index,word,levelNumber,context,writtenFrequencyPerMillion,spokenFrequencyPerMillion,frequencyPerMillion,zhuyin,pinyin
1,愛,1,核心詞,535,681,1216,ㄞˋ,ài
2,吧,1,核心詞,706,748,1454,˙ㄅㄚ,ba
3,八,1,核心詞,214,163,377,ㄅㄚ,bā
4,爸爸/爸,1,核心詞,226,806,1032,ㄅㄚˋ ˙ㄅㄚ / ㄅㄚˋ,bàba / bà 
5,百,1,核心詞,108,77,185,ㄅㄞˇ,bǎi
6,半,1,核心詞,334,279,613,ㄅㄢˋ,bàn
7,本,1,核心詞,745,368,1113,ㄅㄣˇ,běn
8,不,1,核心詞,9278,8951,18229,ㄅㄨˋ,bù
9,茶,1,10.餐飲、烹飪,89,449,538,ㄔㄚˊ,chá
10,車子/車,1,核心詞,275,320,595,ㄔㄜ ˙ㄗ / ㄔㄜ,chēzi / chē
11,吃,1,核心詞,668,1438,2106,ㄔ,chī
12,吃飯,1,核心詞,60,140,200,ㄔ ㄈㄢˋ,chīfàn
13,打,1,核心詞,352,364,716,ㄉㄚˇ,dǎ
14,大,1,核心詞,2110,2859,4969,ㄉㄚˋ,dà
15,大家,1,核心詞,464,1712,2176,ㄉㄚˋ ㄐㄧㄚ,dàjiā
16,大學,1,8.教育、學習,380,219,599,ㄉㄚˋ ㄒㄩㄝˊ,dàxué
17,帶,1,核心詞,450,684,1134,ㄉㄞˋ,dài
18,到,1,核心詞,2297,3229,5526,ㄉㄠˋ,dào
19,的,1,核心詞,62002,62578,124580,ㄉㄜ˙,de
20,點,1,核心詞,479,684,1163,ㄉㄧㄢˇ,diǎn
21,電話,1,核心詞,167,72,239,ㄉㄧㄢˋ ㄏㄨㄚˋ,diànhuà
22,弟弟/弟,1,核心詞,96,88,184,ㄉㄧˋ ˙ㄉㄧ / ㄉㄧˋ,dìdi / dì
23,東西,1,核心詞,561,1120,1681,ㄉㄨㄥ ˙ㄒㄧ,dōngxi
24,都,1,核心詞,4645,7029,11674,ㄉㄡ,dōu
25,對,1,核心詞,3485,5883,9368,ㄉㄨㄟˋ,duì
26,對不起,1,6.社交、人際,37,65,102,ㄉㄨㄟˋ ㄅㄨˋ ㄑㄧˇ,duìbùqǐ
27,多,1,核心詞,1236,1594,2830,ㄉㄨㄛ,duō
28,多少,1,核心詞,207,272,479,ㄉㄨㄛ ㄕㄠˇ,duōshǎo
29,二,1,核心詞,539,227,766,ㄦˋ,èr
30,兒子,1,1.個人資料,277,149,426,ㄦˊ ˙ㄗ,érzi
31,分,1,核心詞,225,359,584,ㄈㄣ,fēn
32,高,1,核心詞,496,694,1190,ㄍㄠ,gāo
33,個,1,核心詞,9562,20644,30206,˙ㄍㄜ,ge
34,哥哥/哥,1,核心詞,113,148,261,ㄍㄜ ˙ㄍㄜ / ㄍㄜ,gēge / gē
35,給,1,核心詞,1039,1401,2440,ㄍㄟˇ,gěi
36,工作,1,3.職業,904,994,1898,ㄍㄨㄥ ㄗㄨㄛˋ,gōngzuò
37,國,1,核心詞,256,363,619,ㄍㄨㄛˊ,guó
38,孩子,1,核心詞,1345,1059,2404,ㄏㄞˊ ˙ㄗ,háizi
39,和1,1,核心詞,5437,2135,7572,ㄏㄢˋ / ㄏㄜˊ,hàn / hé  
40,號1,1,核心詞,73,295,368,ㄏㄠˋ,hào
41,好1,1,核心詞,1887,5853,7740,ㄏㄠˇ,hǎo
42,喝,1,核心詞,250,296,546,ㄏㄜ,hē
43,很,1,核心詞,3068,6550,9618,ㄏㄣˇ,hěn
44,後,1,核心詞,1593,891,2484,ㄏㄡˋ,hòu
45,話,1,核心詞,589,1492,2081,ㄏㄨㄚˋ,huà
46,幾,1,核心詞,963,706,1669,ㄐㄧˇ,jǐ
47,家,1,核心詞,1060,1286,2346,ㄐㄧㄚ,jiā
48,叫,1,核心詞,533,570,1103,ㄐㄧㄠˋ,jiào
49,腳,1,核心詞,208,178,386,ㄐㄧㄠˇ,jiǎo
50,姊姊/姐姐/姊/姐,1,核心詞,108,328,436,ㄐㄧㄝˇ ˙ㄐㄧㄝ / ㄐㄧㄝˇ,jiějie / jiě 
51,今年,1,核心詞,44,343,387,ㄐㄧㄣ ㄋㄧㄢˊ,jīnnián
52,今天,1,核心詞,290,1071,1361,ㄐㄧㄣ ㄊㄧㄢ,jīntiān
53,就,1,核心詞,7262,16921,24183,ㄐㄧㄡˋ,jiù
54,久,1,核心詞,276,293,569,ㄐㄧㄡˇ,jiǔ
55,九,1,核心詞,138,82,220,ㄐㄧㄡˇ,jiǔ
56,咖啡,1,10.餐飲、烹飪,55,89,144,ㄎㄚ ㄈㄟ,kāfēi
57,看1,1,核心詞,1808,3076,4884,ㄎㄢˋ,kàn
58,可能,1,核心詞,1124,1522,2646,ㄎㄜˇ ㄋㄥˊ,kěnéng
59,可以,1,核心詞,2312,4257,6569,ㄎㄜˇ ㄧˇ,kěyǐ
60,塊,1,核心詞,240,542,782,ㄎㄨㄞˋ,kuài
61,來,1,核心詞,2983,5979,8962,ㄌㄞˊ,lái
62,老,1,核心詞,367,267,634,ㄌㄠˇ,lǎo
63,老師,1,8.教育、學習,327,1420,1747,ㄌㄠˇ ㄕ,lǎoshī
64,冷,1,核心詞,71,215,286,ㄌㄥˇ,lěng
65,兩,1,核心詞,2149,1737,3886,ㄌㄧㄤˇ,liǎng
66,六,1,核心詞,306,208,514,ㄌㄧㄡˋ,liù
67,路,1,核心詞,300,352,652,ㄌㄨˋ,lù
68,嗎,1,核心詞,945,1760,2705,˙ㄇㄚ,ma
69,買,1,核心詞,262,449,711,ㄇㄞˇ,mǎi
70,媽媽/媽,1,核心詞,402,1342,1744,ㄇㄚ ˙ㄇㄚ / ㄇㄚ,māma / ma
71,沒,1,核心詞,1269,1260,2529,ㄇㄟˊ,méi
72,沒關係,1,核心詞,27,107,134,ㄇㄟˊ ㄍㄨㄢ ˙ㄒㄧ,méiguānxi
73,妹妹/妹,1,核心詞,95,83,178,ㄇㄟˋ ˙ㄇㄟ / ㄇㄟˋ,mèimei / mèi
74,沒有,1,核心詞,2443,3355,5798,ㄇㄟˊ ㄧㄡˇ,méiyǒu
75,們,1,核心詞,560,623,1183,˙ㄇㄣ,men
76,名字,1,核心詞,182,111,293,ㄇㄧㄥˊ ˙ㄗ,míng zi
77,明天,1,核心詞,78,131,209,ㄇㄧㄥˊ ㄊㄧㄢ,míngtiān
78,拿,1,核心詞,298,343,641,ㄋㄚˊ,ná
79,哪1,1,核心詞,275,382,657,ㄋㄚˇ,nǎ
80,哪裡/哪裏/哪兒,1,核心詞,221,307,528,ㄋㄚˇ ㄌㄧˇ / ㄋㄚˇ ㄌㄧˇ / ㄋㄚˇ ㄦ,nǎlǐ / nǎlǐ / nǎr
81,那/那裡/那裏/那兒,1,核心詞,3314,9035,12349,ㄋㄚˋ / ㄋㄚˋ ㄌㄧˇ / ㄋㄚˋ ㄦ,nà / nàlǐ / nàr
82,難1,1,核心詞,307,415,722,ㄋㄢˊ,nán
83,呢,1,核心詞,800,1792,2592,˙ㄋㄜ,ne
84,你,1,核心詞,5891,8736,14627,ㄋㄧˇ,nǐ
85,妳,1,核心詞,463,1653,2116,ㄋㄧˇ,nǐ
86,你們,1,核心詞,409,1299,1708,ㄋㄧˇ ˙ㄇㄣ,nǐmen
87,年,1,核心詞,1952,2976,4928,ㄋㄧㄢˊ,nián
88,您,1,核心詞,347,764,1111,ㄋㄧㄣˊ,nín
89,女兒,1,1.個人資料,220,168,388,ㄋㄩˇ ㄦˊ,nǚér
90,朋友,1,核心詞,445,464,909,ㄆㄥˊ ㄧㄡˇ,péngyǒu
91,七,1,核心詞,240,151,391,ㄑㄧ,qī
92,前,1,核心詞,1041,807,1848,ㄑㄧㄢˊ,qián
93,錢,1,核心詞,365,489,854,ㄑㄧㄢˊ,qián
94,千,1,核心詞,70,75,145,ㄑㄧㄢ,qiān
95,請,1,核心詞,488,447,935,ㄑㄧㄥˇ,qǐng
96,請問,1,核心詞,24,94,118,ㄑㄧㄥˇ ㄨㄣˋ,qǐngwèn 
97,去,1,核心詞,2059,4057,6116,ㄑㄩˋ,qù
98,去年,1,核心詞,36,126,162,ㄑㄩˋ ㄋㄧㄢˊ,qùnián
99,熱,1,核心詞,87,262,349,ㄖㄜˋ,rè
100,人,1,核心詞,6185,4296,10481,ㄖㄣˊ,rén
101,日,1,核心詞,275,133,408,ㄖˋ,rì
102,容易,1,核心詞,362,404,766,ㄖㄨㄥˊ ㄧˋ,róngyì
103,三,1,核心詞,1267,868,2135,ㄙㄢ,sān
104,上,1,核心詞,4977,3509,8486,ㄕㄤˋ,shàng
105,上午,1,核心詞,26,14,40,ㄕㄤˋ ㄨˇ,shàngwǔ
106,少,1,核心詞,204,340,544,ㄕㄠˇ,shǎo
107,誰,1,核心詞,456,283,739,ㄕㄟˊ,shéi
108,什麼/甚麼,1,核心詞,1754,2650,4404,ㄕㄣˊ ˙ㄇㄜ,shénme 
109,十,1,核心詞,320,293,613,ㄕˊ,shí
110,是,1,核心詞,18291,28602,46893,ㄕˋ,shì
111,時候,1,核心詞,844,3606,4450,ㄕˊ ㄏㄡˋ,shíhòu
112,時間,1,核心詞,865,1063,1928,ㄕˊ ㄐㄧㄢ,shíjiān
113,手機,1,6.社交、人際,39,61,100,ㄕㄡˇ ㄐㄧ,shǒujī
114,書,1,核心詞,767,457,1224,ㄕㄨ,shū
115,水,1,核心詞,342,1245,1587,ㄕㄨㄟˇ,shuǐ
116,睡覺,1,核心詞,65,88,153,ㄕㄨㄟˋ ㄐㄧㄠˋ,shuìjiào
117,說,1,核心詞,5312,6283,11595,ㄕㄨㄛ,shuō
118,四,1,核心詞,553,423,976,ㄙˋ,sì
119,歲,1,核心詞,574,521,1095,ㄙㄨㄟˋ,suì
120,她,1,核心詞,4568,2329,6897,ㄊㄚ,tā
121,他,1,核心詞,10261,6366,16627,ㄊㄚ,tā 
122,他們,1,核心詞,2945,3036,5981,ㄊㄚ ˙ㄇㄣ,tāmen 
123,太,1,核心詞,718,891,1609,ㄊㄞˋ  ,tài  
124,太太,1,核心詞,276,131,407,ㄊㄞˋ ˙ㄊㄞ,tàitai
125,台灣/臺灣,1,1.個人資料,522,1445,1967,ㄊㄞˊ ㄨㄢ,táiwān 
126,臺灣人/台灣人,1,1.個人資料,5,11,16,ㄊㄞˊ ㄨㄢ  ㄖㄣˊ  ,táiwānrén  
127,天,1,核心詞,1520,1616,3136,ㄊㄧㄢ,tiān
128,聽,1,核心詞,615,409,1024,ㄊㄧㄥ,tīng
129,同學,1,核心詞,106,267,373,ㄊㄨㄥˊ ㄒㄩㄝˊ,tóngxué 
130,外,1,核心詞,388,298,686,ㄨㄞˋ,wài
131,晚安,1,核心詞,7,6,13,ㄨㄢˇ ㄢ,wǎnān
132,晚上,1,核心詞,189,188,377,ㄨㄢˇ ㄕㄤˋ,wǎnshàng 
133,位,1,核心詞,1145,1031,2176,ㄨㄟˋ,wèi
134,問,1,核心詞,694,451,1145,ㄨㄣˋ,wèn
135,問題,1,核心詞,1138,1105,2243,ㄨㄣˋ ㄊㄧˊ,wèntí
136,我,1,核心詞,13149,16244,29393,ㄨㄛˇ,wǒ
137,我們,1,核心詞,4150,12537,16687,ㄨㄛˇ ˙ㄇㄣ,wǒmen
138,五,1,核心詞,444,360,804,ㄨˇ,wǔ
139,想,1,核心詞,1876,2025,3901,ㄒㄧㄤˇ,xiǎng
140,先生,1,核心詞,862,274,1136,ㄒㄧㄢ ㄕㄥ ,xiānshēng  
141,現在,1,核心詞,884,2365,3249,ㄒㄧㄢˋ ㄗㄞˋ ,xiànzài  
142,小,1,核心詞,1281,1334,2615,ㄒㄧㄠˇ,xiǎo
143,小孩/小孩子,1,核心詞,240,547,787,ㄒㄧㄠˇ ㄏㄞˊ / ㄒㄧㄠˇ ㄏㄞˊ ˙ㄗ,xiǎohái / xiǎoháizi
144,小姐,1,核心詞,273,50,323,ㄒㄧㄠˇ ㄐㄧㄝˇ,xiǎojiě
145,小時,1,核心詞,227,228,455,ㄒㄧㄠˇ ㄕˊ,xiǎoshí 
146,下午,1,核心詞,83,64,147,ㄒㄧㄚˋ ㄨˇ,xiàwǔ
147,寫,1,核心詞,473,410,883,ㄒㄧㄝˇ,xiě
148,謝謝,1,核心詞,63,593,656,ㄒㄧㄝˋ ˙ㄒㄧㄝ,xièxie  
149,喜歡,1,核心詞,494,577,1071,ㄒㄧˇ ㄏㄨㄢ,xǐhuān
150,新,1,核心詞,822,686,1508,ㄒㄧㄣ,xīn
151,姓名,1,核心詞,22,3,25,ㄒㄧㄥˋ ㄇㄧㄥˊ,xìngmíng 
152,星期天/星期日,1,核心詞,17,10,27,ㄒㄧㄥ ㄑㄧˊ ㄊㄧㄢ / ㄒㄧㄥ ㄑㄧˊ ㄖˋ,xīngqítiān / xīngqírì
153,星期一,1,核心詞,10,8,18,ㄒㄧㄥ ㄑㄧˊ ㄧ,xīngqíyī
154,學,1,核心詞,206,359,565,ㄒㄩㄝˊ ,xué 
155,學生,1,核心詞,418,303,721,ㄒㄩㄝˊ ㄕㄥ,xuéshēng 
156,學校,1,8.教育、學習,303,497,800,ㄒㄩㄝˊ ㄒㄧㄠˋ,xuéxiào
157,要,1,核心詞,3541,7742,11283,ㄧㄠˋ      ,yào      
158,也,1,核心詞,6312,7341,13653,ㄧㄝˇ,yě
159,一,1,核心詞,15058,16040,31098,ㄧ,yī
160,一起,1,核心詞,337,718,1055,ㄧˋ ㄑㄧˇ,yìqǐ
161,一月,1,核心詞,40,13,53,ㄧ ㄩㄝˋ,yīyuè
162,醫生/醫師,1,7.身體、醫療,360,372,732,ㄧ ㄕㄥ / ㄧ ㄕ,yīshēng / yīshī  
163,英文,1,8.教育、學習,59,65,124,ㄧㄥ ㄨㄣˊ,yīngwén 
164,用,1,核心詞,1521,2223,3744,ㄩㄥˋ  ,yòng  
165,有,1,核心詞,8990,12724,21714,ㄧㄡˇ   ,yǒu   
166,元,1,核心詞,220,122,342,ㄩㄢˊ,yuán
167,月,1,核心詞,463,737,1200,ㄩㄝˋ,yuè
168,再見,1,核心詞,19,27,46,ㄗㄞˋ ㄐㄧㄢˋ,zàijiàn 
169,早,1,核心詞,248,240,488,ㄗㄠˇ  ,zǎo  
170,早安,1,核心詞,6,4,10,ㄗㄠˇ ㄢ,zǎoān 
171,早上,1,核心詞,103,130,233,ㄗㄠˇ ㄕㄤˋ,zǎoshàng 
172,怎麼,1,核心詞,570,1269,1839,ㄗㄣˇ ˙ㄇㄜ ,zěnme  
173,找,1,核心詞,489,477,966,ㄓㄠˇ  ,zhǎo  
174,這/這裡/這裏/這兒,1,核心詞,8975,15872,24847,ㄓㄜˋ/ㄓㄜˋ ㄌㄧˇ/ㄓㄜˋ ㄦ,zhè/zhèlǐ/zhèr
175,知道,1,核心詞,1488,1666,3154,ㄓ ㄉㄠˋ,zhīdào  
176,中文,1,核心詞,36,38,74,ㄓㄨㄥ ㄨㄣˊ,zhōngwén 
177,中午,1,核心詞,30,41,71,ㄓㄨㄥ ㄨˇ,zhōngwǔ 
178,字,1,核心詞,284,171,455,ㄗˋ ,zì 
179,走,1,核心詞,545,643,1188,ㄗㄡˇ   ,zǒu   
180,做,1,核心詞,1808,3593,5401,ㄗㄨㄛˋ  ,zuò  
181,坐,1,核心詞,406,240,646,ㄗㄨㄛˋ  ,zuò  
182,昨天,1,核心詞,53,84,137,ㄗㄨㄛˊ ㄊㄧㄢ,zuótiān 
183,矮,1.5,核心詞,29,13,42,ㄞˇ  ,ǎi  
184,白,1.5,核心詞,208,167,375,ㄅㄞˊ,bái
185,飽,1.5,核心詞,17,38,55,ㄅㄠˇ ,bǎo 
186,包子,1.5,10.餐飲、烹飪,4,2,6,ㄅㄠ ˙ㄗ,bāozi 
187,杯子/杯,1.5,核心詞,108,118,226,ㄅㄟ ˙ㄗ / ㄅㄟ,bēizi / bēi
188,鼻子/鼻,1.5,核心詞,69,31,100,ㄅㄧˊ ˙ㄗ / ㄅㄧˊ,bízi / bí 
189,筆,1.5,核心詞,123,82,205,ㄅㄧˇ,bǐ
190,比,1.5,核心詞,728,555,1283,ㄅㄧˇ  ,bǐ  
191,邊,1.5,核心詞,515,454,969,ㄅㄧㄢ ,biān 
192,別,1.5,核心詞,306,142,448,ㄅㄧㄝˊ,bié
193,冰,1.5,10.餐飲、烹飪,31,105,136,ㄅㄧㄥ   ,bīng   
194,病,1.5,7.身體、醫療,131,149,280,ㄅㄧㄥˋ ,bìng 
195,不錯,1.5,核心詞,97,204,301,ㄅㄨˊ ㄘㄨㄛˋ,búcuò 
196,菜,1.5,10.餐飲、烹飪,79,350,429,ㄘㄞˋ ,cài 
197,餐廳,1.5,10.餐飲、烹飪,54,79,133,ㄘㄢ ㄊㄧㄥ,cāntīng 
198,長1,1.5,核心詞,434,469,903,ㄔㄤˊ  ,cháng  
199,唱,1.5,核心詞,89,78,167,ㄔㄤˋ,chàng
200,唱歌,1.5,4.休閒、娛樂,29,35,64,ㄔㄤˋ ㄍㄜ,chàng gē 
201,常常/常,1.5,核心詞,507,691,1198,ㄔㄤˊ ㄔㄤˊ / ㄔㄤˊ,chángcháng / cháng 
202,出,1.5,核心詞,350,216,566,ㄔㄨ ,chū 
203,穿,1.5,2.日常起居,189,193,382,ㄔㄨㄢ ,chuān 
204,床,1.5,核心詞,122,53,175,ㄔㄨㄤˊ ,chuáng 
205,從,1.5,核心詞,1948,1910,3858,ㄘㄨㄥˊ  ,cóng  
206,錯,1.5,核心詞,195,341,536,ㄘㄨㄛˋ ,cuò 
207,蛋,1.5,10.餐飲、烹飪,41,51,92,ㄉㄢˋ ,dàn 
208,得2,1.5,核心詞,2471,1542,4013,˙ㄉㄜ ,de 
209,得1,1.5,核心詞,2471,1542,4013,ㄉㄟˇ ,děi 
210,等,1.5,核心詞,1163,650,1813,ㄉㄥˇ  ,děng  
211,低,1.5,核心詞,122,169,291,ㄉㄧ ,dī 
212,地方,1.5,核心詞,563,1183,1746,ㄉㄧˋ ㄈㄤ ,dìfāng  
213,店,1.5,核心詞,73,56,129,ㄉㄧㄢˋ ,diàn 
214,電腦,1.5,核心詞,226,117,343,ㄉㄧㄢˋ ㄋㄠˇ,diànnǎo 
215,電視,1.5,2.日常起居,125,126,251,ㄉㄧㄢˋ ㄕˋ,diànshì 
216,電影,1.5,4.休閒、娛樂,282,70,352,ㄉㄧㄢˋ ㄧㄥˇ,diànyǐng 
217,懂,1.5,核心詞,133,179,312,ㄉㄨㄥˇ,dǒng
218,讀,1.5,核心詞,204,133,337,ㄉㄨˊ  ,dú  
219,短,1.5,核心詞,82,75,157,ㄉㄨㄢˇ,duǎn
220,多久,1.5,核心詞,19,30,49,ㄉㄨㄛ ㄐㄧㄡˇ,duōjiǔ 
221,餓,1.5,核心詞,41,46,87,ㄜˋ,è
222,耳朵,1.5,7.身體、醫療,57,28,85,ㄦˇ ˙ㄉㄨㄛ,ěrduo
223,飯,1.5,核心詞,79,113,192,ㄈㄢˋ ,fàn 
224,方便,1.5,核心詞,54,124,178,ㄈㄤ ㄅㄧㄢˋ,fāngbiàn 
225,房間,1.5,核心詞,172,48,220,ㄈㄤˊ ㄐㄧㄢ,fángjiān 
226,房子,1.5,核心詞,148,184,332,ㄈㄤˊ ˙ㄗ,fángzi 
227,非常,1.5,核心詞,663,1544,2207,ㄈㄟ ㄔㄤˊ,fēicháng  
228,飛機,1.5,5.交通、旅遊,79,65,144,ㄈㄟ ㄐㄧ,fēijī 
229,風,1.5,核心詞,101,201,302,ㄈㄥ,fēng
230,分鐘,1.5,核心詞,232,125,357,ㄈㄣ ㄓㄨㄥ,fēnzhōng 
231,附近,1.5,核心詞,128,152,280,ㄈㄨˋ ㄐㄧㄣˋ,fùjìn 
232,感冒,1.5,7.身體、醫療,24,37,61,ㄍㄢˇ ㄇㄠˋ,gǎnmào 
233,告訴1,1.5,核心詞,546,363,909,ㄍㄠˋ ㄙㄨˋ,gàosù 
234,歌,1.5,核心詞,68,57,125,ㄍㄜ,gē
235,跟,1.5,核心詞,1038,3969,5007,ㄍㄣ    ,gēn    
236,公車,1.5,5.交通、旅遊,18,34,52,ㄍㄨㄥ ㄔㄜ,gōngchē 
237,公園,1.5,2.日常起居,52,95,147,ㄍㄨㄥ ㄩㄢˊ,gōngyuán 
238,功課,1.5,8.教育、學習,43,93,136,ㄍㄨㄥ ㄎㄜˋ,gōngkè 
239,夠,1.5,核心詞,209,267,476,ㄍㄡˋ,gòu
240,貴,1.5,1.個人資料,57,96,153,ㄍㄨㄟˋ,guì
241,過,1.5,核心詞,1712,1404,3116,ㄍㄨㄛˋ    ,guò    
242,國家,1.5,5.交通、旅遊,363,694,1057,ㄍㄨㄛˊ ㄐㄧㄚ,guójiā 
243,還1,1.5,核心詞,2505,3842,6347,ㄏㄞˊ,hái
244,還是,1.5,核心詞,626,1030,1656,ㄏㄞˊ ㄕˋ  ,háishì   
245,黑,1.5,核心詞,147,111,258,ㄏㄟ  ,hēi  
246,紅,1.5,核心詞,137,139,276,ㄏㄨㄥˊ ,hóng 
247,後年,1.5,核心詞,1,0,1,ㄏㄡˋ ㄋㄧㄢˊ,hòunián 
248,後天,1.5,核心詞,17,14,31,ㄏㄡˋ ㄊㄧㄢ,hòutiān 
249,畫,1.5,核心詞,149,229,378,ㄏㄨㄚˋ      ,huà      
250,花1/花兒,1.5,核心詞,336,417,753,ㄏㄨㄚ / ㄏㄨㄚ ㄦ,huā / huār
251,會,1.5,核心詞,4147,6976,11123,ㄏㄨㄟˋ   ,huì   
252,火車,1.5,5.交通、旅遊,58,75,133,ㄏㄨㄛˇ ㄔㄜ,huǒchē
253,雞,1.5,1.個人資料,69,61,130,ㄐㄧ ,jī 
254,計程車,1.5,5.交通、旅遊,24,23,47,ㄐㄧˋ ㄔㄥˊ ㄔㄜ,jìchéngchē  
255,見,1.5,核心詞,727,293,1020,ㄐㄧㄢˋ,jiàn
256,件,1.5,核心詞,563,461,1024,ㄐㄧㄢˋ ,jiàn 
257,教1,1.5,核心詞,193,340,533,ㄐㄧㄠ ,jiāo 
258,教室,1.5,8.教育、學習,64,74,138,ㄐㄧㄠˋ ㄕˋ,jiàoshì 
259,家人,1.5,1.個人資料,133,197,330,ㄐㄧㄚ ㄖㄣˊ,jiārén 
260,介紹,1.5,6.社交、人際,107,173,280,ㄐㄧㄝˋ ㄕㄠˋ,jièshào 
261,進,1.5,核心詞,163,118,281,ㄐㄧㄣˋ ,jìn 
262,酒,1.5,10.餐飲、烹飪,175,40,215,ㄐㄧㄡˇ,jiǔ
263,舊,1.5,核心詞,118,59,177,ㄐㄧㄡˋ,jiù
264,覺得,1.5,核心詞,738,2538,3276,ㄐㄩㄝˊ ˙ㄉㄜ ,juéde  
265,句子,1.5,8.教育、學習,22,4,26,ㄐㄩˋ ˙ㄗ,jùzi 
266,開,1.5,核心詞,267,344,611,ㄎㄞ     ,kāi     
267,開車,1.5,5.交通、旅遊,54,27,81,ㄎㄞ ㄔㄜ,kāichē 
268,看病,1.5,7.身體、醫療,8,14,22,ㄎㄢˋ ㄅㄧㄥˋ ,kànbìng  
269,看到,1.5,核心詞,659,1347,2006,ㄎㄢˋ ㄉㄠˋ ,kàndào  
270,看見,1.5,核心詞,238,49,287,ㄎㄢˋ ㄐㄧㄢˋ,kànjiàn 
271,考試,1.5,8.教育、學習,56,62,118,ㄎㄠˇ ㄕˋ ,kǎoshì  
272,可是,1.5,核心詞,525,1353,1878,ㄎㄜˇ ㄕˋ,kěshì 
273,課,1.5,8.教育、學習,61,93,154,ㄎㄜˋ   ,kè   
274,空氣,1.5,13.自然環境,77,241,318,ㄎㄨㄥ ㄑㄧˋ,kōngqì 
275,快,1.5,核心詞,479,531,1010,ㄎㄨㄞˋ,kuài
276,快樂,1.5,核心詞,227,194,421,ㄎㄨㄞˋ ㄌㄜˋ,kuàilè 
277,筷子/筷,1.5,10.餐飲、烹飪,10,73,83,ㄎㄨㄞˋ ˙ㄗ / ㄎㄨㄞˋ,kuàizi / kuài 
278,累1,1.5,核心詞,53,121,174,ㄌㄟˋ,lèi
279,裡/裏,1.5,核心詞,2558,1463,4021,ㄌㄧˇ  ,lǐ  
280,輛,1.5,核心詞,83,27,110,ㄌㄧㄤˋ,liàng
281,禮拜天,1.5,核心詞,4,12,16,ㄌㄧˇ ㄅㄞˋ ㄊㄧㄢ,lǐbàitiān  
282,裡面/裏面,1.5,核心詞,158,1724,1882,ㄌㄧˇ ㄇㄧㄢˋ ,lǐmiàn  
283,樓,1.5,2.日常起居,48,53,101,ㄌㄡˊ,lóu
284,慢,1.5,核心詞,65,91,156,ㄇㄢˋ,màn
285,忙,1.5,核心詞,127,144,271,ㄇㄤˊ,máng
286,馬上,1.5,核心詞,166,155,321,ㄇㄚˇ ㄕㄤˋ,mǎshàng 
287,美,1.5,核心詞,212,205,417,ㄇㄟˇ,měi
288,每,1.5,核心詞,1388,1756,3144,ㄇㄟˇ  ,měi  
289,門,1.5,核心詞,322,124,446,ㄇㄣˊ ,mén 
290,門口,1.5,核心詞,70,16,86,ㄇㄣˊ ㄎㄡˇ,ménkǒu 
291,麵,1.5,10.餐飲、烹飪,25,44,69,ㄇㄧㄢˋ ,miàn 
292,麵包,1.5,10.餐飲、烹飪,39,67,106,ㄇㄧㄢˋ ㄅㄠ ,miànbāo  
293,明年,1.5,核心詞,13,31,44,ㄇㄧㄥˊ ㄋㄧㄢˊ,míngnián 
294,男,1.5,核心詞,98,27,125,ㄋㄢˊ,nán
295,能,1.5,核心詞,2327,1244,3571,ㄋㄥˊ  ,néng  
296,唸/念,1.5,核心詞,112,159,271,ㄋㄧㄢˋ  ,niàn 
297,牛,1.5,1.個人資料,107,103,210,ㄋㄧㄡˊ,niú
298,牛奶,1.5,10.餐飲、烹飪,27,36,63,ㄋㄧㄡˊ ㄋㄞˇ,niúnǎi 
299,女,1.5,核心詞,212,47,259,ㄋㄩˇ,nǚ
300,怕,1.5,核心詞,200,270,470,ㄆㄚˋ ,pà 
301,胖,1.5,7.身體、醫療,30,27,57,ㄆㄤˋ,pàng
302,旁邊/旁,1.5,核心詞,266,226,492,ㄆㄤˊ ㄅㄧㄢ / ㄆㄤˊ,pángbiān / páng 
303,便宜,1.5,2.日常起居,38,61,99,ㄆㄧㄢˊ ㄧˊ,piányí 
304,漂亮,1.5,核心詞,89,220,309,ㄆㄧㄠˋ ㄌㄧㄤˋ,piàoliàng 
305,前面,1.5,核心詞,120,132,252,ㄑㄧㄢˊ ㄇㄧㄢˋ,qiánmiàn 
306,前年,1.5,核心詞,5,9,14,ㄑㄧㄢˊ ㄋㄧㄢˊ,qiánnián 
307,前天,1.5,核心詞,7,5,12,ㄑㄧㄢˊ ㄊㄧㄢ,qiántiān 
308,起床,1.5,2.日常起居,29,29,58,ㄑㄧˇ ㄔㄨㄤˊ,qǐchuáng 
309,起來,1.5,核心詞,465,438,903,ㄑㄧˇ ㄌㄞˊ,qǐlái 
310,球,1.5,4.休閒、娛樂,82,52,134,ㄑㄧㄡˊ,qiú
311,然後,1.5,核心詞,650,3102,3752,ㄖㄢˊ ㄏㄡˋ,ránhòu 
312,肉,1.5,10.餐飲、烹飪,93,79,172,ㄖㄡˋ,ròu
313,山,1.5,核心詞,270,319,589,ㄕㄢ,shān
314,上課,1.5,8.教育、學習,49,133,182,ㄕㄤˋ ㄎㄜˋ,shàngkè 
315,生病,1.5,7.身體、醫療,45,103,148,ㄕㄥ ㄅㄧㄥˋ,shēngbìng 
316,生日,1.5,1.個人資料,26,34,60,ㄕㄥ ㄖˋ,shēngrì 
317,身體,1.5,7.身體、醫療,361,310,671,ㄕㄣ ㄊㄧˇ  ,shēntǐ   
318,事/事兒,1.5,核心詞,1579,626,2205,ㄕˋ / ㄕˋ ㄦ,shì / shìr 
319,手,1.5,核心詞,580,500,1080,ㄕㄡˇ,shǒu
320,瘦,1.5,7.身體、醫療,29,26,55,ㄕㄡˋ,shòu
321,舒服,1.5,核心詞,69,98,167,ㄕㄨ ˙ㄈㄨ,shūfu 
322,水果,1.5,10.餐飲、烹飪,28,124,152,ㄕㄨㄟˇ ㄍㄨㄛˇ,shuǐguǒ 
323,說話,1.5,核心詞,215,60,275,ㄕㄨㄛ ㄏㄨㄚˋ,shuōhuà 
324,所以,1.5,核心詞,1000,4988,5988,ㄙㄨㄛˇ ㄧˇ,suǒyǐ 
325,它,1.5,核心詞,1389,5371,6760,ㄊㄚ,tā
326,湯,1.5,10.餐飲、烹飪,132,72,204,ㄊㄤ,tāng
327,天氣,1.5,5.交通、旅遊,55,200,255,ㄊㄧㄢ ㄑㄧˋ,tiānqì 
328,甜,1.5,10.餐飲、烹飪,32,77,109,ㄊㄧㄢˊ ,tián 
329,跳,1.5,核心詞,96,77,173,ㄊㄧㄠˋ  ,tiào  
330,跳舞,1.5,4.休閒、娛樂,28,26,54,ㄊㄧㄠˋ ㄨˇ,tiàowǔ 
331,聽見,1.5,核心詞,85,10,95,ㄊㄧㄥ ㄐㄧㄢˋ,tīngjiàn 
332,痛,1.5,核心詞,97,109,206,ㄊㄨㄥˋ,tòng
333,頭,1.5,核心詞,462,230,692,ㄊㄡˊ ,tóu 
334,外國,1.5,核心詞,46,30,76,ㄨㄞˋ ㄍㄨㄛˊ,wàiguó 
335,外頭,1.5,核心詞,21,7,28,ㄨㄞˋ ˙ㄊㄡ,wàitou 
336,玩,1.5,核心詞,177,281,458,ㄨㄢˊ ,wán 
337,晚,1.5,核心詞,97,76,173,ㄨㄢˇ,wǎn
338,晚餐/晚飯,1.5,核心詞,62,35,97,ㄨㄢˇ ㄘㄢ / ㄨㄢˇ ㄈㄢˋ,wǎncān / wǎnfàn  
339,碗,1.5,10.餐飲、烹飪,68,76,144,ㄨㄢˇ  ,wǎn  
340,萬,1.5,核心詞,44,72,116,ㄨㄢˋ,wàn
341,為什麼,1.5,核心詞,445,814,1259,ㄨㄟˋ ㄕㄣˊ ˙ㄇㄛ,wèishénme  
342,午餐/午飯,1.5,核心詞,45,38,83,ㄨˇ ㄘㄢ / ㄨˇ ㄈㄢˋ,wǔcān / wǔfàn  
343,下,1.5,核心詞,1263,1537,2800,ㄒㄧㄚˋ    ,xià    
344,下課,1.5,8.教育、學習,10,28,38,ㄒㄧㄚˋ ㄎㄜˋ,xiàkè 
345,先,1.5,核心詞,548,795,1343,ㄒㄧㄢ ,xiān 
346,像,1.5,核心詞,1169,1910,3079,ㄒㄧㄤˋ ,xiàng 
347,小吃,1.5,9.購物、商店,6,3,9,ㄒㄧㄠˇ ㄔ ,xiǎochī  
348,下雨,1.5,13.自然環境,22,75,97,ㄒㄧㄚˋ ㄩˇ,xiàyǔ 
349,鞋子/鞋,1.5,核心詞,72,86,158,ㄒㄧㄝˊ ˙ㄗ / ㄒㄧㄝˊ,xiézi / xié 
350,星期,1.5,核心詞,91,52,143,ㄒㄧㄥ ㄑㄧˊ,xīngqí 
351,姓,1.5,1.個人資料,57,12,69,ㄒㄧㄥˋ,xìng
352,休息,1.5,7.身體、醫療,89,90,179,ㄒㄧㄡ ㄒㄧˊ,xiūxí 
353,眼睛,1.5,7.身體、醫療,267,118,385,ㄧㄢˇ ㄐㄧㄥ,yǎnjīng 
354,藥,1.5,7.身體、醫療,134,166,300,ㄧㄠˋ,yào
355,衣服/衣,1.5,核心詞,141,253,394,ㄧ ㄈㄨˊ / ㄧ,yīfú / yī
356,一定,1.5,核心詞,551,848,1399,ㄧˊ ㄉㄧㄥˋ,yídìng 
357,一共/共,1.5,核心詞,119,87,206,ㄧˊ ㄍㄨㄥˋ / ㄍㄨㄥˋ,yígòng / gòng 
358,一點/一點點/一點兒,1.5,核心詞,413,731,1144,ㄧˋ ㄉㄧㄢˇ / ㄧˋ ㄉㄧㄢˇ ㄉㄧㄢˇ / ㄧˋ ㄉㄧㄢˇ ㄦ,yìdiǎn / yìdiǎndiǎn / yìdiǎr     
359,一些,1.5,核心詞,609,1514,2123,ㄧˋ　ㄒㄧㄝ,yìxiē
360,一樣,1.5,核心詞,792,1056,1848,ㄧˊ ㄧㄤˋ  ,yíyàng   
361,以後,1.5,核心詞,302,688,990,ㄧˇ ㄏㄡˋ ,yǐhòu  
362,以前,1.5,核心詞,242,624,866,ㄧˇ ㄑㄧㄢˊ  ,yǐqián   
363,椅子/椅,1.5,核心詞,74,32,106,ㄧˇ ˙ㄗ / ㄧˇ,yǐzi / yǐ 
364,意思,1.5,核心詞,199,249,448,ㄧˋ ˙ㄙ,yìsi 
365,應該/應1,1.5,核心詞,946,1012,1958,ㄧㄥ ㄍㄞ / ㄧㄥ,yīnggāi / yīng
366,因為,1.5,核心詞,1759,4184,5943,ㄧㄣ ㄨㄟˋ,yīnwèi 
367,右,1.5,核心詞,84,112,196,ㄧㄡˋ,yòu
368,右邊,1.5,核心詞,24,15,39,ㄧㄡˋ ㄅㄧㄢ,yòubiān 
369,又,1.5,核心詞,2249,1494,3743,ㄧㄡˋ ,yòu 
370,有點/有一點/有點兒,1.5,核心詞,195,236,431,ㄧㄡˇ ㄉㄧㄢˇ / ㄧㄡˇ ㄧˋ ㄉㄧㄢˇ / ㄧㄡˇ ㄉㄧㄢˇ ㄦ,yǒudiǎn / yǒuyìdiǎn / yǒudiǎnr     
371,有時候/有時,1.5,核心詞,304,466,770,ㄧㄡˇ ㄕˊ ㄏㄡˋ / 一ㄡˇ ㄕˊ,yǒushíhòu / yǒushí
372,魚,1.5,10.餐飲、烹飪,165,175,340,ㄩˊ ,yú 
373,雨,1.5,13.自然環境,65,161,226,ㄩˇ ,yǔ 
374,運動,1.5,4.休閒、娛樂,270,275,545,ㄩㄣˋ ㄉㄨㄥˋ  ,yùndòng   
375,再,1.5,核心詞,1274,1754,3028,ㄗㄞˋ  ,zài  
376,在,1.5,核心詞,12612,12148,24760,ㄗㄞˋ,zài    
377,早餐/早飯,1.5,核心詞,35,52,87,ㄗㄠˇ ㄘㄢ / ㄗㄠˇ ㄈㄢˋ,zǎocān / zǎofàn  
378,怎麼樣,1.5,核心詞,59,494,553,ㄗㄣˇ ˙ㄇㄜ ㄧㄤˋ,zěnmeyàng  
379,站,1.5,核心詞,273,179,452,ㄓㄢˋ  ,zhàn  
380,張,1.5,核心詞,396,264,660,ㄓㄤ ,zhāng 
381,真,1.5,核心詞,579,373,952,ㄓㄣ    ,zhēn    
382,真的,1.5,核心詞,351,1675,2026,ㄓㄣ ˙ㄉㄜ,zhēnde 
383,枝,1.5,核心詞,33,32,65,ㄓ,zhī
384,紙,1.5,核心詞,90,134,224,ㄓˇ,zhǐ
385,只,1.5,核心詞,1718,946,2664,ㄓˇ ,zhǐ 
386,中1,1.5,核心詞,3605,1443,5048,ㄓㄨㄥ,zhōng
387,鐘頭,1.5,核心詞,14,12,26,ㄓㄨㄥ ㄊㄡˊ,zhōngtóu 
388,週末/周末,1.5,核心詞,31,21,52,ㄓㄡ ㄇㄛˋ ,zhōumò 
389,住,1.5,核心詞,307,323,630,ㄓㄨˋ ,zhù 
390,豬,1.5,1.個人資料,51,40,91,ㄓㄨ  ,zhū  
391,桌子/桌,1.5,核心詞,137,72,209,ㄓㄨㄛ ˙ㄗ / ㄓㄨㄛ ,zhuōzi / zhuō  
392,自己,1.5,核心詞,2880,2324,5204,ㄗˋ ㄐㄧˇ,zìjǐ 
393,走路,1.5,核心詞,51,59,110,ㄗㄡˇ ㄌㄨˋ,zǒulù 
394,最,1.5,核心詞,1730,2182,3912,ㄗㄨㄟˋ ,zuì 
395,嘴巴/嘴,1.5,7.身體、醫療,177,77,254,ㄗㄨㄟˇ ˙ㄅㄚ / ㄗㄨㄟˇ,zuǐba / zuǐ 
396,左,1.5,核心詞,92,106,198,ㄗㄨㄛˇ ,zuǒ 
397,啊,2,核心詞,500,2836,3336,˙ㄚ,a
398,把,2,核心詞,2814,2812,5626,ㄅㄚˇ,bǎ
399,班,2,核心詞,82,176,258,ㄅㄢ ,bān
400,辦法,2,3.職業,186,398,584,ㄅㄢˋ ㄈㄚˇ,bànfǎ 
401,幫,2,核心詞,239,588,827,ㄅㄤ,bāng
402,幫忙,2,核心詞,89,273,362,ㄅㄤ ㄇㄤˊ,bāngmáng 
403,幫助,2,核心詞,272,393,665,ㄅㄤ ㄓㄨˋ ,bāngzhù  
404,棒,2,核心詞,68,195,263,ㄅㄤˋ  ,bàng  
405,包,2,核心詞,61,163,224,ㄅㄠ ,bāo 
406,北,2,核心詞,68,223,291,ㄅㄟˇ,běi
407,被,2,核心詞,1969,1237,3206,ㄅㄟˋ,bèi
408,本來,2,核心詞,134,217,351,ㄅㄣˇ ㄌㄞˊ,běnlái 
409,變,2,核心詞,334,377,711,ㄅㄧㄢˋ,biàn
410,別人,2,核心詞,480,357,837,ㄅㄧㄝˊ ㄖㄣˊ,biérén 
411,比較/較,2,核心詞,764,2174,2938,ㄅㄧˇ ㄐㄧㄠˋ / ㄐㄧㄠˋ ,bǐjiào / jiào  
412,病人,2,7.身體、醫療,121,191,312,ㄅㄧㄥˋ ㄖㄣˊ,bìngrén 
413,比賽,2,4.休閒、娛樂,121,100,221,ㄅㄧˇ ㄙㄞˋ ,bǐsài  
414,部,2,核心詞,218,87,305,ㄅㄨˋ ,bù 
415,部分/部份,2,核心詞,321,466,787,ㄅㄨˋ ㄈㄣˋ  ,bùfèn   
416,不過,2,核心詞,743,693,1436,ㄅㄨˊ ㄍㄨㄛˋ,búguò
417,才,2,核心詞,1590,1559,3149,ㄘㄞˊ,cái
418,參加,2,核心詞,188,204,392,ㄘㄢ ㄐㄧㄚ,cānjiā
419,差不多,2,核心詞,60,239,299,ㄔㄚ　 ㄅㄨˋ ㄉㄨㄛ ,chābùduō
420,場,2,核心詞,280,268,548,ㄔㄤˇ,chǎng
421,成績,2,8.教育、學習,80,53,133,ㄔㄥˊ ㄐㄧ,chéngjī 
422,春天/春,2,核心詞,81,102,183,ㄔㄨㄣ ㄊㄧㄢ / ㄔㄨㄣ,chūntiān / chūn 
423,次,2,核心詞,1325,1630,2955,ㄘˋ,cì
424,戴,2,核心詞,95,62,157,ㄉㄞˋ,dài
425,當1,2,核心詞,1150,895,2045,ㄉㄤ,dāng
426,當然,2,核心詞,487,687,1174,ㄉㄤ ㄖㄢˊ,dāngrán 
427,但是/但,2,核心詞,3376,2621,5997,ㄉㄢˋ ㄕˋ / ㄉㄢˋ,dànshì / dàn 
428,道1,2,核心詞,491,164,655,ㄉㄠˋ,dào
429,大人,2,核心詞,148,96,244,ㄉㄚˋ ㄖㄣˊ ,dàrén  
430,地2,2,核心詞,2854,1161,4015,˙ㄉㄜ,de
431,地1,2,核心詞,2854,1161,4015,ㄉㄧˋ,dì
432,電,2,核心詞,25,123,148,ㄉㄧㄢˋ,diàn
433,第一,2,核心詞,698,863,1561,ㄉㄧˋ ㄧ ,dìyī  
434,冬天/冬,2,核心詞,65,168,233,ㄉㄨㄥ ㄊㄧㄢ / ㄉㄨㄥ,dōngtiān / dōng 
435,方法,2,8.教育、學習,401,287,688,ㄈㄤ ㄈㄚˇ,fāngfǎ 
436,放,2,核心詞,347,470,817,ㄈㄤˋ,fàng
437,發現,2,核心詞,734,657,1391,ㄈㄚ ㄒㄧㄢˋ,fāxiàn
438,份,2,核心詞,198,204,402,ㄈㄣˋ,fèn
439,乾淨,2,核心詞,49,159,208,ㄍㄢ ㄐㄧㄥˋ,gānjìng 
440,敢,2,核心詞,277,151,428,ㄍㄢˇ,gǎn
441,剛剛/剛,2,核心詞,311,924,1235,ㄍㄤ ㄍㄤ ,gānggāng / gāng
442,高興,2,核心詞,186,161,347,ㄍㄠ ㄒㄧㄥˋ,gāoxìng 
443,高中,2,1.個人資料,56,43,99,ㄍㄠ ㄓㄨㄥ,gāozhōng
444,各,2,核心詞,889,762,1651,ㄍㄜˋ,gè
445,更1,2,核心詞,1457,1320,2777,ㄍㄥˋ,gèng
446,公司,2,3.職業,680,169,849,ㄍㄨㄥ ㄙ,gōngsī 
447,狗,2,1.個人資料,184,80,264,ㄍㄡˇ,gǒu
448,故事,2,4.休閒、娛樂,404,338,742,ㄍㄨˋ ㄕˋ,gùshì
449,海,2,核心詞,108,237,345,ㄏㄞˇ,hǎi
450,行2,2,8.教育、學習,226,190,416,ㄏㄤˊ,háng
451,好像,2,核心詞,259,660,919,ㄏㄠˇ ㄒㄧㄤˋ,hǎoxiàng 
452,後來,2,核心詞,418,501,919,ㄏㄡˋ ㄌㄞˊ,hòulái 
453,還2,2,核心詞,2505,3842,6347,ㄏㄨㄢˊ,huán
454,黃,2,核心詞,89,78,167,ㄏㄨㄤˊ,huáng
455,歡迎,2,6.社交、人際,71,294,365,ㄏㄨㄢ ㄧㄥˊ,huānyíng 
456,回,2,核心詞,373,215,588,ㄏㄨㄟˊ,huí
457,回到,2,核心詞,248,208,456,ㄏㄨㄟˊ ㄉㄠˋ,huídào 
458,活動,2,4.休閒、娛樂,310,303,613,ㄏㄨㄛˊ ㄉㄨㄥˋ,huódòng 
459,火,2,核心詞,96,105,201,ㄏㄨㄛˇ  ,huǒ  
460,或是,2,核心詞,303,554,857,ㄏㄨㄛˋ ㄕˋ,huòshì 
461,加,2,核心詞,110,185,295,ㄐㄧㄚ,jiā   
462,間1,2,核心詞,400,316,716,ㄐㄧㄢ ,jiān 
463,簡單,2,核心詞,212,339,551,ㄐㄧㄢˇ ㄉㄢ,jiǎndān 
464,健康,2,7.身體、醫療,224,401,625,ㄐㄧㄢˋ ㄎㄤ ,jiànkāng  
465,講,2,核心詞,268,1564,1832,ㄐㄧㄤˇ,jiǎng
466,家庭,2,1.個人資料,250,305,555,ㄐㄧㄚ ㄊㄧㄥˊ,jiātíng 
467,記得,2,核心詞,215,220,435,ㄐㄧˋ ˙ㄉㄜ,jìde 
468,接,2,核心詞,78,88,166,ㄐㄧㄝ,jiē
469,計畫/計劃,2,核心詞,286,228,514,ㄐㄧˋ ㄏㄨㄚˋ  ,jìhuà
470,機會,2,核心詞,326,364,690,ㄐㄧ ㄏㄨㄟˋ,jīhuì 
471,近,2,核心詞,146,108,254,ㄐㄧㄣˋ,jìn
472,進步,2,3.職業,79,93,172,ㄐㄧㄣˋ ㄅㄨˋ,jìnbù 
473,經過,2,核心詞,270,364,634,ㄐㄧㄥ ㄍㄨㄛˋ,jīngguò 
474,經驗,2,核心詞,363,239,602,ㄐㄧㄥ ㄧㄢˋ,jīngyàn 
475,緊張,2,核心詞,111,98,209,ㄐㄧㄣˇ ㄓㄤ,jǐnzhāng 
476,句,2,核心詞,323,264,587,ㄐㄩˋ,jù
477,決定,2,核心詞,398,244,642,ㄐㄩㄝˊ ㄉㄧㄥˋ  ,juédìng   
478,開始,2,核心詞,985,1483,2468,ㄎㄞ ㄕˇ,kāishǐ 
479,可愛,2,核心詞,56,117,173,ㄎㄜˇ ㄞˋ,kěài 
480,客人,2,9.購物、商店,82,101,183,ㄎㄜˋ ㄖㄣˊ,kèrén 
481,哭,2,核心詞,136,116,252,ㄎㄨ ,kū 
482,苦,2,核心詞,78,142,220,ㄎㄨˇ,kǔ
483,啦,2,核心詞,268,1199,1467,˙ㄌㄚ ,la
484,拉,2,核心詞,118,93,211,ㄌㄚ,lā
485,老闆/老板,2,9.購物、商店,112,80,192,ㄌㄠˇ ㄅㄢˇ ,lǎobǎn
486,老人,2,核心詞,121,79,200,ㄌㄠˇ ㄖㄣˊ,lǎorén
487,離,2,核心詞,108,80,188,ㄌㄧˊ ,lí 
488,臉,2,7.身體、醫療,311,117,428,ㄌㄧㄢˇ,liǎn
489,練習,2,8.教育、學習,94,100,194,ㄌㄧㄢˋ ㄒㄧˊ ,liànxí  
490,聊天/聊,2,6.社交、人際,79,120,199,ㄌㄧㄠˊ ㄊㄧㄢ / ㄌㄧㄠˊ,liáotiān / liáo 
491,離開,2,核心詞,287,158,445,ㄌㄧˊ ㄎㄞ,líkāi 
492,旅行,2,5.交通、旅遊,65,66,131,ㄌㄩˇ ㄒㄧㄥˊ ,lǚxíng  
493,綠,2,核心詞,63,134,197,ㄌㄩˋ ,lǜ 
494,馬,2,1.個人資料,194,108,302,ㄇㄚˇ ,mǎ 
495,賣,2,核心詞,128,219,347,ㄇㄞˋ ,mài 
496,貓,2,4.休閒、娛樂,69,49,118,ㄇㄠ,māo
497,名,2,核心詞,430,307,737,ㄇㄧㄥˊ ,míng
498,哪2,2,核心詞,275,382,657,˙ㄋㄚ,na
499,那麼,2,核心詞,488,795,1283,ㄋㄚˋ ˙ㄇㄜ,nàme
500,南,2,核心詞,77,98,175,ㄋㄢˊ,nán
501,能力,2,核心詞,389,173,562,ㄋㄥˊ ㄌㄧˋ,nénglì 
502,年輕,2,1.個人資料,205,158,363,ㄋㄧㄢˊ ㄑㄧㄥ,niánqīng 
503,鳥,2,4.休閒、娛樂,86,111,197,ㄋㄧㄠˇ ,niǎo  
504,努力,2,核心詞,258,290,548,ㄋㄨˇ ㄌㄧˋ ,nǔlì  
505,跑,2,核心詞,199,145,344,ㄆㄠˇ  ,pǎo  
506,片,2,核心詞,266,254,520,ㄆㄧㄢˋ,piàn
507,票,2,4.休閒、娛樂,30,29,59,ㄆㄧㄠˋ,piào
508,平常,2,核心詞,73,182,255,ㄆㄧㄥˊ ㄔㄤˊ,píngcháng 
509,騎,2,核心詞,91,89,180,ㄑㄧˊ,qí
510,奇怪,2,16.情緒、態度,117,96,213,ㄑㄧˊ ㄍㄨㄞˋ,qíguài 
511,汽車,2,5.交通、旅遊,122,46,168,ㄑㄧˋ ㄔㄜ,qìchē 
512,清楚,2,核心詞,299,201,500,ㄑㄧㄥ ㄔㄨˇ,qīngchǔ 
513,其他/其它,2,核心詞,735,426,1161,ㄑㄧˊ ㄊㄚ ,qítā  
514,全,2,核心詞,690,726,1416,ㄑㄩㄢˊ,quán
515,全部,2,核心詞,126,230,356,ㄑㄩㄢˊ ㄅㄨˋ,quánbù 
516,讓,2,核心詞,2186,2818,5004,ㄖㄤˋ ,ràng 
517,認識,2,核心詞,198,264,462,ㄖㄣˋ ㄕˋ,rènshì 
518,認為,2,核心詞,760,343,1103,ㄖㄣˋ ㄨㄟˊ,rènwéi 
519,如果,2,核心詞,1392,1604,2996,ㄖㄨˊ ㄍㄨㄛˇ,rúguǒ 
520,聲2,2,核心詞,230,65,295,ㄕㄥ ,shēng 
521,聲音/聲1,2,核心詞,549,259,808,ㄕㄥ ㄧㄣ / ㄕㄥ,shēngyīn / shēng 
522,試,2,核心詞,182,92,274,ㄕˋ ,shì 
523,市場,2,2.日常起居,221,143,364,ㄕˋ ㄔㄤˇ,shìchǎng 
524,世界,2,核心詞,605,775,1380,ㄕˋ ㄐㄧㄝˋ,shìjiè 
525,事情,2,核心詞,436,865,1301,ㄕˋ ㄑㄧㄥˊ,shìqíng 
526,樹,2,核心詞,156,375,531,ㄕㄨˋ ,shù 
527,雙,2,核心詞,80,61,141,ㄕㄨㄤ ,shuāng 
528,送,2,核心詞,142,182,324,ㄙㄨㄥˋ  ,sòng  
529,算,2,核心詞,146,215,361,ㄙㄨㄢˋ,suàn
530,雖然/雖,2,核心詞,777,560,1337,ㄙㄨㄟ ㄖㄢˊ / ㄙㄨㄟ,suīrán / suī 
531,所,2,核心詞,1751,912,2663,ㄙㄨㄛˇ,suǒ
532,所有,2,核心詞,563,428,991,ㄙㄨㄛˇ ㄧㄡˇ,suǒyǒu 
533,台/臺,2,核心詞,127,241,368,ㄊㄞˊ ,tái 
534,特別,2,核心詞,345,605,950,ㄊㄜˋ ㄅㄧㄝˊ ,tèbié  
535,替,2,核心詞,154,72,226,ㄊㄧˋ,tì
536,條,2,核心詞,450,328,778,ㄊㄧㄠˊ ,tiáo 
537,聽到,2,核心詞,255,179,434,ㄊㄧㄥ ㄉㄠˋ,tīngdào 
538,聽說,2,核心詞,113,120,233,ㄊㄧㄥ ㄕㄨㄛ,tīngshuō 
539,圖,2,核心詞,131,76,207,ㄊㄨˊ ,tú 
540,往,2,核心詞,382,338,720,ㄨㄤˇ,wǎng
541,網路,2,核心詞,131,104,235,ㄨㄤˇ ㄌㄨˋ,wǎnglù
542,味道/味,2,10.餐飲、烹飪,89,175,264,ㄨㄟˋ ㄉㄠˋ / ㄨㄟˋ,wèidào / wèi 
543,文化,2,核心詞,343,304,647,ㄨㄣˊ ㄏㄨㄚˋ,wénhuà 
544,屋子/屋,2,2.日常起居,165,62,227,ㄨ ˙ㄗ / ㄨ,wūzi / wū 
545,西,2,核心詞,153,181,334,ㄒㄧ,xī
546,洗,2,核心詞,56,209,265,ㄒㄧˇ ,xǐ 
547,香,2,核心詞,52,151,203,ㄒㄧㄤ,xiāng
548,想法,2,核心詞,231,188,419,ㄒㄧㄤˇ ㄈㄚˇ,xiǎngfǎ 
549,向,2,核心詞,893,259,1152,ㄒㄧㄤˋ,xiàng
550,相片/照片,2,4.休閒、娛樂,102,123,225,ㄒㄧㄤˋ ㄆㄧㄢˋ / ㄓㄠˋ ㄆㄧㄢˋ,xiàngpiàn / zhàopiàn  
551,相信,2,核心詞,338,201,539,ㄒㄧㄤ ㄒㄧㄣˋ,xiāngxìn 
552,小時候,2,核心詞,55,138,193,ㄒㄧㄠˇ ㄕˊ ㄏㄡˋ,xiǎoshíhòu  
553,小心,2,核心詞,97,149,246,ㄒㄧㄠˇ ㄒㄧㄣ,xiǎoxīn 
554,小朋友,2,核心詞,35,459,494,ㄒㄧㄠˇ ㄆㄥˊ ㄧㄡˇ,xiǎpéngyǒu 
555,笑,2,核心詞,251,105,356,ㄒㄧㄠˋ,xiào
556,夏天/夏,2,核心詞,98,167,265,ㄒㄧㄚˋ ㄊㄧㄢ / ㄒㄧㄚˋ,xiàtiān / xià 
557,習慣,2,核心詞,183,215,398,ㄒㄧˊ ㄍㄨㄢˋ ,xíguàn  
558,心,2,核心詞,694,715,1409,ㄒㄧㄣ,xīn
559,辛苦,2,核心詞,57,312,369,ㄒㄧㄣ ㄎㄨˇ,xīnkǔ
560,信,2,核心詞,233,65,298,ㄒㄧㄣˋ ,xìn 
561,行1,2,核心詞,226,190,416,ㄒㄧㄥˊ ,xíng 
562,希望,2,核心詞,499,916,1415,ㄒㄧ ㄨㄤˋ,xīwàng 
563,學習,2,核心詞,497,380,877,ㄒㄩㄝˊ ㄒㄧˊ,xuéxí 
564,需要/需,2,核心詞,791,682,1473,ㄒㄩ ㄧㄠˋ / ㄒㄩ,xūyào / xū
565,呀,2,核心詞,238,304,542,˙ㄧㄚ ,ya 
566,樣子,2,核心詞,122,193,315,ㄧㄤˋ ˙ㄗ,yàngzi 
567,顏色,2,核心詞,73,134,207,ㄧㄢˊ ㄙㄜˋ,yánsè 
568,醫院,2,7.身體、醫療,137,218,355,ㄧ ㄩㄢˋ ,yīyuàn  
569,一半,2,核心詞,88,84,172,ㄧˊ　 ㄅㄢˋ,yíbàn 
570,一下子/一下,2,核心詞,374,631,1005,ㄧˊ　 ㄒㄧㄚˋ ˙ㄗ / ㄧˊ　 ㄒㄧㄚˋ,yíxiàzi/ yíxià
571,一直,2,核心詞,476,813,1289,ㄧˋ ㄓˊ ,yìzhí  
572,以為,2,核心詞,229,117,346,ㄧˇ ㄨㄟˊ,yǐwéi 
573,已經,2,核心詞,978,1519,2497,ㄧˇ ㄐㄧㄥ,yǐjīng
574,銀行,2,11.公共服務,91,108,199,ㄧㄣˊ ㄏㄤˊ,yínháng
575,音樂,2,4.休閒、娛樂,148,104,252,ㄧㄣ ㄩㄝˋ ,yīnyuè  
576,有的,2,核心詞,125,218,343,ㄧㄡˇ ㄉㄜ˙,yǒude 
577,遠,2,核心詞,214,178,392,ㄩㄢˇ,yuǎn
578,願意,2,核心詞,201,224,425,ㄩㄢˋ ㄧˋ,yuànyì 
579,語言/語,2,1.個人資料,219,87,306,ㄩˇ ㄧㄢˊ ,yǔyán/yǔ  
580,怎麼辦,2,核心詞,75,158,233,ㄗㄣˇ ˙ㄇㄜ ㄅㄢˋ,zěnmebàn  
581,長2,2,核心詞,434,469,903,ㄓㄤˇ ,zhǎng 
582,找到,2,核心詞,272,228,500,ㄓㄠˇ ㄉㄠˋ,zhǎodào
583,這麼,2,核心詞,468,851,1319,ㄓㄜˋ ˙ㄇㄜ,zhème
584,支,2,核心詞,100,95,195,ㄓ,zhī
585,隻,2,核心詞,389,277,666,ㄓ ,zhī 
586,中間,2,核心詞,73,142,215,ㄓㄨㄥ ㄐㄧㄢ,zhōngjiān 
587,種1,2,核心詞,2584,3158,5742,ㄓㄨㄥˇ,zhǒng
588,重1,2,核心詞,115,151,266,ㄓㄨㄥˋ ,zhòng 
589,重要,2,核心詞,611,812,1423,ㄓㄨㄥˋ ㄧㄠˋ,zhòngyào
590,轉1,2,核心詞,76,92,168,ㄓㄨㄢˇ,zhuǎn
591,準備,2,核心詞,264,304,568,ㄓㄨㄣˇ ㄅㄟˋ,zhǔnbèi 
592,注意,2,核心詞,200,151,351,ㄓㄨˋ ㄧˋ,zhùyì 
593,總是/總,2,核心詞,448,203,651,ㄗㄨㄥˇ ㄕˋ / ㄗㄨㄥˇ,zǒngshì / zǒng 
594,最後,2,核心詞,572,451,1023,ㄗㄨㄟˋ ㄏㄡˋ,zuìhòu
595,最近,2,核心詞,133,222,355,ㄗㄨㄟˋ ㄐㄧㄣˋ,zuìjìn 
596,作業,2,8.教育、學習,78,72,150,ㄗㄨㄛˋ ㄧㄝˋ,zuòyè 
597,阿姨,2.5,1.個人資料,22,52,74,ㄚ ㄧˊ,āyí 
598,白天,2.5,核心詞,45,49,94,ㄅㄞˊ ㄊㄧㄢ,báitiān 
599,百貨公司,2.5,9.購物、商店,14,5,19,ㄅㄞˇ ㄏㄨㄛˋ ㄍㄨㄥ ㄙ,bǎihuògōngsī   
600,搬,2.5,核心詞,17,32,49,ㄅㄢ,bān
601,搬家,2.5,2.日常起居,12,10,22,ㄅㄢ ㄐㄧㄚ,bānjiā 
602,辦公室,2.5,3.職業,98,31,129,ㄅㄢˋ ㄍㄨㄥ ㄕˋ,bàngōngshì
603,棒球,2.5,4.休閒、娛樂,14,6,20,ㄅㄤˋ ㄑㄧㄡˊ ,bàngqiú  
604,報紙,2.5,5.交通、旅遊,72,38,110,ㄅㄠˋ ㄓˇ,bàozhǐ 
605,巴士,2.5,5.交通、旅遊,13,10,23,ㄅㄚ ㄕˋ,bāshì 
606,背包,2.5,核心詞,14,6,20,ㄅㄟ ㄅㄠ,bēibāo 
607,北部,2.5,核心詞,20,74,94,ㄅㄟˇ ㄅㄨˋ,běibù  
608,本子,2.5,8.教育、學習,7,3,10,ㄅㄣˇ ˙ㄗ,běnzi 
609,笨,2.5,核心詞,27,21,48,ㄅㄣˋ,bèn
610,便利商店,2.5,核心詞,0,0,0,ㄅㄧㄢˋ ㄌㄧˋ ㄕㄤ ㄉㄧㄢˋ,biànlìshāngdiàn   
611,別的,2.5,核心詞,55,38,93,ㄅㄧㄝˊ ˙ㄉㄜ,biéde 
612,比方說/比方,2.5,核心詞,20,82,102,ㄅㄧˇ ㄈㄤ ㄕㄨㄛ / ㄅㄧˇ ㄈㄤ,bǐfāngshuō / bǐfāng   
613,冰塊,2.5,10.餐飲、烹飪,7,16,23,ㄅㄧㄥ ㄎㄨㄞˋ,bīngkuài 
614,冰淇淋,2.5,10.餐飲、烹飪,13,4,17,ㄅㄧㄥ ㄑㄧˊ ㄌㄧㄣˊ,bīngqílín  
615,冰箱,2.5,2.日常起居,20,29,49,ㄅㄧㄥ ㄒㄧㄤ,bīngxiāng 
616,伯伯/伯,2.5,1.個人資料,11,30,41,ㄅㄛˊ ˙ㄅㄛ / ㄅㄛˊ,bóbo / bó 
617,不好意思,2.5,6.社交、人際,15,54,69,ㄅㄨˋ ㄏㄠˇ ㄧˋ ˙ㄙ ,bùhǎoyìsi    
618,不見了,2.5,核心詞,36,17,53,ㄅㄨˊ ㄐㄧㄢˋ ˙ㄌㄜ,bújiànle
619,不客氣,2.5,6.社交、人際,0,0,0,ㄅㄨˊ ㄎㄜˋ ㄑㄧˋ,búkèqì
620,菜單,2.5,10.餐飲、烹飪,8,7,15,ㄘㄞˋ ㄉㄢ,càidān 
621,餐,2.5,核心詞,25,63,88,ㄘㄢ,cān
622,草,2.5,13.自然環境,46,196,242,ㄘㄠˇ,cǎo
623,茶館,2.5,5.交通、旅遊,11,1,12,ㄔㄚˊ ㄍㄨㄢˇ,cháguǎn 
624,炒,2.5,10.餐飲、烹飪,28,53,81,ㄔㄠˇ ,chǎo 
625,超商,2.5,9.購物、商店,5,5,10,ㄔㄠ ㄕㄤ,chāoshāng
626,超市/超級市場,2.5,9.購物、商店,17,19,36,ㄔㄠ ㄕˋ / ㄔㄠ ㄐㄧˊ ㄕˋ ㄔㄤˇ,chāoshì/ chāojíshìchǎng
627,叉子/叉,2.5,10.餐飲、烹飪,12,14,26,ㄔㄚ ˙ㄗ / ㄔㄚ,chāzi / chā 
628,車站,2.5,5.交通、旅遊,27,25,52,ㄔㄜ ㄓㄢˋ,chēzhàn 
629,臭,2.5,核心詞,33,30,63,ㄔㄡˋ,chòu
630,窗/窗戶/窗子,2.5,2.日常起居,124,51,175,ㄔㄨㄤ / ㄔㄨㄤ ㄏㄨˋ / ㄔㄨㄤ ˙ㄗ,chuāng / chuānghù / chuāngzi  
631,聰明,2.5,核心詞,135,81,216,ㄘㄨㄥ ㄇㄧㄥˊ,cōngmíng 
632,從前,2.5,核心詞,51,13,64,ㄘㄨㄥˊ ㄑㄧㄢˊ,cóngqián 
633,袋,2.5,核心詞,18,37,55,ㄉㄞˋ,dài
634,袋子,2.5,核心詞,15,23,38,ㄉㄞˋ ˙ㄗ,dàizi 
635,打算,2.5,核心詞,96,37,133,ㄉㄚˇ ㄙㄨㄢˋ ,dǎsuàn  
636,大樓,2.5,2.日常起居,32,37,69,ㄉㄚˋ ㄌㄡˊ,dàlóu 
637,大門,2.5,2.日常起居,54,12,66,ㄉㄚˋ ㄇㄣˊ,dàmén 
638,大衣,2.5,9.購物、商店,14,2,16,ㄉㄚˋ ㄧ ,dàyī  
639,蛋糕,2.5,10.餐飲、烹飪,19,14,33,ㄉㄢˋ ㄍㄠ,dàngāo 
640,刀子/刀,2.5,10.餐飲、烹飪,99,57,156,ㄉㄠ ˙ㄗ / ㄉㄠ,dāozi/dāo   
641,燈,2.5,核心詞,54,72,126,ㄉㄥ,dēng
642,德文,2.5,8.教育、學習,4,2,6,ㄉㄜˊ ㄨㄣˊ,déwén 
643,點心,2.5,10.餐飲、烹飪,18,13,31,ㄉㄧㄢˇ ㄒㄧㄣ,diǎnxīn 
644,電梯,2.5,2.日常起居,18,10,28,ㄉㄧㄢˋ ㄊㄧ,diàntī 
645,掉,2.5,核心詞,46,146,192,ㄉㄧㄠˋ,diào
646,地圖,2.5,核心詞,36,61,97,ㄉㄧˋ ㄊㄨˊ,dìtú 
647,地址,2.5,1.個人資料,21,9,30,ㄉㄧˋ ㄓˇ,dìzhǐ 
648,東,2.5,核心詞,96,163,259,ㄉㄨㄥ,dōng
649,對面,2.5,核心詞,30,17,47,ㄉㄨㄟˋ ㄇㄧㄢˋ,duìmiàn 
650,肚子/肚,2.5,7.身體、醫療,84,80,164,ㄉㄨˋ ˙ㄗ / ㄉㄨˋ,dùzi / dù 
651,飯店,2.5,5.交通、旅遊,44,21,65,ㄈㄢˋ ㄉㄧㄢˋ,fàndiàn 
652,飯廳,2.5,2.日常起居,5,1,6,ㄈㄢˋ ㄊㄧㄥ ,fàntīng  
653,房租,2.5,2.日常起居,5,6,11,ㄈㄤˊ ㄗㄨ,fáng zū 
654,房東,2.5,2.日常起居,5,2,7,ㄈㄤˊ ㄉㄨㄥ,fángdōng 
655,法文,2.5,8.教育、學習,9,4,13,ㄈㄚˇ ㄨㄣˊ,fǎwén 
656,飛,2.5,13.自然環境,85,53,138,ㄈㄟ,fēi
657,風景,2.5,5.交通、旅遊,26,34,60,ㄈㄥ ㄐㄧㄥˇ,fēngjǐng 
658,付,2.5,核心詞,40,31,71,ㄈㄨˋ,fù
659,公共汽車,2.5,5.交通、旅遊,3,1,4,ㄍㄨㄥ ㄍㄨㄥˋ ㄑㄧˋ ㄔㄜ,gōnggòngqìchē
660,掛,2.5,核心詞,79,37,116,ㄍㄨㄚˋ,guà
661,關,2.5,核心詞,70,91,161,ㄍㄨㄢ ,guān 
662,罐子/罐,2.5,核心詞,16,20,36,ㄍㄨㄢˋ ˙ㄗ / ㄍㄨㄢˋ,guànzi / guàn
663,過年,2.5,15.文化,13,45,58,ㄍㄨㄛˋ ㄋㄧㄢˊ,guònián 
664,果汁,2.5,10.餐飲、烹飪,8,10,18,ㄍㄨㄛˇ ㄓ,guǒzhī 
665,漢堡,2.5,10.餐飲、烹飪,12,4,16,ㄏㄢˋ ㄅㄠˇ,hànbǎo 
666,號碼,2.5,核心詞,22,10,32,ㄏㄠˋ ㄇㄚˇ,hàomǎ
667,河,2.5,核心詞,114,99,213,ㄏㄜˊ,hé
668,盒子/盒,2.5,核心詞,40,29,69,ㄏㄜˊ ˙ㄗ / ㄏㄜˊ,hézi / hé
669,紅茶,2.5,10.餐飲、烹飪,4,33,37,ㄏㄨㄥˊ ㄔㄚˊ,hóngchá
670,壞,2.5,核心詞,108,79,187,ㄏㄨㄞˋ ,huài 
671,火腿,2.5,10.餐飲、烹飪,5,2,7,ㄏㄨㄛˇ ㄊㄨㄟˇ,huǒtuǐ
672,護士,2.5,7.身體、醫療,43,21,64,ㄏㄨˋ ㄕˋ,hùshì 
673,寄,2.5,11.公共服務,27,16,43,ㄐㄧˋ,jì
674,見面,2.5,核心詞,54,23,77,ㄐㄧㄢˋ ㄇㄧㄢˋ,jiànmiàn 
675,交,2.5,核心詞,37,37,74,ㄐㄧㄠ ,jiāo 
676,腳踏車,2.5,5.交通、旅遊,26,54,80,ㄐㄧㄠˇ ㄊㄚˋ ㄔㄜ,jiǎotàchē  
677,餃子/餃,2.5,10.餐飲、烹飪,4,2,6,ㄐㄧㄠˇ ˙ㄗ / ㄐㄧㄠˇ,jiǎozi / jiǎo 
678,加油,2.5,6.社交、人際,14,109,123,ㄐㄧㄚ ㄧㄡˊ,jiāyóu 
679,機場,2.5,5.交通、旅遊,31,29,60,ㄐㄧ ㄔㄤˇ,jīchǎng 
680,街,2.5,5.交通、旅遊,60,48,108,ㄐㄧㄝ,jiē
681,借,2.5,核心詞,56,77,133,ㄐㄧㄝˋ ,jiè 
682,開學,2.5,8.教育、學習,9,10,19,ㄎㄞ ㄒㄩㄝˊ,kāixué 
683,考,2.5,8.教育、學習,45,87,132,ㄎㄠˇ,kǎo
684,烤,2.5,10.餐飲、烹飪,33,23,56,ㄎㄠˇ ,kǎo 
685,渴,2.5,核心詞,10,4,14,ㄎㄜˇ  ,kě  
686,可樂,2.5,10.餐飲、烹飪,13,3,16,ㄎㄜˇ ㄌㄜˋ,kělè 
687,課本,2.5,8.教育、學習,14,18,32,ㄎㄜˋ ㄅㄣˇ,kèběn 
688,客氣,2.5,核心詞,26,25,51,ㄎㄜˋ ㄑㄧˋ,kèqì 
689,客廳,2.5,2.日常起居,48,17,65,ㄎㄜˋ ㄊㄧㄥ,kètīng 
690,空1,2.5,核心詞,55,71,126,ㄎㄨㄥˋ ,kòng 
691,褲子/褲,2.5,9.購物、商店,18,9,27,ㄎㄨˋ ˙ㄗ / ㄎㄨˋ,kùzi / kù 
692,辣,2.5,10.餐飲、烹飪,12,21,33,ㄌㄚˋ,là  
693,藍,2.5,核心詞,60,30,90,ㄌㄢˊ,lán
694,籃球,2.5,4.休閒、娛樂,14,18,32,ㄌㄢˊ ㄑㄧㄡˊ ,lánqiú  
695,冷氣,2.5,2.日常起居,8,24,32,ㄌㄥˇ ㄑㄧˋ,lěngqì 
696,禮拜,2.5,核心詞,33,129,162,ㄌㄧˇ ㄅㄞˋ,lǐbài 
697,零,2.5,核心詞,23,35,58,ㄌㄧㄥˊ,líng
698,樓上,2.5,2.日常起居,14,5,19,ㄌㄡˊ ㄕㄤˋ,lóushàng 
699,樓梯,2.5,2.日常起居,35,16,51,ㄌㄡˊ ㄊㄧ,lóutī 
700,樓下,2.5,2.日常起居,9,3,12,ㄌㄡˊ ㄒㄧㄚˋ,lóuxià 
701,旅館,2.5,4.休閒、娛樂,58,16,74,ㄌㄩˇ ㄍㄨㄢˇ,lǚguǎn
702,路口,2.5,5.交通、旅遊,4,1,5,ㄌㄨˋ ㄎㄡˇ,lùkǒu 
703,麻煩,2.5,核心詞,79,75,154,ㄇㄚˊ ㄈㄢˊ ,máfán  
704,馬路,2.5,5.交通、旅遊,26,24,50,ㄇㄚˇ ㄌㄨˋ,mǎlù 
705,饅頭,2.5,10.餐飲、烹飪,4,14,18,ㄇㄢˊ ˙ㄊㄡ,mántou 
706,慢跑,2.5,4.休閒、娛樂,13,1,14,ㄇㄢˋ ㄆㄠˇ ,mànpǎo  
707,帽子/帽,2.5,9.購物、商店,49,29,78,ㄇㄠˋ ˙ㄗ / ㄇㄠˋ,màozi / mào 
708,門票,2.5,4.休閒、娛樂,3,2,5,ㄇㄣˊ ㄆㄧㄠˋ,ménpiào 
709,奶茶,2.5,10.餐飲、烹飪,3,4,7,ㄋㄞˇ ㄔㄚˊ,nǎichá 
710,奶奶,2.5,1.個人資料,29,55,84,ㄋㄞˇ ˙ㄋㄞ,nǎinai 
711,難過,2.5,核心詞,53,43,96,ㄋㄢˊ ㄍㄨㄛˋ,nánguò 
712,男生,2.5,核心詞,55,73,128,ㄋㄢˊ ㄕㄥ,nánshēng 
713,年級,2.5,8.教育、學習,4,5,9,ㄋㄧㄢˊ ㄐㄧˊ,niánjí 
714,念書/唸書,2.5,8.教育、學習,23,68,91,ㄋㄧㄢˋ ㄕㄨ ,niànshū  
715,女生,2.5,核心詞,57,87,144,ㄋㄩˇ ㄕㄥ,nǚshēng 
716,盤子/盤,2.5,10.餐飲、烹飪,58,43,101,ㄆㄢˊ ˙ㄗ / ㄆㄢˊ,pánzi / pán
717,跑步,2.5,4.休閒、娛樂,65,23,88,ㄆㄠˇ ㄅㄨˋ  ,pǎobù   
718,皮包,2.5,9.購物、商店,9,3,12,ㄆㄧˊ ㄅㄠ ,píbāo  
719,啤酒,2.5,10.餐飲、烹飪,33,2,35,ㄆㄧˊ ㄐㄧㄡˇ,píjiǔ 
720,蘋果,2.5,10.餐飲、烹飪,41,25,66,ㄆㄧㄥˊ ㄍㄨㄛˇ,píngguǒ 
721,瓶子/瓶,2.5,核心詞,54,74,128,ㄆㄧㄥˊ ˙ㄗ / ㄆㄧㄥˊ,píngzi / píng
722,錢包,2.5,核心詞,5,3,8,ㄑㄧㄢˊ ㄅㄠ,qiánbāo 
723,輕,2.5,核心詞,73,46,119,ㄑㄧㄥ,qīng
724,青菜,2.5,10.餐飲、烹飪,5,18,23,ㄑㄧㄥ ㄘㄞˋ ,qīngcài  
725,汽水,2.5,10.餐飲、烹飪,5,5,10,ㄑㄧˋ ㄕㄨㄟˇ,qìshuǐ 
726,秋天/秋,2.5,核心詞,55,87,142,ㄑㄧㄡ ㄊㄧㄢ / ㄑㄧㄡ,qiūtiān  / qiū 
727,裙子/裙,2.5,9.購物、商店,12,8,20,ㄑㄩㄣˊ ˙ㄗ / ㄑㄩㄣˊ,qúnzi / qún 
728,熱狗,2.5,10.餐飲、烹飪,3,0,3,ㄖㄜˋ ㄍㄡˇ,règǒu 
729,日文,2.5,8.教育、學習,8,6,14,ㄖˋ ㄨㄣˊ,rìwén 
730,日語,2.5,8.教育、學習,7,2,9,ㄖˋ ㄩˇ,rìyǔ 
731,三明治,2.5,10.餐飲、烹飪,10,7,17,ㄙㄢ ㄇㄧㄥˊ ㄓˋ,sānmíngzhì  
732,色,2.5,核心詞,32,33,65,ㄙㄜˋ,sè
733,商店,2.5,9.購物、商店,34,22,56,ㄕㄤ ㄉㄧㄢˋ,shāngdiàn 
734,上班,2.5,3.職業,47,67,114,ㄕㄤˋ ㄅㄢ,shàngbān 
735,上網,2.5,2.日常起居,18,25,43,ㄕㄤˋ ㄨㄤˇ,shàngwǎng
736,上學,2.5,8.教育、學習,36,74,110,ㄕㄤˋ ㄒㄩㄝˊ,shàngxué 
737,生氣,2.5,核心詞,93,114,207,ㄕㄥ ㄑㄧˋ,shēngqì 
738,十字路口,2.5,5.交通、旅遊,5,4,9,ㄕˊ ㄗˋ ㄌㄨˋ ㄎㄡˇ,shízìlùkǒu
739,市,2.5,核心詞,13,16,29,ㄕˋ ,shì 
740,室友,2.5,2.日常起居,5,3,8,ㄕˋ ㄧㄡˇ,shìyǒu 
741,手錶/手表/錶/表1,2.5,9.購物、商店,68,49,117,ㄕㄡˇ ㄅㄧㄠˇ / ㄅㄧㄠˇ   ,shǒubiǎo / biǎo
742,書包,2.5,8.教育、學習,7,15,22,ㄕㄨ ㄅㄠ,shūbāo 
743,書店,2.5,2.日常起居,32,7,39,ㄕㄨ ㄉㄧㄢˋ,shūdiàn 
744,書房,2.5,2.日常起居,24,5,29,ㄕㄨ ㄈㄤˊ,shūfáng 
745,叔叔/叔,2.5,1.個人資料,43,100,143,ㄕㄨˊ ˙ㄕㄨ / ㄕㄨˊ,shúshu / shú 
746,司機,2.5,5.交通、旅遊,34,17,51,ㄙ ㄐㄧ,sījī 
747,酸,2.5,10.餐飲、烹飪,21,56,77,ㄙㄨㄢ,suān
748,宿舍,2.5,2.日常起居,19,16,35,ㄙㄨˋ ㄕㄜˋ,sùshè 
749,湯匙,2.5,10.餐飲、烹飪,9,2,11,ㄊㄤ ㄔˊ,tāngchí 
750,糖,2.5,10.餐飲、烹飪,39,54,93,ㄊㄤˊ ,táng 
751,踢,2.5,核心詞,41,11,52,ㄊㄧ  ,tī  
752,甜點,2.5,10.餐飲、烹飪,5,5,10,ㄊㄧㄢˊ ㄉㄧㄢˇ,tiándiǎn 
753,頭髮/髮,2.5,7.身體、醫療,94,59,153,ㄊㄡˊ ㄈㄚˇ / ㄈㄚˇ,tóufǎ / fǎ 
754,脫,2.5,核心詞,25,33,58,ㄊㄨㄛ,tuō
755,圖書館,2.5,8.教育、學習,48,27,75,ㄊㄨˊ ㄕㄨ ㄍㄨㄢˇ,túshūguǎn  
756,外套,2.5,9.購物、商店,21,9,30,ㄨㄞˋ ㄊㄠˋ,wàitào 
757,忘,2.5,核心詞,99,63,162,ㄨㄤˋ ,wàng 
758,網球,2.5,4.休閒、娛樂,9,2,11,ㄨㄤˇ ㄑㄧㄡˊ    ,wǎngqiú     
759,網站,2.5,4.休閒、娛樂,22,5,27,ㄨㄤˇ ㄓㄢˋ,wǎngzhàn 
760,喂,2.5,核心詞,23,26,49,ㄨㄟˊ,wéi
761,下班,2.5,3.職業,19,20,39,ㄒㄧㄚˋ ㄅㄢ,xiàbān 
762,鹹,2.5,10.餐飲、烹飪,12,21,33,ㄒㄧㄢˊ,xián
763,香蕉,2.5,10.餐飲、烹飪,14,66,80,ㄒㄧㄤ ㄐㄧㄠ ,xiāngjiāo  
764,小學,2.5,1.個人資料,50,111,161,ㄒㄧㄠˇ ㄒㄩㄝˊ,xiǎoxué 
765,下雪,2.5,13.自然環境,5,9,14,ㄒㄧㄚˋ ㄒㄩㄝˇ,xiàxuě 
766,西瓜,2.5,10.餐飲、烹飪,11,20,31,ㄒㄧ ㄍㄨㄚ,xīguā 
767,新年,2.5,15.文化,7,15,22,ㄒㄧㄣ ㄋㄧㄢˊ,xīnnián 
768,信用卡,2.5,9.購物、商店,11,5,16,ㄒㄧㄣˋ ㄩㄥˋ ㄎㄚˇ,xìnyòngkǎ  
769,洗手間,2.5,2.日常起居,6,4,10,ㄒㄧˇ ㄕㄡˇ ㄐㄧㄢ,xǐshǒujiān  
770,洗澡,2.5,2.日常起居,23,34,57,ㄒㄧˇ ㄗㄠˇ,xǐzǎo 
771,雪,2.5,5.交通、旅遊,48,78,126,ㄒㄩㄝˇ ,xuě
772,眼鏡,2.5,9.購物、商店,27,14,41,ㄧㄢˇ ㄐㄧㄥˋ,yǎnjìng 
773,要是,2.5,核心詞,123,54,177,ㄧㄠˋ ㄕˋ,yàoshì
774,爺爺,2.5,1.個人資料,33,105,138,ㄧㄝˊ ˙ㄧㄝ,yéye 
775,野餐,2.5,4.休閒、娛樂,5,2,7,ㄧㄝˇ ㄘㄢ ,yěcān  
776,夜市,2.5,9.購物、商店,5,13,18,ㄧㄝˋ ㄕˋ,yèshì 
777,一會/一會兒,2.5,核心詞,111,13,124,ㄧˋ ㄏㄨㄟˇ / ㄧˋ ㄏㄨㄟˇ ㄦ,yìhuǐ/yìhuǐr     
778,一塊/一塊兒,2.5,核心詞,13,18,31,ㄧˊ ㄎㄨㄞˋ / ㄧˊ ㄎㄨㄞˋ ㄦ,yíkuài/yíkuàir     
779,英語,2.5,8.教育、學習,28,13,41,ㄧㄥ ㄩˇ,yīngyǔ 
780,用功,2.5,8.教育、學習,13,13,26,ㄩㄥˋ ㄍㄨㄥ ,yònggōng  
781,游,2.5,4.休閒、娛樂,15,20,35,ㄧㄡˊ,yóu
782,郵局,2.5,11.公共服務,11,7,18,ㄧㄡˊ ㄐㄩˊ,yóujú 
783,郵票,2.5,11.公共服務,5,2,7,ㄧㄡˊ ㄆㄧㄠˋ ,yóupiào  
784,游泳,2.5,4.休閒、娛樂,22,31,53,ㄧㄡˊ ㄩㄥˇ ,yóuyǒng  
785,游泳池,2.5,4.休閒、娛樂,8,8,16,ㄧㄡˊ ㄩㄥˇ ㄔˊ,yóuyǒngchí  
786,有空,2.5,4.休閒、娛樂,10,25,35,ㄧㄡˇ ㄎㄨㄥˋ,yǒukòng 
787,有名,2.5,核心詞,41,40,81,ㄧㄡˇ ㄇㄧㄥˊ,yǒumíng 
788,有錢,2.5,核心詞,34,20,54,ㄧㄡˇ ㄑㄧㄢˊ,yǒuqián 
789,有意思,2.5,核心詞,23,27,50,ㄧㄡˇ ㄧˋ ˙ㄙ,yǒuyìsi  
790,有用,2.5,核心詞,49,29,78,ㄧㄡˇ ㄩㄥˋ,yǒuyòng 
791,炸1,2.5,10.餐飲、烹飪,16,17,33,ㄓㄚˊ ,zhá 
792,照相,2.5,4.休閒、娛樂,5,7,12,ㄓㄠˋ ㄒㄧㄤˋ,zhàoxiàng 
793,週日,2.5,核心詞,6,3,9,ㄓㄡ ㄖˋ,zhōurì 
794,週一,2.5,核心詞,4,3,7,ㄓㄡ ㄧ,zhōuyī 
795,祝,2.5,6.社交、人際,10,16,26,ㄓㄨˋ,zhù
796,字典,2.5,8.教育、學習,7,5,12,ㄗˋ ㄉㄧㄢˇ,zìdiǎn 
797,租,2.5,2.日常起居,19,30,49,ㄗㄨ ,zū 
798,足球,2.5,4.休閒、娛樂,14,8,22,ㄗㄨˊ ㄑㄧㄡˊ,zúqiú   
799,安全,3,12.安全,147,261,408,ㄢ ㄑㄩㄢˊ ,ānquán  
800,報告,3,3.職業,136,95,231,ㄅㄠˋ ㄍㄠˋ ,bàogào  
801,背1,3,7.身體、醫療,115,116,231,ㄅㄟˋ  ,bèi  
802,背2,3,核心詞,115,116,231,ㄅㄟ   ,bēi   
803,遍,3,核心詞,86,47,133,ㄅㄧㄢˋ,biàn
804,便當,3,10.餐飲、烹飪,12,35,47,ㄅㄧㄢˋ ㄉㄤ,biàndāng 
805,餅乾,3,10.餐飲、烹飪,16,32,48,ㄅㄧㄥˇ ㄍㄢ ,bǐnggān  
806,必須/須,3,核心詞,752,402,1154,ㄅㄧˋ ㄒㄩ /ㄒㄩ,bìxū /xū 
807,畢業,3,8.教育、學習,85,116,201,ㄅㄧˋ ㄧㄝˋ,bìyè 
808,不必,3,核心詞,125,32,157,ㄅㄨˊ ㄅㄧˋ,búbì 
809,不但,3,核心詞,193,170,363,ㄅㄨˊ ㄉㄢˋ ,búdàn  
810,不同,3,核心詞,591,518,1109,ㄅㄨˋ ㄊㄨㄥˊ ,bùtóng  
811,不用,3,核心詞,87,240,327,ㄅㄨˊ ㄩㄥˋ,búyòng 
812,草莓,3,10.餐飲、烹飪,5,22,27,ㄘㄠˇ ㄇㄟˊ,cǎoméi 
813,廁所,3,2.日常起居,25,35,60,ㄘㄜˋ ㄙㄨㄛˇ,cèsuǒ 
814,查,3,核心詞,32,26,58,ㄔㄚˊ,chá
815,城市/城,3,5.交通、旅遊,239,199,438,ㄔㄥˊ ㄕˋ / ㄔㄥˊ,chéngshì / chéng 
816,遲到,3,8.教育、學習,14,14,28,ㄔˊ ㄉㄠˋ,chídào 
817,船,3,5.交通、旅遊,141,98,239,ㄔㄨㄢˊ,chuán  
818,傳統,3,核心詞,204,233,437,ㄔㄨㄢˊ　ㄊㄨㄥˇ  ,chuántǒng  
819,廚房,3,2.日常起居,74,47,121,ㄔㄨˊ ㄈㄤˊ ,chúfáng  
820,出國,3,5.交通、旅遊,22,25,47,ㄔㄨ ㄍㄨㄛˊ,chūguó 
821,出口,3,5.交通、旅遊,35,28,63,ㄔㄨ ㄎㄡˇ ,chūkǒu  
822,出門,3,2.日常起居,58,61,119,ㄔㄨ ㄇㄣˊ,chūmén 
823,春節,3,15.文化,6,7,13,ㄔㄨㄣ ㄐㄧㄝˊ,chūnjié 
824,詞,3,8.教育、學習,64,20,84,ㄘˊ,cí
825,搭,3,5.交通、旅遊,68,63,131,ㄉㄚ,dā
826,打工,3,3.職業,11,53,64,ㄉㄚˇ ㄍㄨㄥ,dǎgōng 
827,打折,3,9.購物、商店,3,2,5,ㄉㄚˇ ㄓㄜˊ,dǎzhé 
828,大概,3,核心詞,159,761,920,ㄉㄚˋ  ㄍㄞˋ   ,dàgài    
829,大學生,3,1.個人資料,25,26,51,ㄉㄚˋ ㄒㄩㄝˊ ㄕㄥ,dàxuéshēng  
830,到處,3,核心詞,87,90,177,ㄉㄠˋ ㄔㄨˋ,dàochù 
831,電影院,3,4.休閒、娛樂,9,6,15,ㄉㄧㄢˋ ㄧㄥˇ ㄩㄢˋ,diànyǐngyuàn  
832,店員,3,9.購物、商店,28,4,32,ㄉㄧㄢˋ ㄩㄢˊ,diànyuán 
833,訂,3,4.休閒、娛樂,22,20,42,ㄉㄧㄥˋ,dìng
834,訂位,3,9.購物、商店,2,1,3,ㄉㄧㄥˋ ㄨㄟˋ,dìngwèi 
835,地鐵,3,5.交通、旅遊,7,14,21,ㄉㄧˋ ㄊㄧㄝˇ,dìtiě 
836,丟,3,核心詞,47,59,106,ㄉㄧㄡ   ,diū   
837,底下,3,核心詞,61,82,143,ㄉㄧˇ ㄒㄧㄚˋ,dǐxià 
838,豆腐,3,10.餐飲、烹飪,14,27,41,ㄉㄡˋ ㄈㄨˇ ,dòufǔ  
839,豆漿,3,10.餐飲、烹飪,3,17,20,ㄉㄡˋ ㄐㄧㄤ ,dòujiāng  
840,度,3,5.交通、旅遊,92,295,387,ㄉㄨˋ  ,dù  
841,讀書,3,8.教育、學習,83,136,219,ㄉㄨˊ ㄕㄨ,dúshū
842,耳機,3,17.科技,5,4,9,ㄦˇ ㄐㄧ,ěrjī     
843,而且/且,3,核心詞,989,1026,2015,ㄦˊ ㄑㄧㄝˇ/ㄑㄧㄝˇ,érqiě/qiě 
844,放假,3,3.職業,5,24,29,ㄈㄤˋ ㄐㄧㄚˋ,fàngjià 
845,番茄,3,10.餐飲、烹飪,9,61,70,ㄈㄢ ㄑㄧㄝˊ ,fānqié  
846,發生,3,12.安全,524,520,1044,ㄈㄚ ㄕㄥ,fāshēng 
847,肥皂,3,2.日常起居,9,23,32,ㄈㄟˊ ㄗㄠˋ,féizào 
848,封,3,11.公共服務,137,37,174,ㄈㄥ ,fēng 
849,鳳梨,3,10.餐飲、烹飪,5,86,91,ㄈㄥˋ ㄌㄧˊ  ,fènglí   
850,服務,3,核心詞,160,142,302,ㄈㄨˊ ㄨˋ ,fúwù  
851,父母,3,核心詞,397,171,568,ㄈㄨˋ ㄇㄨˇ,fùmǔ 
852,父親,3,核心詞,391,178,569,ㄈㄨˋ ㄑㄧㄣ,fùqīn 
853,乾1,3,核心詞,50,99,149,ㄍㄢ  ,gān  
854,剛才,3,核心詞,62,145,207,ㄍㄤ ㄘㄞˊ,gāngcái 
855,趕快,3,核心詞,45,260,305,ㄍㄢˇ ㄎㄨㄞˋ,gǎnkuài 
856,逛,3,4.休閒、娛樂,14,16,30,ㄍㄨㄤˋ,guàng
857,逛街,3,9.購物、商店,6,8,14,ㄍㄨㄤˋ ㄐㄧㄝ ,guàngjiē  
858,關係,3,核心詞,564,426,990,ㄍㄨㄢ ㄒㄧˋ,guānxì 
859,關心,3,核心詞,90,141,231,ㄍㄨㄢ ㄒㄧㄣ ,guānxīn  
860,還好,3,核心詞,27,82,109,ㄏㄞˊ ㄏㄠˇ,háihǎo 
861,海鮮,3,10.餐飲、烹飪,5,2,7,ㄏㄞˇ ㄒㄧㄢ ,hǎixiān  
862,寒假,3,8.教育、學習,4,4,8,ㄏㄢˊ ㄐㄧㄚˋ,hánjià 
863,漢字,3,8.教育、學習,11,1,12,ㄏㄢˋ ㄗˋ,hànzì 
864,好處,3,核心詞,69,62,131,ㄏㄠˇ  ㄔㄨˋ,hǎochù 
865,黑板,3,8.教育、學習,7,8,15,ㄏㄟ ㄅㄢˇ,hēibǎn 
866,花2,3,核心詞,331,411,742,ㄏㄨㄚ,huā
867,壞處,3,核心詞,6,4,10,ㄏㄨㄞˋ ㄔㄨˋ,huàichù 
868,環境,3,2.日常起居,276,668,944,ㄏㄨㄢˊ ㄐㄧㄥˋ,huánjìng 
869,換,3,核心詞,110,151,261,ㄏㄨㄢˋ   ,huàn   
870,華語,3,8.教育、學習,3,3,6,ㄏㄨㄚˊ ㄩˇ,huáyǔ 
871,回答/答,3,核心詞,288,58,346,ㄏㄨㄟˊ ㄉㄚˊ / ㄉㄚˊ ,huídá / dá  
872,回信,3,11.公共服務,11,4,15,ㄏㄨㄟˊ ㄒㄧㄣˋ ,huíxìn  
873,或者/或,3,核心詞,2009,1064,3073,ㄏㄨㄛˋ　ㄓㄜˇ / ㄏㄨㄛˋ,huòzhě / huò
874,急,3,核心詞,89,62,151,ㄐㄧˊ ,jí 
875,假1,3,4.休閒、娛樂,66,50,116,ㄐㄧㄚˋ,jià
876,醬,3,10.餐飲、烹飪,7,14,21,ㄐㄧㄤˋ   ,jiàng   
877,簡訊,3,6.社交、人際,6,7,13,ㄐㄧㄢˇ ㄒㄩㄣˋ ,jiǎnxùn  
878,交通,3,5.交通、旅遊,44,87,131,ㄐㄧㄠ ㄊㄨㄥ,jiāotōng 
879,教育,3,8.教育、學習,314,306,620,ㄐㄧㄠˋ ㄩˋ ,jiàoyù  
880,加上,3,核心詞,152,191,343,ㄐㄧㄚ ㄕㄤˋ ,jiāshàng  
881,機車,3,5.交通、旅遊,12,20,32,ㄐㄧ ㄔㄜ,jīchē 
882,季節/季,3,核心詞,56,142,198,ㄐㄧˋ ㄐㄧㄝˊ/ㄐㄧˋ,jìjié/jì 
883,結婚,3,1.個人資料,105,77,182,ㄐㄧㄝˊ ㄏㄨㄣ   ,jiéhūn    
884,捷運,3,5.交通、旅遊,5,15,20,ㄐㄧㄝˊ ㄩㄣˋ ,jiéyùn  
885,橘子,3,10.餐飲、烹飪,6,20,26,ㄐㄩˊ ,jú 
886,開心,3,核心詞,74,173,247,ㄎㄞ ㄒㄧㄣ,kāixīn 
887,看起來,3,核心詞,168,182,350,ㄎㄢˋ　 ㄑㄧˇ　 ㄌㄞˊ,kànqǐlái  
888,顆,3,核心詞,124,242,366,ㄎㄜ,kē
889,可怕,3,12.安全 ,79,75,154,ㄎㄜˇ ㄆㄚˋ,kěpà 
890,客滿,3,5.交通、旅遊,2,1,3,ㄎㄜˋ ㄇㄢˇ,kèmǎn 
891,空2,3,核心詞,55,71,126,ㄎㄨㄥ,kōng
892,口,3,核心詞,347,191,538,ㄎㄡˇ ,kǒu 
893,口袋,3,核心詞,43,12,55,ㄎㄡˇ ㄉㄞˋ,kǒudài 
894,垃圾,3,2.日常起居,24,215,239,ㄌㄜˋ ㄙㄜˋ,lèsè 
895,涼快,3,2.日常起居,2,3,5,ㄌㄧㄤˊ ㄎㄨㄞˋ ,liángkuài  
896,立刻,3,核心詞,199,50,249,ㄌㄧˋ ㄎㄜˋ ,lìkè  
897,零錢,3,11.公共服務,4,6,10,ㄌㄧㄥˊ ㄑㄧㄢˊ,língqián 
898,另外/另,3,核心詞,705,546,1251,ㄌㄧㄥˋ ㄨㄞˋ / ㄌㄧㄥˋ   ,lìngwài / lìng    
899,鄰居,3,2.日常起居,48,45,93,ㄌㄧㄣˊ ㄐㄩ,línjū 
900,歷史,3,8.教育、學習,341,248,589,ㄌㄧˋ ㄕˇ,lìshǐ 
901,留,3,核心詞,102,99,201,ㄌㄧㄡˊ   ,liú   
902,流汗,3,7.身體、醫療,7,13,20,ㄌㄧㄡˊ ㄏㄢˋ,liúhàn 
903,流行,3,核心詞,58,51,109,ㄌㄧㄡˊ ㄒㄧㄥˊ,liúxíng 
904,禮物,3,6.社交、人際,51,66,117,ㄌㄧˇ ㄨˋ,lǐwù 
905,例子/例,3,核心詞,193,105,298,ㄌㄧˋ ˙ㄗ /ㄌㄧˋ,lìzi/ lì  
906,亂,3,核心詞,105,80,185,ㄌㄨㄢˋ,luàn
907,滿,3,核心詞,208,335,543,ㄇㄢˇ  ,mǎn  
908,芒果,3,10.餐飲、烹飪,5,8,13,ㄇㄤˊ ㄍㄨㄛˇ    ,mángguǒ     
909,毛巾,3,2.日常起居,13,9,22,ㄇㄠˊ　ㄐㄧㄣ ,máojīn 
910,毛衣,3,9.購物、商店,9,2,11,ㄇㄠˊ　ㄧ ,máoyī 
911,夢,3,2.日常起居,117,79,196,ㄇㄥˋ  ,mèng  
912,摩托車,3,5.交通、旅遊,14,25,39,ㄇㄛˊ ㄊㄨㄛ ㄔㄜ,mótuōchē  
913,母親,3,核心詞,399,112,511,ㄇㄨˇ ㄑㄧㄣ,mǔqīn 
914,木瓜,3,10.餐飲、烹飪,4,24,28,ㄇㄨˋ ㄍㄨㄚ,mùguā 
915,沐浴乳,3,2.日常起居,1,1,2,ㄇㄨˋ ㄩˋ ㄖㄨˇ,mùyùrǔ  
916,鬧鐘,3,2.日常起居,6,5,11,ㄋㄠˋ ㄓㄨㄥ,nàozhōng 
917,那樣,3,核心詞,178,100,278,ㄋㄚˋ ㄧㄤˋ ,nàyàng  
918,內,3,核心詞,606,390,996,ㄋㄟˋ ,nèi 
919,年紀,3,1.個人資料,96,113,209,ㄋㄧㄢˊ ㄐㄧˋ,niánjì 
920,牛排,3,10.餐飲、烹飪,7,2,9,ㄋㄧㄡˊ ㄆㄞˊ ,niúpái  
921,弄1,3,核心詞,62,76,138,ㄋㄨㄥˋ  ,nòng  
922,拍,3,核心詞,75,125,200,ㄆㄞ  ,pāi  
923,拍照,3,4.休閒、娛樂,10,25,35,ㄆㄞ ㄓㄠˋ ,pāizhào  
924,排隊,3,9.購物、商店,15,22,37,ㄆㄞˊ ㄉㄨㄟˋ,páiduì 
925,泡,3,10.餐飲、烹飪,33,120,153,ㄆㄠˋ     ,pào     
926,泡麵,3,10.餐飲、烹飪,2,5,7,ㄆㄠˋ ㄇ一ㄢˋ,pàomiàn 
927,爬山,3,4.休閒、娛樂,8,13,21,ㄆㄚˊ ㄕㄢ,páshān 
928,陪,3,核心詞,75,94,169,ㄆㄟˊ,péi
929,皮鞋,3,9.購物、商店,9,2,11,ㄆㄧˊ ㄒㄧㄝˊ,píxié 
930,破,3,核心詞,59,53,112,ㄆㄛˋ ,pò 
931,葡萄,3,10.餐飲、烹飪,12,45,57,ㄆㄨˊ ㄊㄠˊ,pútáo 
932,簽證,3,5.交通、旅遊,4,6,10,ㄑㄧㄢ ㄓㄥˋ,qiānzhèng 
933,巧克力,3,10.餐飲、烹飪,24,25,49,ㄑㄧㄠˇ　ㄎㄜˋ　 ㄌㄧˋ,qiǎokèlì 
934,輕鬆,3,核心詞,74,62,136,ㄑㄧㄥ ㄙㄨㄥ ,qīngsōng  
935,請客,3,6.社交、人際,6,2,8,ㄑㄧㄥˇ ㄎㄜˋ,qǐngkè 
936,認真,3,核心詞,80,107,187,ㄖㄣˋ ㄓㄣ,rènzhēn 
937,入口,3,5.交通、旅遊,18,5,23,ㄖㄨˋ ㄎㄡˇ,rùkǒu 
938,傘,3,2.日常起居,14,17,31,ㄙㄢˇ,sǎn
939,沙發,3,2.日常起居,28,10,38,ㄕㄚ ㄈㄚ,shāfā 
940,沙拉,3,10.餐飲、烹飪,8,10,18,ㄕㄚ ㄌㄚ,shālā 
941,上床,3,核心詞,21,4,25,ㄕㄤˋ ㄔㄨㄤˊ,shàngchuáng 
942,生活,3,核心詞,933,908,1841,ㄕㄥ ㄏㄨㄛˊ ,shēnghuó  
943,生意,3,9.購物、商店,59,37,96,ㄕㄥ ㄧˋ,shēngyì 
944,溼/濕,3,核心詞,27,40,67,ㄕ ,shī 
945,食物,3,10.餐飲、烹飪,152,338,490,ㄕˊ ㄨˋ,shíwù 
946,適合,3,核心詞,104,153,257,ㄕˋ ㄏㄜˊ,shìhé 
947,收,3,核心詞,58,148,206,ㄕㄡ    ,shōu    
948,手套,3,9.購物、商店,16,15,31,ㄕㄡˇ ㄊㄠˋ ,shǒutào  
949,帥,3,核心詞,20,23,43,ㄕㄨㄞˋ,shuài
950,刷卡,3,9.購物、商店,1,3,4,ㄕㄨㄚ ㄎㄚˇ  ,shuākǎ   
951,暑假,3,8.教育、學習,17,21,38,ㄕㄨˇ ㄐㄧㄚˋ,shǔjià 
952,死,3,核心詞,459,149,608,ㄙˇ  ,sǐ  
953,速食,3,10.餐飲、烹飪,4,3,7,ㄙㄨˋ ㄕˊ ,sùshí  
954,颱風,3,5.交通、旅遊,14,280,294,ㄊㄞˊ ㄈㄥ,táifēng 
955,太陽,3,核心詞,104,111,215,ㄊㄞˋ  ㄧㄤˊ,tàiyáng 
956,台語/臺語,3,8.教育、學習,9,18,27,ㄊㄞˊ ㄩˇ ,táiyǔ  
957,糖果,3,10.餐飲、烹飪,10,15,25,ㄊㄤˊ ㄍㄨㄛˇ ,tángguǒ  
958,套,3,核心詞,157,100,257,ㄊㄠˋ ,tào 
959,提,3,11.公共服務,134,73,207,ㄊㄧˊ  ,tí  
960,停,3,核心詞,89,73,162,ㄊㄧㄥˊ  ,tíng  
961,停車場,3,5.交通、旅遊,11,6,17,ㄊㄧㄥˊㄔㄜ ㄔㄤˇ,tíngchēchǎng 
962,同意,3,核心詞,123,45,168,ㄊㄨㄥˊ ㄧˋ,tóngyì 
963,頭痛,3,7.身體、醫療,27,24,51,ㄊㄡˊ ㄊㄨㄥˋ,tóutòng 
964,腿,3,7.身體、醫療,79,27,106,ㄊㄨㄟˇ ,tuǐ 
965,哇,3,核心詞,29,221,250,˙ㄨㄚ/ ㄨㄚ,wɑ/ wā
966,忘記,3,核心詞,69,73,142,ㄨㄤˋ ㄐㄧˋ ,wàngjì  
967,襪子,3,9.購物、商店,19,19,38,ㄨㄚˋ ˙ㄗ,wàzi 
968,危險,3,12.安全 ,121,110,231,ㄨㄟˊ ㄒㄧㄢˇ ,wéixiǎn  
969,衛生紙,3,2.日常起居,4,39,43,ㄨㄟˋ ㄕㄥ ㄓˇ  ,wèishēngzhǐ    
970,位子,3,10.餐飲、烹飪,17,8,25,ㄨㄟˋ ˙ㄗ  ,wèizi   
971,聞,3,核心詞,66,40,106,ㄨㄣˊ,wén
972,溫泉,3,5.交通、旅遊,9,8,17,ㄨㄣ ㄑㄩㄢˊ,wēnquán 
973,文法,3,8.教育、學習,8,3,11,ㄨㄣˊ ㄈㄚˇ,wénfǎ 
974,烏龍茶,3,10.餐飲、烹飪,1,8,9,ㄨ ㄌㄨㄥˊ ㄔㄚˊ,wūlóngchá  
975,無聊,3,4.休閒、娛樂,42,27,69,ㄨˊ ㄌㄧㄠˊ ,wúliáo  
976,舞,3,4.休閒、娛樂,25,34,59,ㄨˇ,wǔ
977,相當,3,核心詞,246,288,534,ㄒㄧㄤ ㄉㄤ,xiāngdāng 
978,消息,3,核心詞,127,52,179,ㄒㄧㄠ ㄒㄧˊ,xiāoxí 
979,校園,3,8.教育、學習,29,41,70,ㄒㄧㄠˋ ㄩㄢˊ,xiàoyuán 
980,洗髮精,3,2.日常起居,3,13,16,ㄒㄧˇ ㄈㄚˇ ㄐㄧㄥ,xǐfǎjīng  
981,行李,3,5.交通、旅遊,23,16,39,ㄒㄧㄥˊ ㄌㄧˇ ,xínglǐ  
982,興趣,3,核心詞,141,117,258,ㄒㄧㄥˋ ㄑㄩˋ,xìngqù 
983,新聞,3,4.休閒、娛樂,91,108,199,ㄒㄧㄣ ㄨㄣˊ,xīnwén 
984,新鮮,3,10.餐飲、烹飪,37,71,108,ㄒㄧㄣ ㄒㄧㄢ,xīnxiān 
985,信箱,3,2.日常起居,9,3,12,ㄒㄧㄣˋ ㄒㄧㄤ,xìnxiāng 
986,兄弟,3,核心詞,120,85,205,ㄒㄩㄥ ㄉㄧˋ,xiōngdì 
987,洗衣機,3,2.日常起居,7,23,30,ㄒㄧˇ ㄧ ㄐㄧ,xǐyījī  
988,選,3,核心詞,65,121,186,ㄒㄩㄢˇ,xuǎn
989,學期,3,8.教育、學習,19,17,36,ㄒㄩㄝˊ ㄑㄧˊ ,xuéqí 
990,學生證,3,8.教育、學習,1,0,1,ㄒㄩㄝˊ ㄕㄥ ㄓㄥˋ,xuéshēngzhèng
991,牙膏,3,2.日常起居,4,4,8,ㄧㄚˊ ㄍㄠ ,yágāo  
992,鹽,3,10.餐飲、烹飪,33,65,98,ㄧㄢˊ ,yán 
993,洋蔥,3,10.餐飲、烹飪,9,10,19,ㄧㄤˊ ㄘㄨㄥ,yángcōng 
994,研究,3,8.教育、學習,794,375,1169,ㄧㄢˊ ㄐㄧㄡˋ ,yánjiù  
995,樣,3,核心詞,124,498,622,ㄧㄤˋ,yàng
996,鑰匙,3,2.日常起居,45,10,55,ㄧㄠˋ ˙ㄕ ,yàoshi
997,牙刷,3,2.日常起居,4,5,9,ㄧㄚˊ ㄕㄨㄚ ,yáshuā  
998,已,3,核心詞,783,245,1028,ㄧˇ,yǐ
999,影響,3,核心詞,363,505,868,ㄧㄥˇ ㄒㄧㄤˇ ,yǐngxiǎng
1000,飲料,3,10.餐飲、烹飪,28,39,67,ㄧㄣˇ ㄌㄧㄠˋ ,yǐnliào  
1001,油,3,10.餐飲、烹飪,51,148,199,ㄧㄡˊ    ,yóu    
1002,郵件,3,11.公共服務,39,7,46,ㄧㄡˊ ㄐㄧㄢˋ,yóujiàn 
1003,遊戲,3,4.休閒、娛樂,132,59,191,ㄧㄡˊ ㄒㄧˋ,yóuxì 
1004,有趣,3,4.休閒、娛樂,108,134,242,ㄧㄡˇ ㄑㄩˋ,yǒuqù 
1005,越,3,核心詞,303,297,600,ㄩㄝˋ ,yuè 
1006,雨傘,3,2.日常起居,7,3,10,ㄩˇ ㄙㄢˇ,yǔsǎn
1007,雨衣,3,2.日常起居,4,5,9,ㄩˇ ㄧ,yǔyī 
1008,浴室,3,2.日常起居,18,8,26,ㄩˋ ㄕˋ,yùshì 
1009,髒,3,核心詞,21,40,61,ㄗㄤ  ,zāng  
1010,長大,3,核心詞,104,157,261,ㄓㄤˇ ㄉㄚˋ ,zhǎngdà  
1011,照顧,3,核心詞,151,282,433,ㄓㄠˋ ㄍㄨˋ ,zhàogù  
1012,這樣,3,核心詞,1129,2794,3923,ㄓㄜˋ ㄧㄤˋ ,zhèyàng  
1013,直接,3,核心詞,197,275,472,ㄓˊ ㄐㄧㄝ,zhíjiē 
1014,只好,3,核心詞,141,54,195,ㄓˇ ㄏㄠˇ,zhǐhǎo 
1015,只要,3,核心詞,426,461,887,ㄓˇ　 ㄧㄠˋ,zhǐyào 
1016,中心,3,核心詞,161,193,354,ㄓㄨㄥ ㄒㄧㄣ ,zhōngxīn  
1017,週,3,核心詞,106,53,159,ㄓㄡ,zhōu
1018,裝,3,核心詞,77,86,163,ㄓㄨㄤ,zhuāng
1019,資料,3,核心詞,206,159,365,ㄗ ㄌㄧㄠˋ,zīliào 
1020,自行車,3,5.交通、旅遊,10,15,25,ㄗˋ ㄒㄧㄥˊ ㄔㄜ,zìxíngchē  
1021,最好,3,核心詞,96,64,160,ㄗㄨㄟˋ ㄏㄠˇ,zuìhǎo 
1022,做法/作法,3,10.餐飲、烹飪,100,68,168,ㄗㄨㄛˋ ㄈㄚˇ ,zuòfǎ  
1023,班次,3.5,5.交通、旅遊,2,1,3,ㄅㄢ ㄘˋ,bāncì 
1024,辦,3.5,核心詞,79,75,154,ㄅㄢˋ,bàn
1025,半夜,3.5,核心詞,27,16,43,ㄅㄢˋ ㄧㄝˋ,bànyè 
1026,包括,3.5,核心詞,273,281,554,ㄅㄠ ㄎㄨㄛˋ,bāokuò 
1027,保護,3.5,12.安全,131,211,342,ㄅㄠˇ ㄏㄨˋ,bǎohù 
1028,倍,3.5,核心詞,102,132,234,ㄅㄟˋ,bèi
1029,標準,3.5,5.交通、旅遊,116,86,202,ㄅㄧㄠ ㄓㄨㄣˇ ,biāozhǔn  
1030,鼻水,3.5,7.身體、醫療,2,1,3,ㄅㄧˊ ㄕㄨㄟˇ,bíshuǐ 
1031,伯父,3.5,1.個人資料,6,4,10,ㄅㄛˊ ㄈㄨˋ,bófù 
1032,伯母,3.5,1.個人資料,3,10,13,ㄅㄛˊ ㄇㄨˇ,bómǔ 
1033,步,3.5,核心詞,179,131,310,ㄅㄨˋ,bù
1034,不停,3.5,核心詞,85,34,119,ㄅㄨˋ ㄊㄧㄥˊ,bù tíng
1035,不得了,3.5,核心詞,25,15,40,ㄅㄨˋ ㄉㄜˊ ㄌㄧㄠˇ,bùdéliǎo  
1036,不管,3.5,核心詞,166,238,404,ㄅㄨˋ ㄍㄨㄢˇ,bùguǎn 
1037,參觀,3.5,4.休閒、娛樂,36,45,81,ㄘㄢ ㄍㄨㄢ,cānguān 
1038,餐桌,3.5,2.日常起居,27,17,44,ㄘㄢ ㄓㄨㄛ ,cānzhuō  
1039,層,3.5,核心詞,143,147,290,ㄘㄥˊ  ,céng  
1040,差1,3.5,核心詞,97,159,256,ㄔㄚ    ,chā    
1041,吵,3.5,核心詞,27,48,75,ㄔㄠˇ   ,chǎo   
1042,乘,3.5,8.教育、學習,43,16,59,ㄔㄥˊ  ,chéng  
1043,程度,3.5,8.教育、學習,167,106,273,ㄔㄥˊ ㄉㄨˋ,chéngdù 
1044,成功,3.5,8.教育、學習,332,203,535,ㄔㄥˊ ㄍㄨㄥ ,chénggōng  
1045,除,3.5,8.教育、學習,55,54,109,ㄔㄨˊ  ,chú  
1046,除了,3.5,核心詞,299,504,803,ㄔㄨˊ ˙ㄌㄜ,chúle 
1047,傳,3.5,核心詞,62,50,112,ㄔㄨㄢˊ ,chuán 
1048,春季,3.5,5.交通、旅遊,6,6,12,ㄔㄨㄣ ㄐㄧˋ,chūnjì 
1049,春假,3.5,8.教育、學習,1,1,2,ㄔㄨㄣ ㄐㄧㄚˋ,chūnjià 
1050,出生,3.5,1.個人資料,92,80,172,ㄔㄨ ㄕㄥ,chūshēng 
1051,除夕,3.5,15.文化,4,3,7,ㄔㄨˊ ㄒㄧˋ,chúxì 
1052,從來,3.5,核心詞,159,100,259,ㄘㄨㄥˊ ㄌㄞˊ,cónglái 
1053,存,3.5,11.公共服務,36,49,85,ㄘㄨㄣˊ ,cún 
1054,答案,3.5,8.教育、學習,124,98,222,ㄉㄚˊ ㄢˋ,dáàn 
1055,帶來,3.5,核心詞,160,189,349,ㄉㄞˋ ㄌㄞˊ,dàilái 
1056,大陸,3.5,1.個人資料,91,152,243,ㄉㄚˋ  ㄌㄨˋ  ,dàlù   
1057,當時,3.5,核心詞,477,365,842,ㄉㄤ ㄕˊ,dāngshí 
1058,當中,3.5,核心詞,96,376,472,ㄉㄤ ㄓㄨㄥ,dāngzhōng 
1059,擔心,3.5,核心詞,169,241,410,ㄉㄢ ㄒㄧㄣ,dānxīn 
1060,得到,3.5,核心詞,335,210,545,ㄉㄜˊ ㄉㄠˋ,dédào 
1061,等/等等,3.5,核心詞,153,161,314,ㄉㄥˇ /ㄉㄥˇ ㄉㄥˇ,děng/ děngděng
1062,等到,3.5,核心詞,102,80,182,ㄉㄥˇ ㄉㄠˋ,děngdào 
1063,低頭,3.5,核心詞,27,10,37,ㄉㄧ ㄊㄡˊ,dītóu 
1064,底,3.5,核心詞,125,130,255,ㄉㄧˇ  ,dǐ  
1065,地點,3.5,核心詞,60,52,112,ㄉㄧˋ ㄉㄧㄢˇ,dìdiǎn 
1066,東方,3.5,核心詞,47,24,71,ㄉㄨㄥ ㄈㄤ ,dōngfāng  
1067,動,3.5,核心詞,153,160,313,ㄉㄨㄥˋ   ,dòng   
1068,豆/豆子,3.5,10.餐飲、烹飪,25,47,72,ㄉㄡˋ/ ㄉㄡˋ ˙ㄗ,dòu/ dòuzi  
1069,朵,3.5,核心詞,50,23,73,ㄉㄨㄛˇ,duǒ
1070,多麼,3.5,核心詞,92,31,123,ㄉㄨㄛˊ ˙ㄇㄜ,duóme 
1071,法律,3.5,8.教育、學習,83,33,116,ㄈㄚˇ ㄌㄩˋ,fǎlǜ 
1072,煩,3.5,核心詞,17,22,39,ㄈㄢˊ ,fán 
1073,方,3.5,核心詞,126,67,193,ㄈㄤ ,fāng 
1074,方面,3.5,8.教育、學習,280,228,508,ㄈㄤ ㄇㄧㄢˋ,fāngmiàn 
1075,方向,3.5,核心詞,146,124,270,ㄈㄤ ㄒㄧㄤˋ,fāngxiàng
1076,房,3.5,2.日常起居,66,24,90,ㄈㄤˊ,fáng
1077,房屋,3.5,2.日常起居,20,37,57,ㄈㄤˊ ㄨ ,fángwū  
1078,放心,3.5,核心詞,38,45,83,ㄈㄤˋ ㄒㄧㄣ,fàngxīn 
1079,發燒,3.5,7.身體、醫療,14,16,30,ㄈㄚ ㄕㄠ,fāshāo 
1080,改,3.5,核心詞,51,65,116,ㄍㄞˇ  ,gǎi  
1081,剛好,3.5,核心詞,46,196,242,ㄍㄤ ㄏㄠˇ ,gānghǎo  
1082,感覺,3.5,核心詞,373,534,907,ㄍㄢˇ ㄐㄩㄝˊ ,gǎnjué  
1083,高級,3.5,8.教育、學習,39,15,54,ㄍㄠ ㄐㄧˊ,gāojí 
1084,公路,3.5,5.交通、旅遊,32,43,75,ㄍㄨㄥ ㄌㄨˋ,gōnglù 
1085,工人,3.5,3.職業,48,28,76,ㄍㄨㄥ　 ㄖㄣˊ,gōngrén 
1086,光,3.5,核心詞,150,192,342,ㄍㄨㄤ,guāng
1087,姑姑/姑,3.5,1.個人資料,20,13,33,ㄍㄨ　 ˙ㄍㄨ /ㄍㄨ,gūgu/ gū 
1088,姑媽,3.5,1.個人資料,6,1,7,ㄍㄨ  ㄇㄚ,gūmā 
1089,櫃子/櫃,3.5,核心詞,17,10,27,ㄍㄨㄟˋ　˙ㄗ/ㄍㄨㄟˋ,guìzi/guì
1090,國小,3.5,1.個人資料,20,99,119,ㄍㄨㄛˊ ㄒㄧㄠˇ,guóxiǎo 
1091,害怕,3.5,核心詞,125,81,206,ㄏㄞˋ ㄆㄚˋ ,hàipà  
1092,汗,3.5,7.身體、醫療,42,18,60,ㄏㄢˋ  ,hàn  
1093,合適,3.5,核心詞,28,7,35,ㄏㄜˊ ㄕˋ,héshì 
1094,合作,3.5,6.社交、人際,117,128,245,ㄏㄜˊ ㄗㄨㄛˋ ,hézuò  
1095,畫家,3.5,4.休閒、娛樂,35,31,66,ㄏㄨㄚˋ ㄐㄧㄚ,huàjiā 
1096,環保,3.5,14.社會,13,396,409,ㄏㄨㄢˊ ㄅㄠˇ,huánbǎo 
1097,極,3.5,核心詞,224,79,303,ㄐㄧˊ,jí
1098,加班,3.5,3.職業,6,6,12,ㄐㄧㄚ ㄅㄢ,jiābān 
1099,家具/傢俱,3.5,2.日常起居,24,25,49,ㄐㄧㄚ　 ㄐㄩˋ,jiājù   
1100,減,3.5,核心詞,19,92,111,ㄐㄧㄢˇ ,jiǎn 
1101,建議,3.5,核心詞,195,112,307,ㄐㄧㄢˋ ㄧˋ ,jiànyì  
1102,教授,3.5,8.教育、學習,167,175,342,ㄐㄧㄠˋ ㄕㄡˋ,jiàoshòu 
1103,教書,3.5,3.職業,16,17,33,ㄐㄧㄠ ㄕㄨ,jiāoshū 
1104,叫做,3.5,核心詞,97,331,428,ㄐㄧㄠˋ ㄗㄨㄛˋ,jiàozuò
1105,假日,3.5,核心詞,11,34,45,ㄐㄧㄚˋ ㄖˋ,jiàrì 
1106,接著/接着,3.5,核心詞,243,100,343,ㄐㄧㄝ ˙ㄓㄜ,jiēzhe 
1107,結果,3.5,核心詞,484,379,863,ㄐㄧㄝˊ ㄍㄨㄛˇ ,jiéguǒ  
1108,結束,3.5,核心詞,152,124,276,ㄐㄧㄝˊ ㄕㄨˋ,jiéshù 
1109,節日,3.5,15.文化,8,13,21,ㄐㄧㄝˊ ㄖˋ,jiérì 
1110,經常,3.5,核心詞,196,102,298,ㄐㄧㄥ ㄔㄤˊ,jīngcháng 
1111,精神,3.5,7.身體、醫療,305,197,502,ㄐㄧㄥ ㄕㄣˊ,jīngshén 
1112,金色,3.5,核心詞,15,7,22,ㄐㄧㄣ ㄙㄜˋ,jīnsè 
1113,居留證,3.5,11.公共服務,1,1,2,ㄐㄩ ㄌㄧㄡˊ ㄓㄥˋ,jūliúzhèng  
1114,開會,3.5,3.職業,31,23,54,ㄎㄞ ㄏㄨㄟˋ ,kāihuì  
1115,開玩笑,3.5,核心詞,26,35,61,ㄎㄞ ㄨㄢˊ ㄒㄧㄠˋ,kāiwánxiào  
1116,看法,3.5,核心詞,118,45,163,ㄎㄢˋ　ㄈㄚˇ,kànfǎ
1117,咳,3.5,7.身體、醫療,11,3,14,ㄎㄜˊ  ,ké  
1118,咳嗽,3.5,7.身體、醫療,15,13,28,ㄎㄜˊ ㄙㄡˋ ,késòu  
1119,可惜,3.5,核心詞,66,56,122,ㄎㄜˇ ㄒㄧˊ,kěxí 
1120,困難,3.5,核心詞,170,207,377,ㄎㄨㄣˋ ㄋㄢˊ ,kùnnán  
1121,籃子,3.5,核心詞,8,9,17,ㄌㄢˊ ˙ㄗ ,lánzi  
1122,老闆娘/老板娘,3.5,9.購物、商店,11,13,24,ㄌㄠˇ　ㄅㄢˇ　ㄋㄧㄤˊ ,lǎobǎnniáng 
1123,老太太,3.5,核心詞,22,5,27,ㄌㄠˇ ㄊㄞˋ ˙ㄊㄞ,lǎotàitɑi  
1124,類,3.5,核心詞,210,131,341,ㄌㄟˋ,lèi
1125,連,3.5,核心詞,362,284,646,ㄌㄧㄢˊ  ,lián  
1126,臉色,3.5,7.身體、醫療,37,11,48,ㄌㄧㄢˇ　ㄙㄜˋ ,liǎnsè 
1127,涼,3.5,13.自然環境,18,33,51,ㄌㄧㄤˊ,liáng
1128,了解/瞭解,3.5,核心詞,375,339,714,ㄌㄧㄠˇ ㄐㄧㄝˇ ,liǎojiě  
1129,禮貌,3.5,6.社交、人際,35,16,51,ㄌㄧˇ ㄇㄠˋ,lǐmào 
1130,零用錢,3.5,2.日常起居,6,27,33,ㄌㄧㄥˊ ㄩㄥˋ ㄑㄧㄢˊ,língyòngqián  
1131,例如,3.5,核心詞,302,125,427,ㄌㄧˋ ㄖㄨˊ,lìrú 
1132,流,3.5,核心詞,46,96,142,ㄌㄧㄡˊ ,liú 
1133,留下,3.5,核心詞,116,74,190,ㄌㄧㄡˊ ㄒㄧㄚˋ,liúxià 
1134,利用,3.5,5.交通、旅遊,181,301,482,ㄌㄧˋ ㄩㄥˋ,lìyòng 
1135,毛,3.5,核心詞,66,38,104,ㄇㄠˊ  ,máo  
1136,美麗,3.5,核心詞,105,169,274,ㄇㄟˇ ㄌㄧˋ,měilì 
1137,沒想到,3.5,核心詞,56,88,144,ㄇㄟˊ ㄒㄧㄤˇ ㄉㄠˋ,méixiǎngdào  
1138,米,3.5,10.餐飲、烹飪,140,199,339,ㄇㄧˇ  ,mǐ  
1139,母語,3.5,1.個人資料,7,6,13,ㄇㄨˇ ㄩˇ,mǔyǔ 
1140,目的,3.5,核心詞,159,100,259,ㄇㄨˋ ㄉㄧˋ,mùdì 
1141,爬,3.5,核心詞,53,37,90,ㄆㄚˊ   ,pá   
1142,派對,3.5,6.社交、人際,20,1,21,ㄆㄞˋ ㄉㄨㄟˋ,pàiduì 
1143,拼音,3.5,8.教育、學習,6,4,10,ㄆㄧㄣ ㄧㄣ,pīnyīn 
1144,其實,3.5,核心詞,431,2878,3309,ㄑㄧˊ ㄕˊ,qíshí 
1145,其中,3.5,核心詞,353,207,560,ㄑㄧˊ ㄓㄨㄥ,qízhōng 
1146,起,3.5,核心詞,382,295,677,ㄑㄧˇ,qǐ
1147,淺,3.5,核心詞,23,21,44,ㄑㄧㄢˇ ,qiǎn 
1148,晴天,3.5,5.交通、旅遊,4,1,5,ㄑㄧㄥˊ ㄊㄧㄢ,qíngtiān 
1149,情形,3.5,核心詞,146,96,242,ㄑㄧㄥˊ ㄒㄧㄥˊ,qíngxíng 
1150,熱鬧,3.5,9.購物、商店,27,31,58,ㄖㄜˋ ㄋㄠˋ,rènào 
1151,日記,3.5,2.日常起居,28,13,41,ㄖˋ ㄐㄧˋ,rìjì 
1152,日子,3.5,2.日常起居,132,77,209,ㄖˋ ˙ㄗ ,rìzi  
1153,散步,3.5,4.休閒、娛樂,31,12,43,ㄙㄢˋ ㄅㄨˋ,sànbù 
1154,商人,3.5,3.職業,38,11,49,ㄕㄤ ㄖㄣˊ,shāngrén 
1155,上衣,3.5,9.購物、商店,11,3,14,ㄕㄤˋ ㄧ,shàngyī 
1156,社會,3.5,14.社會,604,419,1023,ㄕㄜˋ ㄏㄨㄟˋ,shèhuì 
1157,深,3.5,核心詞,150,145,295,ㄕㄣ ,shēn 
1158,身邊,3.5,核心詞,131,66,197,ㄕㄣ ㄅㄧㄢ,shēnbiān 
1159,身高,3.5,7.身體、醫療,18,10,28,ㄕㄣ ㄍㄠ,shēngāo 
1160,聖誕老人,3.5,15.文化,3,0,3,ㄕㄥˋ　ㄉㄢˋ　ㄌㄠˇ　ㄖㄣˊ  ,shèngdànlǎorén  
1161,生活費,3.5,2.日常起居,4,11,15,ㄕㄥ ㄏㄨㄛˊ ㄈㄟˋ,shēnghuófèi  
1162,時,3.5,核心詞,2473,455,2928,ㄕˊ ,shí 
1163,時差,3.5,5.交通、旅遊,2,1,3,ㄕˊ ㄔㄚ,shíchā 
1164,時鐘/鐘1,3.5,2.日常起居,29,15,44,ㄕˊ ㄓㄨㄥ / ㄓㄨㄥ,shízhōng / zhōng 
1165,市區,3.5,2.日常起居,13,18,31,ㄕˋ ㄑㄩ,shìqū 
1166,熟,3.5,核心詞,31,52,83,ㄕㄡˊ  ,shóu  
1167,數,3.5,核心詞,137,66,203,ㄕㄨˇ,shǔ
1168,刷,3.5,9.購物、商店,14,26,40,ㄕㄨㄚ,shuā
1169,書法,3.5,8.教育、學習,16,11,27,ㄕㄨ ㄈㄚˇ,shūfǎ 
1170,書架,3.5,2.日常起居,14,3,17,ㄕㄨ ㄐㄧㄚˋ,shūjià 
1171,書桌,3.5,2.日常起居,15,8,23,ㄕㄨ ㄓㄨㄛ,shūzhuō 
1172,睡衣,3.5,9.購物、商店,7,1,8,ㄕㄨㄟˋ　ㄧ ,shuìyī 
1173,速度,3.5,核心詞,118,111,229,ㄙㄨˋ ㄉㄨˋ,sùdù 
1174,孫女,3.5,1.個人資料,10,7,17,ㄙㄨㄣ　 ㄋㄩˇ,sūnnǚ 
1175,孫子,3.5,1.個人資料,40,31,71,ㄙㄨㄣ　 ˙ㄗ,sūnzi 
1176,鎖,3.5,2.日常起居,22,11,33,ㄙㄨㄛˇ     ,suǒ     
1177,談,3.5,核心詞,181,217,398,ㄊㄢˊ,tán
1178,討論,3.5,8.教育、學習,213,149,362,ㄊㄠˇ ㄌㄨㄣˋ ,tǎolùn  
1179,套餐,3.5,10.餐飲、烹飪,1,3,4,ㄊㄠˋ  ㄘㄢ,tàocān 
1180,題,3.5,8.教育、學習,16,62,78,ㄊㄧˊ,tí
1181,題目,3.5,8.教育、學習,37,27,64,ㄊㄧˊ ㄇㄨˋ,tímù 
1182,廳,3.5,2.日常起居,9,4,13,ㄊㄧㄥ,tīng
1183,同班,3.5,1.個人資料,5,5,10,ㄊㄨㄥˊ ㄅㄢ,tóngbān 
1184,同時,3.5,核心詞,413,253,666,ㄊㄨㄥˊ ㄕˊ ,tóngshí  
1185,同樣,3.5,核心詞,250,156,406,ㄊㄨㄥˊ ㄧㄤˋ,tóngyàng 
1186,偷,3.5,12.安全,43,25,68,ㄊㄡ,tōu
1187,拖鞋,3.5,9.購物、商店,4,12,16,ㄊㄨㄛ ㄒㄧㄝˊ ,tuōxié  
1188,外公/外祖父,3.5,1.個人資料,12,13,25,ㄨㄞˋ ㄍㄨㄥ /ㄨㄞˋ ㄗㄨˇ ㄈㄨˋ,wàigong/ wàizǔfù   
1189,外婆/外祖母,3.5,1.個人資料,15,20,35,ㄨㄞˋ ㄆㄛˊ /ㄨㄞˋ ㄗㄨˇ ㄇㄨˇ,wàipó/wài zǔmǔ    
1190,完,3.5,核心詞,49,95,144,ㄨㄢˊ,wán
1191,完全,3.5,核心詞,461,302,763,ㄨㄢˊ ㄑㄩㄢˊ,wánquán 
1192,蚊子,3.5,2.日常起居,10,29,39,ㄨㄣˊ ˙ㄗ,wénzi 
1193,臥房,3.5,2.日常起居,12,1,13,ㄨㄛˋ ㄈㄤˊ,wòfáng 
1194,臥室,3.5,2.日常起居,18,4,22,ㄨㄛˋ　ㄕˋ ,wòshì 
1195,污染/汙染,3.5,14.社會,26,162,188,ㄨ ㄖㄢˇ,wūrǎn   
1196,現代,3.5,8.教育、學習,130,67,197,ㄒㄧㄢˋ ㄉㄞˋ,xiàndài 
1197,香味,3.5,10.餐飲、烹飪,14,22,36,ㄒㄧㄤ ㄨㄟˋ,xiāngwèi 
1198,鄉下,3.5,2.日常起居,25,37,62,ㄒㄧㄤ ㄒㄧㄚˋ,xiāngxià 
1199,箱子/箱,3.5,核心詞,37,36,73,ㄒㄧㄤ ˙ㄗ/ ㄒㄧㄤ   ,xiāngzi/ xiāng  
1200,小費,3.5,9.購物、商店,7,1,8,ㄒㄧㄠˇ　ㄈㄟˋ,xiǎofèi
1201,信封,3.5,11.公共服務,14,3,17,ㄒㄧㄣˋ ㄈㄥ ,xìnfēng
1202,星星,3.5,13.自然環境,21,13,34,ㄒㄧㄥ ˙ㄒㄧㄥ,xīngxing 
1203,心情,3.5,核心詞,140,154,294,ㄒㄧㄣ ㄑㄧㄥˊ,xīnqíng 
1204,選擇,3.5,核心詞,275,244,519,ㄒㄩㄢˇ ㄗㄜˊ ,xuǎnzé  
1205,許多,3.5,核心詞,658,362,1020,ㄒㄩˇ ㄉㄨㄛ,xǔduō 
1206,眼,3.5,7.身體、醫療,274,102,376,ㄧㄢˇ,yǎn
1207,嚴重,3.5,7.身體、醫療,172,378,550,ㄧㄢˊ ㄓㄨㄥˋ,yánzhòng 
1208,藥房,3.5,7.身體、醫療,6,4,10,ㄧㄠˋ ㄈㄤˊ,yàofáng 
1209,藥局,3.5,7.身體、醫療,3,0,3,ㄧㄠˋ ㄐㄩˊ ,yàojú  
1210,要求,3.5,核心詞,270,139,409,ㄧㄠ ㄑㄧㄡˊ ,yāoqiú  
1211,也許,3.5,核心詞,290,132,422,ㄧㄝˇ ㄒㄩˇ,yěxǔ 
1212,夜,3.5,核心詞,112,47,159,ㄧㄝˋ ,yè 
1213,夜晚,3.5,核心詞,38,20,58,ㄧㄝˋ ㄨㄢˇ,yèwǎn 
1214,一般,3.5,核心詞,285,472,757,ㄧˋ ㄅㄢ   ,yìbān    
1215,一切,3.5,核心詞,365,112,477,ㄧˊ ㄑㄧㄝˋ,yíqiè 
1216,衣架,3.5,2.日常起居,2,2,4,ㄧ ㄐㄧㄚˋ ,yījià  
1217,以上,3.5,核心詞,144,145,289,ㄧˇ ㄕㄤˋ,yǐshàng 
1218,以下,3.5,核心詞,102,53,155,ㄧˇ ㄒㄧㄚˋ,yǐxià 
1219,意見,3.5,核心詞,133,60,193,ㄧˋ ㄐㄧㄢˋ,yìjiàn 
1220,陰天,3.5,13.自然環境,2,2,4,ㄧㄣ ㄊㄧㄢ,yīntiān 
1221,尤其,3.5,核心詞,215,228,443,ㄧㄡˊ　 ㄑㄧˊ,yóuqí 
1222,圓,3.5,核心詞,53,44,97,ㄩㄢˊ  ,yuán  
1223,原來,3.5,核心詞,210,309,519,ㄩㄢˊ ㄌㄞˊ,yuánlái 
1224,原因,3.5,核心詞,286,217,503,ㄩㄢˊ ㄧㄣ,yuányīn 
1225,院子/院,3.5,2.日常起居,58,33,91,ㄩㄢˋ ˙ㄗ/ ㄩㄢˋ,yuànzi/yuàn  
1226,約,3.5,6.社交、人際,171,120,291,ㄩㄝ,yuē
1227,約會,3.5,6.社交、人際,20,4,24,ㄩㄝ ㄏㄨㄟˋ   ,yuēhuì    
1228,月亮,3.5,核心詞,34,29,63,ㄩㄝˋ ㄌㄧㄤˋ,yuèliàng 
1229,月台,3.5,5.交通、旅遊,7,4,11,ㄩㄝˋ ㄊㄞˊ,yuètái
1230,早點,3.5,核心詞,11,11,22,ㄗㄠˇ ㄉㄧㄢˇ    ,zǎodiǎn     
1231,雜誌,3.5,4.休閒、娛樂,86,92,178,ㄗㄚˊ ㄓˋ,zázhì 
1232,整,3.5,核心詞,386,782,1168,ㄓㄥˇ ,zhěng 
1233,正,3.5,核心詞,662,247,909,ㄓㄥˋ,zhèng
1234,正常,3.5,7.身體、醫療,134,108,242,ㄓㄥˋ ㄔㄤˊ,zhèngcháng 
1235,正好,3.5,核心詞,74,37,111,ㄓㄥˋ　ㄏㄠˇ,zhènghǎo
1236,正式,3.5,8.教育、學習,86,73,159,ㄓㄥˋ ㄕˋ,zhèngshì 
1237,枕頭,3.5,2.日常起居,15,6,21,ㄓㄣˇ ˙ㄊㄡ,zhěntou 
1238,汁,3.5,10.餐飲、烹飪,16,18,34,ㄓ ,zhī 
1239,知識,3.5,8.教育、學習,280,111,391,ㄓ　ㄕˋ,zhīshì
1240,鐘2,3.5,9.購物、商店,14,11,25,ㄓㄨㄥ,zhōng
1241,中式,3.5,15.文化,2,2,4,ㄓㄨㄥ ㄕˋ,zhōngshì 
1242,中學,3.5,1.個人資料,33,26,59,ㄓㄨㄥ ㄒㄩㄝˊ,zhōngxué 
1243,抓,3.5,核心詞,88,85,173,ㄓㄨㄚ ,zhuā 
1244,主人,3.5,9.購物、商店,95,40,135,ㄓㄨˇ ㄖㄣˊ ,zhǔrén  
1245,住址,3.5,1.個人資料,4,1,5,ㄓㄨˋ ㄓˇ,zhùzhǐ 
1246,子,3.5,1.個人資料,64,54,118,ㄗˇ ,zǐ 
1247,自然,3.5,16.情緒、態度,341,394,735,ㄗˋ ㄖㄢˊ,zìrán 
1248,自由,3.5,核心詞,197,88,285,ㄗˋ ㄧㄡˊ ,zìyóu  
1249,座,3.5,核心詞,186,186,372,ㄗㄨㄛˋ,zuò
1250,座位,3.5,5.交通、旅遊,25,6,31,ㄗㄨㄛˋ ㄨㄟˋ,zuòwèi 
1251,做到,3.5,核心詞,86,114,200,ㄗㄨㄛˋ ㄉㄠˋ,zuòdào 
1252,做生意,3.5,9.購物、商店,18,20,38,ㄗㄨㄛˋ ㄕㄥ ㄧˋ,zuòshēngyì  
1253,作文,3.5,8.教育、學習,13,10,23,ㄗㄨㄛˋ ㄨㄣˊ,zuòwén 
1254,左右,3.5,核心詞,126,88,214,ㄗㄨㄛˇ ㄧㄡˋ,zuǒyòu 
1255,愛好,4,核心詞,15,8,23,ㄞˋ ㄏㄠˋ,ài hào
1256,愛心,4,核心詞,18,88,106,ㄞˋ ㄒㄧㄣ,ài xīn
1257,哎呀,4,核心詞,15,28,43,ㄞ ˙ㄧㄚ,āi ya
1258,哎喲,4,核心詞,6,24,30,ㄞ ㄧㄠ,āi yāo
1259,安排,4,核心詞,119,61,180,ㄢ ㄆㄞˊ,ān pái
1260,按,4,核心詞,128,39,167,ㄢˋ,àn
1261,按照,4,核心詞,54,34,88,ㄢˋ ㄓㄠˋ,àn zhào
1262,擺,4,核心詞,71,55,126,ㄅㄞˇ,bǎi
1263,半天,4,核心詞,0,0,0,ㄅㄢˋ ㄊㄧㄢ,bàn tiān
1264,抱,4,核心詞,96,66,162,ㄅㄠˋ,bào
1265,抱怨,4,核心詞,71,22,93,ㄅㄠˋ ㄩㄢˋ,bào yuàn
1266,笨蛋,4,核心詞,11,2,13,ㄅㄣˋ ㄉㄢˋ,bèn dàn
1267,比如說/比如,4,核心詞,62,260,322,ㄅㄧˇ ㄖㄨˊㄕㄨㄛ/ㄅㄧˇ ㄖㄨˊ,bǐ rú shuō/bǐ rú
1268,必需,4,核心詞,8,7,15,ㄅㄧˋ ㄒㄩ,bì xū
1269,必要,4,核心詞,112,39,151,ㄅㄧˋ ㄧㄠˋ,bì yào
1270,變成,4,核心詞,312,540,852,ㄅㄧㄢˋ ㄔㄥˊ,biàn chéng
1271,變化,4,核心詞,146,184,330,ㄅㄧㄢˋ ㄏㄨㄚˋ,biàn huà
1272,表2,4,核心詞,39,39,78,ㄅㄧㄠˇ,biǎo
1273,表情,4,核心詞,87,28,115,ㄅㄧㄠˇ ㄑㄧㄥˊ,biǎo qíng
1274,並且,4,核心詞,225,137,362,ㄅㄧㄥˋ ㄑㄧㄝˇ,bìng qiě
1275,不得不,4,核心詞,83,21,104,ㄅㄨˋ ㄉㄜˊ ㄅㄨˋ,bù dé bù
1276,不斷,4,核心詞,257,233,490,ㄅㄨˊ ㄉㄨㄢˋ,bú duàn
1277,不論,4,核心詞,108,56,164,ㄅㄨˊ ㄌㄨㄣˋ,bú lùn
1278,不如,4,核心詞,86,39,125,ㄅㄨˋ ㄖㄨˊ,bù rú
1279,不行,4,核心詞,70,93,163,ㄅㄨˋ ㄒㄧㄥˊ,bù xíng
1280,擦,4,核心詞,39,55,94,ㄘㄚ,cā
1281,猜,4,核心詞,47,39,86,ㄘㄞ,cāi
1282,曾經/曾,4,核心詞,687,517,1204,ㄘㄥˊ ㄐㄧㄥ/ㄘㄥˊ,céng jīng/céng
1283,差一點/差點,4,核心詞,32,21,53,ㄔㄚ ㄧˋ ㄉㄧㄢ/ㄔㄚ ㄉㄧㄢˇ,chā yì diǎn/chā diǎn
1284,常見,4,核心詞,52,34,86,ㄔㄤˊ ㄐㄧㄢˋ,cháng jiàn
1285,吵架,4,核心詞,20,48,68,ㄔㄠˇ ㄐㄧㄚˋ,chǎo jià
1286,趁,4,核心詞,41,29,70,ㄔㄣˋ,chèn
1287,充電,4,核心詞,4,17,21,ㄔㄨㄥ ㄉㄧㄢˋ,chōng diàn
1288,抽菸/抽煙,4,核心詞,22,18,40,ㄔㄡ ㄧㄢ,chōu yān
1289,醜,4,核心詞,19,16,35,ㄔㄡˇ,chǒu
1290,初,4,核心詞,133,75,208,ㄔㄨ,chū
1291,吹,4,核心詞,53,70,123,ㄔㄨㄟ,chuī
1292,從小,4,核心詞,61,132,193,ㄘㄨㄥˊ ㄒㄧㄠˇ,cóng xiǎo
1293,粗,4,核心詞,33,29,62,ㄘㄨ,cū
1294,錯誤,4,核心詞,144,35,179,ㄘㄨㄛˋ ㄨˋ,cuò wù
1295,答應,4,核心詞,81,35,116,ㄉㄚ ㄧㄥˋ,dā yìng
1296,代,4,核心詞,159,187,346,ㄉㄞˋ,dài
1297,代表,4,核心詞,203,239,442,ㄉㄞˋ ㄅㄧㄠˇ,dài biǎo
1298,淡,4,核心詞,19,17,36,ㄉㄢˋ,dàn
1299,當成,4,核心詞,59,50,109,ㄉㄤˋ ㄔㄥˊ,dàng chéng
1300,當作/當做,4,核心詞,86,110,196,ㄉㄤˋ ㄗㄨㄛˋ ,dàng zuò 
1301,倒1,4,核心詞,166,102,268,ㄉㄠˋ,dào
1302,倒2,4,核心詞,166,102,268,ㄉㄠˇ,dǎo
1303,到期,4,核心詞,3,3,6,ㄉㄠˋ ㄑㄧˊ,dào qí
1304,電燈,4,核心詞,7,9,16,ㄉㄧㄢˋ ㄉㄥ,diàn dēng
1305,懂得,4,核心詞,91,60,151,ㄉㄨㄥˇ ˙ㄉㄜ,dǒng de
1306,棟,4,核心詞,59,60,119,ㄉㄨㄥˋ,dòng
1307,洞,4,核心詞,90,55,145,ㄉㄨㄥˋ,dòng
1308,動作,4,核心詞,190,191,381,ㄉㄨㄥˋ ㄗㄨㄛˋ,dòng zuò
1309,獨立,4,核心詞,98,85,183,ㄉㄨˊ ㄌㄧˋ,dú lì
1310,段,4,核心詞,387,341,728,ㄉㄨㄢˋ,duàn
1311,堆,4,核心詞,117,65,182,ㄉㄨㄟ,duī
1312,對方,4,核心詞,215,40,255,ㄉㄨㄟˋ ㄈㄤ,duì fāng
1313,對話,4,核心詞,77,46,123,ㄉㄨㄟˋ ㄏㄨㄚˋ,duì huà
1314,對象,4,核心詞,96,34,130,ㄉㄨㄟˋ ㄒㄧㄤˋ,duì xiàng
1315,頓,4,核心詞,72,20,92,ㄉㄨㄣˋ,dùn
1316,多半,4,核心詞,50,19,69,ㄉㄨㄛ ㄅㄢˋ,duō bàn
1317,多數,4,核心詞,53,28,81,ㄉㄨㄛ ㄕㄨˋ,duō shù
1318,躲,4,核心詞,56,42,98,ㄉㄨㄛˇ,duǒ
1319,嗯,4,核心詞,73,363,436,˙ㄣ,en
1320,兒童,4,核心詞,146,127,273,ㄦˊ ㄊㄨㄥˊ,ér tóng
1321,而已,4,核心詞,165,93,258,ㄦˊ ㄧˇ,ér yǐ
1322,發,4,核心詞,81,91,172,ㄈㄚ,fā
1323,翻,4,核心詞,42,56,98,ㄈㄢ,fān
1324,煩惱,4,核心詞,47,53,100,ㄈㄢˊ ㄋㄠˇ,fán nǎo
1325,反應,4,核心詞,218,106,324,ㄈㄢˇ ㄧㄥˋ,fǎn yìng
1326,放棄,4,核心詞,104,107,211,ㄈㄤˋ ㄑㄧˋ,fàng qì
1327,放下,4,核心詞,60,53,113,ㄈㄤˋ ㄒㄧㄚˋ,fàng xià
1328,分開,4,核心詞,27,18,45,ㄈㄣ ㄎㄞ,fēn kāi
1329,豐富,4,核心詞,98,130,228,ㄈㄥ ㄈㄨˋ,fēng fù
1330,婦女,4,核心詞,72,51,123,ㄈㄨˋ ㄋㄩˇ,fù nǚ
1331,複雜,4,核心詞,125,64,189,ㄈㄨˋ ㄗㄚˊ,fù zá
1332,改變,4,核心詞,372,360,732,ㄍㄞˇ ㄅㄧㄢˋ,gǎi biàn
1333,改天,4,核心詞,3,5,8,ㄍㄞˇ ㄊㄧㄢ,gǎi tiān
1334,感到,4,核心詞,291,73,364,ㄍㄢˇ ㄉㄠˋ,gǎn dào
1335,感動,4,核心詞,67,186,253,ㄍㄢˇ ㄉㄨㄥˋ,gǎn dòng
1336,感謝,4,核心詞,78,94,172,ㄍㄢˇ ㄒㄧㄝˋ,gǎn xiè
1337,各式各樣,4,核心詞,27,25,52,ㄍㄜˋ ㄕˋ ㄍㄜˋ ㄧㄤˋ,gè shì gè yàng
1338,根,4,核心詞,163,114,277,ㄍㄣ,gēn
1339,公尺,4,核心詞,80,147,227,ㄍㄨㄥ ㄔˇ,gōng chǐ
1340,公分,4,核心詞,42,76,118,ㄍㄨㄥ ㄈㄣ,gōng fēn
1341,公斤,4,核心詞,29,99,128,ㄍㄨㄥ ㄐㄧㄣ,gōng jīn
1342,公里,4,核心詞,95,136,231,ㄍㄨㄥ ㄌㄧˇ,gōng lǐ
1343,共同,4,核心詞,134,129,263,ㄍㄨㄥˋ ㄊㄨㄥˊ,gòng tóng
1344,溝通,4,核心詞,138,94,232,ㄍㄡ ㄊㄨㄥ,gōu tōng
1345,鼓勵,4,核心詞,115,160,275,ㄍㄨˇ ㄌㄧˋ,gǔ lì
1346,故意,4,核心詞,67,32,99,ㄍㄨˋ ㄧˋ,gù yì
1347,乖,4,核心詞,18,56,74,ㄍㄨㄞ,guāi
1348,怪,4,核心詞,90,42,132,ㄍㄨㄞˋ,guài
1349,關門,4,核心詞,9,10,19,ㄍㄨㄢ ㄇㄣˊ,guān mén
1350,管,4,核心詞,90,95,185,ㄍㄨㄢˇ,guǎn
1351,規定,4,核心詞,77,49,126,ㄍㄨㄟ ㄉㄧㄥˋ,guī dìng
1352,貴姓,4,核心詞,1,1,2,ㄍㄨㄟˋ ㄒㄧㄥˋ,guì xìng
1353,過期,4,核心詞,3,5,8,ㄍㄨㄛˋ ㄑㄧˊ,guò qí
1354,過去,4,核心詞,364,393,757,ㄍㄨㄛˋ ㄑㄩˋ,guò qù
1355,哈,4,核心詞,29,42,71,ㄏㄚ,hā
1356,害,4,核心詞,62,60,122,ㄏㄞˋ,hài
1357,嗨,4,核心詞,11,18,29,ㄏㄞ,hāi
1358,海外,4,核心詞,30,24,54,ㄏㄞˇ ㄨㄞˋ,hǎi wài
1359,喊,4,核心詞,81,26,107,ㄏㄢˇ,hǎn
1360,好2,4,核心詞,1887,5853,7740,ㄏㄠˋ,hào
1361,厚,4,核心詞,36,38,74,ㄏㄡˋ,hòu
1362,忽然/忽,4,核心詞,143,26,169,ㄏㄨ ㄖㄢˊ/ㄏㄨ,hū rán/hū
1363,糊塗,4,核心詞,15,3,18,ㄏㄨˊ ㄊㄨˊ,hú tú
1364,互相,4,核心詞,97,105,202,ㄏㄨˋ ㄒㄧㄤ,hù xiāng
1365,滑,4,核心詞,15,18,33,ㄏㄨㄚˊ,huá
1366,話題,4,核心詞,54,32,86,ㄏㄨㄚˋ ㄊㄧˊ,huà tí
1367,或許,4,核心詞,231,108,339,ㄏㄨㄛˋ ㄒㄩˇ,huò xǔ
1368,幾乎,4,核心詞,306,236,542,ㄐㄧ ㄏㄨ,jī hū
1369,激烈,4,核心詞,48,23,71,ㄐㄧ ㄌㄧㄝˋ,jī liè
1370,機器,4,核心詞,78,66,144,ㄐㄧ ㄑㄧˋ,jī qì
1371,擠,4,核心詞,35,23,58,ㄐㄧˇ,jǐ
1372,記,4,核心詞,67,69,136,ㄐㄧˋ,jì
1373,記錄,4,核心詞,65,64,129,ㄐㄧˋ ㄌㄨˋ,jì lù
1374,繼續,4,核心詞,319,296,615,ㄐㄧˋ ㄒㄩˋ,jì xù
1375,加入,4,核心詞,103,138,241,ㄐㄧㄚ ㄖㄨˋ,jiā rù
1376,家事,4,核心詞,21,26,47,ㄐㄧㄚ ㄕˋ,jiā shì
1377,架,4,核心詞,57,37,94,ㄐㄧㄚˋ,jià
1378,價錢,4,核心詞,18,29,47,ㄐㄧㄚˋ ㄑㄧㄢˊ,jià qián
1379,剪,4,核心詞,17,72,89,ㄐㄧㄢˇ,jiǎn
1380,檢查,4,核心詞,93,91,184,ㄐㄧㄢˇ ㄔㄚˊ,jiǎn chá
1381,減少,4,核心詞,92,199,291,ㄐㄧㄢˇ ㄕㄠˇ,jiǎn shǎo
1382,見到,4,核心詞,120,30,150,ㄐㄧㄢˋ ㄉㄠˋ,jiàn dào
1383,將來,4,核心詞,73,74,147,ㄐㄧㄤ ㄌㄞˊ,jiāng lái
1384,講話,4,核心詞,52,83,135,ㄐㄧㄤˇ ㄏㄨㄚˋ,jiǎng huà
1385,講價,4,核心詞,1,0,1,ㄐㄧㄤˇ ㄐㄧㄚˋ,jiǎng jià
1386,解決,4,核心詞,234,228,462,ㄐㄧㄝˇ ㄐㄩㄝˊ,jiě jué
1387,解釋,4,核心詞,247,66,313,ㄐㄧㄝˇ ㄕˋ,jiě shì
1388,接受,4,核心詞,360,196,556,ㄐㄧㄝ ㄕㄡˋ,jiē shòu
1389,接下來,4,核心詞,92,223,315,ㄐㄧㄝ ㄒㄧㄚˋ ㄌㄞˊ,jiē xià lái
1390,緊,4,核心詞,51,33,84,ㄐㄧㄣˇ,jǐn
1391,舉,4,核心詞,82,65,147,ㄐㄩˇ,jǔ
1392,舉辦,4,核心詞,45,52,97,ㄐㄩˇ ㄅㄢˋ,jǔ bàn
1393,舉行,4,核心詞,60,66,126,ㄐㄩˇ ㄒㄧㄥˊ,jǔ xíng
1394,拒絕,4,核心詞,114,32,146,ㄐㄩˋ ㄐㄩㄝˊ,jù jué
1395,距離/距,4,核心詞,126,127,253,ㄐㄩˋ ㄌㄧˊ/ㄐㄩˋ,jù lí/jù
1396,看出,4,核心詞,78,23,101,ㄎㄢˋ ㄔㄨ,kàn chū
1397,靠,4,核心詞,224,217,441,ㄎㄠˋ,kào
1398,靠近,4,核心詞,44,43,87,ㄎㄠˋ ㄐㄧㄣˋ,kào jìn
1399,考慮,4,核心詞,111,49,160,ㄎㄠˇ ㄌㄩˋ,kǎo lǜ
1400,棵,4,核心詞,68,145,213,ㄎㄜ,kē
1401,可憐,4,核心詞,77,31,108,ㄎㄜˇ ㄌㄧㄢˊ,kě lián
1402,恐怕,4,核心詞,102,62,164,ㄎㄨㄥˇ ㄆㄚˋ,kǒng pà
1403,快速,4,核心詞,83,69,152,ㄎㄨㄞˋ ㄙㄨˋ,kuài sù
1404,寬,4,核心詞,43,35,78,ㄎㄨㄢ,kuān
1405,來不及,4,核心詞,30,37,67,ㄌㄞˊ ㄅㄨˋ ㄐㄧˊ,lái bù jí
1406,來得及,4,核心詞,10,7,17,ㄌㄞˊ ˙ㄉㄜ ㄐㄧˊ,lái de jí
1407,來自,4,核心詞,161,178,339,ㄌㄞˊ ㄗˋ,lái zì
1408,懶,4,核心詞,7,4,11,ㄌㄢˇ,lǎn
1409,浪費,4,核心詞,50,107,157,ㄌㄤˋ ㄈㄟˋ,làng fèi
1410,老是,4,核心詞,39,12,51,ㄌㄠˇ ㄕˋ,lǎo shì
1411,理由,4,核心詞,124,35,159,ㄌㄧˇ ㄧㄡˊ,lǐ yóu
1412,厲害,4,核心詞,53,169,222,ㄌㄧˋ ㄏㄞˋ,lì hài
1413,亮,4,核心詞,49,61,110,ㄌㄧㄤˋ,liàng
1414,量1,4,核心詞,34,167,201,ㄌㄧㄤˋ,liàng
1415,領,4,核心詞,50,44,94,ㄌㄧㄥˇ,lǐng
1416,路線,4,核心詞,35,37,72,ㄌㄨˋ ㄒㄧㄢˋ,lù xiàn
1417,罵,4,核心詞,64,83,147,ㄇㄚˋ,mà
1418,滿意,4,核心詞,71,22,93,ㄇㄢˇ ㄧˋ,mǎn yì
1419,滿足,4,核心詞,111,47,158,ㄇㄢˇ ㄗㄨˊ,mǎn zú
1420,慢用,4,核心詞,1,0,1,ㄇㄢˋ ㄩㄥˋ,màn yòng
1421,沒(有)用,4,核心詞,0,0,0,ㄇㄟˊ (ㄧㄡˇ) ㄩㄥˋ,méi (yǒu) yòng
1422,夢想,4,核心詞,61,126,187,ㄇㄥˋ ㄒㄧㄤˇ,mèng xiǎng
1423,迷路,4,核心詞,8,7,15,ㄇㄧˊ ㄌㄨˋ,mí lù
1424,面前,4,核心詞,125,29,154,ㄇㄧㄢˋ ㄑㄧㄢˊ,miàn qián
1425,秒,4,核心詞,62,51,113,ㄇㄧㄠˇ,miǎo
1426,明白,4,核心詞,198,32,230,ㄇㄧㄥˊ ㄅㄞˊ,míng bái
1427,摸,4,核心詞,52,47,99,ㄇㄛ,mō
1428,目標,4,核心詞,231,118,349,ㄇㄨˋ ㄅㄧㄠ,mù biāo
1429,目前,4,核心詞,184,377,561,ㄇㄨˋ ㄑㄧㄢˊ,mù qián
1430,拿出,4,核心詞,60,19,79,ㄋㄚˊ ㄔㄨ,ná chū
1431,濃,4,核心詞,27,22,49,ㄋㄨㄥˊ,nóng
1432,哦,4,核心詞,65,105,170,ㄛˊ,ó
1433,喔,4,核心詞,79,1304,1383,ㄛ,ō
1434,排,4,核心詞,68,90,158,ㄆㄞˊ,pái
1435,碰,4,核心詞,43,32,75,ㄆㄥˋ,pèng
1436,碰到,4,核心詞,73,109,182,ㄆㄥˋ ㄉㄠˋ,pèng dào
1437,碰見,4,核心詞,7,0,7,ㄆㄥˋ ㄐㄧㄢˋ,pèng jiàn
1438,篇,4,核心詞,174,48,222,ㄆㄧㄢ,piān
1439,平均,4,核心詞,56,134,190,ㄆㄧㄥˊ ㄐㄩㄣ,píng jūn
1440,平日,4,核心詞,25,13,38,ㄆㄧㄥˊ ㄖˋ,píng rì
1441,平時,4,核心詞,36,24,60,ㄆㄧㄥˊ ㄕˊ,píng shí
1442,破壞,4,核心詞,71,116,187,ㄆㄛˋ ㄏㄨㄞˋ,pò huài
1443,普遍,4,核心詞,57,44,101,ㄆㄨˇ ㄅㄧㄢˋ,pǔ biàn
1444,普通,4,核心詞,48,28,76,ㄆㄨˇ ㄊㄨㄥ,pǔ tōng
1445,強1,4,核心詞,141,158,299,ㄑㄧㄤˊ,qiáng
1446,情況,4,核心詞,340,241,581,ㄑㄧㄥˊ ㄎㄨㄤˋ,qíng kuàng
1447,窮,4,核心詞,43,28,71,ㄑㄩㄥˊ,qióng
1448,全球,4,核心詞,91,441,532,ㄑㄩㄢˊ ㄑㄧㄡˊ,quán qiú
1449,卻,4,核心詞,1310,602,1912,ㄑㄩㄝˋ,què
1450,確定,4,核心詞,158,79,237,ㄑㄩㄝˋ ㄉㄧㄥˋ,què dìng
1451,群/羣,4,核心詞,173,197,370,ㄑㄩㄣˊ,qún
1452,熱心,4,核心詞,19,20,39,ㄖㄜˋ ㄒㄧㄣ,rè xīn
1453,仍然/仍,4,核心詞,522,141,663,ㄖㄥˊ ㄖㄢˊ/ㄖㄥˊ,réng rán/réng
1454,日期,4,核心詞,22,9,31,ㄖˋ ㄑㄧˊ,rì qí
1455,軟,4,核心詞,31,40,71,ㄖㄨㄢˇ,ruǎn
1456,商量,4,核心詞,30,10,40,ㄕㄤ ㄌㄧㄤˊ,shāng liáng
1457,燒,4,核心詞,63,88,151,ㄕㄠ,shāo
1458,少數,4,核心詞,67,41,108,ㄕㄠˇ ㄕㄨˋ,shǎo shù
1459,申請,4,核心詞,34,38,72,ㄕㄣ ㄑㄧㄥˇ,shēn qǐng
1460,剩,4,核心詞,33,40,73,ㄕㄥˋ,shèng
1461,省,4,核心詞,57,114,171,ㄕㄥˇ,shěng
1462,剩下,4,核心詞,65,93,158,ㄕㄥˋ ㄒㄧㄚˋ,shèng xià
1463,時常,4,核心詞,33,22,55,ㄕˊ ㄔㄤˊ,shí cháng
1464,十分,4,核心詞,234,59,293,ㄕˊ ㄈㄣ,shí fēn
1465,世紀,4,核心詞,47,62,109,ㄕˋ ㄐㄧˋ,shì jì
1466,事實,4,核心詞,317,249,566,ㄕˋ ㄕˊ,shì shí
1467,使用,4,核心詞,371,387,758,ㄕˇ ㄩㄥˋ,shǐ yòng
1468,受,4,核心詞,424,251,675,ㄕㄡˋ,shòu
1469,受不了,4,核心詞,28,25,53,ㄕㄡˋ ㄅㄨˋ ㄌㄧㄠˇ,shòu bù liǎo
1470,受到,4,核心詞,253,265,518,ㄕㄡˋ ㄉㄠˋ,shòu dào
1471,首都,4,核心詞,35,65,100,ㄕㄡˇ ㄉㄨ,shǒu dū
1472,首先,4,核心詞,112,141,253,ㄕㄡˇ ㄒㄧㄢ,shǒu xiān
1473,樹木,4,核心詞,23,43,66,ㄕㄨˋ ㄇㄨˋ,shù mù
1474,順便,4,核心詞,23,30,53,ㄕㄨㄣˋ ㄅㄧㄢˋ,shùn biàn
1475,順利,4,核心詞,70,72,142,ㄕㄨㄣˋ ㄌㄧˋ,shùn lì
1476,說出,4,核心詞,73,16,89,ㄕㄨㄛ ㄔㄨ,shuō chū
1477,說法,4,核心詞,116,45,161,ㄕㄨㄛ ㄈㄚˇ,shuō fǎ
1478,說明,4,核心詞,183,76,259,ㄕㄨㄛ ㄇㄧㄥˊ,shuō míng
1479,鬆,4,核心詞,28,30,58,ㄙㄨㄥ,sōng
1480,隨便,4,核心詞,42,55,97,ㄙㄨㄟˊ ㄅㄧㄢˋ,suí biàn
1481,隨時,4,核心詞,90,66,156,ㄙㄨㄟˊ ㄕˊ,suí shí
1482,牠,4,核心詞,343,659,1002,ㄊㄚ,tā
1483,態度,4,核心詞,232,124,356,ㄊㄞˋ ㄉㄨˋ,tài dù
1484,躺,4,核心詞,82,30,112,ㄊㄤˇ,tǎng
1485,討厭,4,核心詞,56,30,86,ㄊㄠˇ ㄧㄢˋ,tǎo yàn
1486,特色,4,核心詞,52,73,125,ㄊㄜˋ ㄙㄜˋ,tè sè
1487,提到,4,核心詞,129,167,296,ㄊㄧˊ ㄉㄠˋ,tí dào
1488,提醒,4,核心詞,89,102,191,ㄊㄧˊ ㄒㄧㄥˇ,tí xǐng
1489,填,4,核心詞,16,16,32,ㄊㄧㄢˊ,tián
1490,挑1,4,核心詞,45,64,109,ㄊㄧㄠ,tiāo
1491,條件,4,核心詞,135,114,249,ㄊㄧㄠˊ ㄐㄧㄢˋ,tiáo jiàn
1492,貼,4,核心詞,46,48,94,ㄊㄧㄝ,tiē
1493,通常,4,核心詞,224,190,414,ㄊㄨㄥ ㄔㄤˊ,tōng cháng
1494,通過,4,核心詞,96,93,189,ㄊㄨㄥ ㄍㄨㄛˋ,tōng guò
1495,通知,4,核心詞,33,19,52,ㄊㄨㄥ ㄓ,tōng zhī
1496,投,4,核心詞,23,17,40,ㄊㄡˊ,tóu
1497,土,4,核心詞,39,125,164,ㄊㄨˇ,tǔ
1498,突然,4,核心詞,277,117,394,ㄊㄨˊ ㄖㄢˊ,tú rán
1499,推,4,核心詞,58,64,122,ㄊㄨㄟ,tuī
1500,玩具,4,核心詞,46,64,110,ㄨㄢˊ ㄐㄩˋ,wán jù
1501,網,4,核心詞,61,54,115,ㄨㄤˇ,wǎng
1502,未來,4,核心詞,217,292,509,ㄨㄟˋ ㄌㄞˊ,wèi lái
1503,溫度,4,核心詞,33,230,263,ㄨㄣ ㄉㄨˋ,wēn dù
1504,無論,4,核心詞,151,34,185,ㄨˊ ㄌㄨㄣˋ,wú lùn
1505,細,4,核心詞,36,41,77,ㄒㄧˋ,xì
1506,喜愛,4,核心詞,48,19,67,ㄒㄧˇ ㄞˋ,xǐ ài
1507,嚇,4,核心詞,67,42,109,ㄒㄧㄚˋ,xià
1508,相反,4,核心詞,71,20,91,ㄒㄧㄤ ㄈㄢˇ,xiāng fǎn
1509,想念,4,核心詞,18,11,29,ㄒㄧㄤˇ ㄋㄧㄢˋ,xiǎng niàn
1510,想起,4,核心詞,106,18,124,ㄒㄧㄤˇ ㄑㄧˇ,xiǎng qǐ
1511,相同,4,核心詞,119,47,166,ㄒㄧㄤ ㄊㄨㄥˊ,xiāng tóng
1512,想像,4,核心詞,181,132,313,ㄒㄧㄤˇ ㄒㄧㄤˋ,xiǎng xiàng
1513,消夜/宵夜,4,核心詞,2,3,5,ㄒㄧㄠ ㄧㄝˋ ,xiāo yè 
1514,血,4,核心詞,80,34,114,ㄒㄧㄝˇ,xiě
1515,信心,4,核心詞,80,63,143,ㄒㄧㄣˋ ㄒㄧㄣ,xìn xīn
1516,興奮,4,核心詞,86,29,115,ㄒㄧㄥ ㄈㄣˋ,xīng fèn
1517,幸運,4,核心詞,42,42,84,ㄒㄧㄥˋ ㄩㄣˋ,xìng yùn
1518,壓力,4,核心詞,180,188,368,ㄧㄚ ㄌㄧˋ,yā lì
1519,嚴格/嚴,4,核心詞,70,61,131,ㄧㄢˊ ㄍㄜˊ/ㄧㄢˊ,yán gé/yán
1520,煙火,4,核心詞,5,3,8,ㄧㄢ ㄏㄨㄛˇ,yān huǒ
1521,咬,4,核心詞,46,43,89,ㄧㄠˇ,yǎo
1522,要不然,4,核心詞,12,52,64,ㄧㄠˋ ㄅㄨˋ ㄖㄢˊ,yào bù rán
1523,要緊,4,核心詞,18,6,24,ㄧㄠˋ ㄐㄧㄣˇ,yào jǐn
1524,頁,4,核心詞,156,29,185,ㄧㄝˋ,yè
1525,葉子/葉,4,核心詞,90,166,256,ㄧㄝˋ ˙ㄗ/ㄧㄝˋ,yè zi/yè
1526,一邊(兒),4,核心詞,137,65,202,ㄧˋ ㄅㄧㄢ(ㄦ),yì biān(r)
1527,一同,4,核心詞,36,19,55,ㄧˋ ㄊㄨㄥˊ,yì tóng
1528,硬,4,核心詞,72,53,125,ㄧㄥˋ,yìng
1529,用處,4,核心詞,13,5,18,ㄩㄥˋ ㄔㄨˋ,yòng chù
1530,用心,4,核心詞,34,102,136,ㄩㄥˋ ㄒㄧㄣ,yòng xīn
1531,永遠,4,核心詞,190,115,305,ㄩㄥˇ ㄩㄢˇ,yǒng yuǎn
1532,有關,4,核心詞,247,115,362,ㄧㄡˇ ㄍㄨㄢ,yǒu guān
1533,噢,4,核心詞,80,19,99,ㄩˇ,yǔ
1534,遇到,4,核心詞,122,156,278,ㄩˋ ㄉㄠˋ,yù dào
1535,遇見,4,核心詞,31,7,38,ㄩˋ ㄐㄧㄢˋ,yù jiàn
1536,願望,4,核心詞,24,23,47,ㄩㄢˋ ㄨㄤˋ,yuàn wàng
1537,運氣,4,核心詞,32,16,48,ㄩㄣˋ ˙ㄑㄧ,yùn qi
1538,載1,4,核心詞,66,47,113,ㄗㄞˋ,zài
1539,增加/增,4,核心詞,217,230,447,ㄗㄥ ㄐㄧㄚ/ㄗㄥ,zēng jiā/zēng
1540,著急,4,核心詞,17,7,24,ㄓㄠ ㄐㄧˊ,zhāo jí
1541,陣,4,核心詞,106,20,126,ㄓㄣˋ,zhèn
1542,真正,4,核心詞,296,202,498,ㄓㄣ ㄓㄥˋ,zhēn zhèng
1543,正確,4,核心詞,166,88,254,ㄓㄥˋ ㄑㄩㄝˋ,zhèng què
1544,整天,4,核心詞,15,8,23,ㄓㄥˇ ㄊㄧㄢ,zhěng tiān
1545,直,4,核心詞,128,50,178,ㄓˊ,zhí
1546,指,4,核心詞,237,81,318,ㄓˇ,zhǐ
1547,值得,4,核心詞,131,119,250,ㄓˊ ˙ㄉㄜ,zhí de
1548,之後,4,核心詞,785,1006,1791,ㄓ ㄏㄡˋ,zhī hòu
1549,之間,4,核心詞,435,261,696,ㄓ ㄐㄧㄢ,zhī jiān
1550,之前,4,核心詞,321,293,614,ㄓ ㄑㄧㄢˊ,zhī qián
1551,至少,4,核心詞,167,142,309,ㄓˋ ㄕㄠˇ,zhì shǎo
1552,只是,4,核心詞,373,356,729,ㄓˇ ㄕˋ,zhǐ shì
1553,之中,4,核心詞,179,24,203,ㄓ ㄓㄨㄥ,zhī zhōng
1554,種2,4,核心詞,2584,3158,5742,ㄓㄨㄥˋ,zhòng
1555,重點,4,核心詞,84,102,186,ㄓㄨㄥˋ ㄉㄧㄢˇ,zhòng diǎn
1556,種類,4,核心詞,25,35,60,ㄓㄨㄥˇ ㄌㄟˋ,zhǒng lèi
1557,重視,4,核心詞,96,76,172,ㄓㄨㄥˋ ㄕˋ,zhòng shì
1558,終於,4,核心詞,231,148,379,ㄓㄨㄥ ㄩˊ,zhōng yú
1559,主角,4,核心詞,85,36,121,ㄓㄨˇ ㄐㄧㄠˇ / ㄓㄨˇ ㄐㄩㄝˊ,zhǔ jiǎo / zhǔ jué 
1560,主要,4,核心詞,278,394,672,ㄓㄨˇ ㄧㄠˋ,zhǔ yào
1561,竹子/竹,4,核心詞,37,88,125,ㄓㄨˊ ˙ㄗ/ㄓㄨˊ,zhú zi/zhú
1562,追,4,核心詞,49,27,76,ㄓㄨㄟ,zhuī
1563,準時,4,核心詞,14,16,30,ㄓㄨㄣˇ ㄕˊ,zhǔn shí
1564,自動,4,核心詞,52,32,84,ㄗˋ ㄉㄨㄥˋ,zì dòng
1565,子女,4,核心詞,75,37,112,ㄗˇ ㄋㄩˇ,zǐ nǚ
1566,總共,4,核心詞,22,68,90,ㄗㄨㄥˇ ㄍㄨㄥˋ,zǒng gòng
1567,宗教/教2,4,核心詞,291,441,732,ㄗㄨㄥ ㄐㄧㄠˋ/ㄐㄧㄠˋ,zōng jiào/jiào
1568,足夠,4,核心詞,67,43,110,ㄗㄨˊ ㄍㄡˋ,zú gòu
1569,做出,4,核心詞,113,58,171,ㄗㄨㄛˋ ㄔㄨ,zuò chū
1570,作者,4,核心詞,153,30,183,ㄗㄨㄛˋ ㄓㄜˇ,zuò zhě
1571,阿公,4,1.個人資料,10,115,125,ㄚ ㄍㄨㄥ,ā gōng
1572,阿嬤/阿媽,4,1.個人資料,41,301,342,ㄚ ˙ㄇㄚ,ā ma
1573,拜拜,4,1.個人資料,4,66,70,ㄅㄞˋ ㄅㄞˋ,bài bài
1574,夫妻,4,1.個人資料,81,62,143,ㄈㄨ ㄑㄧ,fū qī
1575,個人,4,1.個人資料,277,104,381,ㄍㄜˋ ㄖㄣˊ,gè rén
1576,個性,4,1.個人資料,79,69,148,ㄍㄜˋ ㄒㄧㄥˋ,gè xìng
1577,國內,4,1.個人資料,64,81,145,ㄍㄨㄛˊ ㄋㄟˋ,guó nèi
1578,國外,4,1.個人資料,33,76,109,ㄍㄨㄛˊ ㄨㄞˋ,guó wài
1579,國中,4,1.個人資料,23,54,77,ㄍㄨㄛˊ ㄓㄨㄥ,guó zhōng
1580,猴子/猴,4,1.個人資料,67,31,98,ㄏㄡˊ ˙ㄗ/ㄏㄡˊ,hóu zi/hóu
1581,活潑,4,1.個人資料,28,27,55,ㄏㄨㄛˊ ㄆㄛ,huó pō
1582,教堂,4,1.個人資料,47,39,86,ㄐㄧㄠˋ ㄊㄤˊ,jiào táng
1583,老鼠/鼠,4,1.個人資料,75,43,118,ㄌㄠˇ ㄕㄨˇ/ㄕㄨˇ,lǎo shǔ/shǔ
1584,龍,4,1.個人資料,68,28,96,ㄌㄨㄥˊ,lóng
1585,男性,4,1.個人資料,77,21,98,ㄋㄢˊ ㄒㄧㄥˋ,nán xìng
1586,年齡,4,1.個人資料,76,43,119,ㄋㄧㄢˊ ㄌㄧㄥˊ,nián líng
1587,農曆,4,1.個人資料,8,18,26,ㄋㄨㄥˊ ㄌㄧˋ,nóng lì
1588,女性,4,1.個人資料,162,80,242,ㄋㄩˇ ㄒㄧㄥˋ,nǚ xìng
1589,親戚,4,1.個人資料,37,30,67,ㄑㄧㄣ ㄑㄧ,qīn qī
1590,全家,4,1.個人資料,16,25,41,ㄑㄩㄢˊ ㄐㄧㄚ,quán jiā
1591,生,4,1.個人資料,235,236,471,ㄕㄥ,shēng
1592,外語,4,1.個人資料,6,3,9,ㄨㄞˋ ㄩˇ,wài yǔ
1593,羊,4,1.個人資料,61,41,102,ㄧㄤˊ,yáng
1594,移民,4,1.個人資料,25,82,107,ㄧˊ ㄇㄧㄣˊ,yí mín
1595,職業,4,1.個人資料,52,36,88,ㄓˊ ㄧㄝˋ,zhí yè
1596,自信,4,1.個人資料,61,37,98,ㄗˋ ㄒㄧㄣˋ,zì xìn
1597,祖父,4,1.個人資料,23,13,36,ㄗㄨˇ ㄈㄨˋ,zǔ fù
1598,祖母,4,1.個人資料,22,6,28,ㄗㄨˇ ㄇㄨˇ,zǔ mǔ
1599,安靜,4,2.日常起居,54,26,80,ㄢ ㄐㄧㄥˋ,ān jìng
1600,玻璃,4,2.日常起居,42,38,80,ㄅㄛ ㄌㄧˊ,bō lí
1601,出租,4,2.日常起居,6,4,10,ㄔㄨ ㄗㄨ,chū zū
1602,打掃,4,2.日常起居,13,22,35,ㄉㄚˇ ㄙㄠˇ,dǎ sǎo
1603,大廳,4,2.日常起居,25,3,28,ㄉㄚˋ ㄊㄧㄥ,dà tīng
1604,電風扇/電扇,4,2.日常起居,4,15,19,ㄉㄧㄢˋ ㄈㄥ ㄕㄢˋ/ㄉㄧㄢˋ ㄕㄢˋ,diàn fēng shàn/diàn shàn
1605,都市,4,2.日常起居,27,79,106,ㄉㄨ ㄕˋ,dū shì
1606,費用,4,2.日常起居,37,32,69,ㄈㄟˋ ㄩㄥˋ,fèi yòng
1607,公寓,4,2.日常起居,40,7,47,ㄍㄨㄥ ㄩˋ,gōng yù
1608,花園,4,2.日常起居,51,19,70,ㄏㄨㄚ ㄩㄢˊ,huā yuán
1609,化妝,4,2.日常起居,7,7,14,ㄏㄨㄚˋ ㄓㄨㄤ,huà zhuāng
1610,回收,4,2.日常起居,9,214,223,ㄏㄨㄟˊ ㄕㄡ,huí shōu
1611,家鄉,4,2.日常起居,36,57,93,ㄐㄧㄚ ㄒㄧㄤ,jiā xiāng
1612,郊區,4,2.日常起居,8,8,16,ㄐㄧㄠ ㄑㄩ,jiāo qū
1613,空間,4,2.日常起居,190,151,341,ㄎㄨㄥ ㄐㄧㄢ,kōng jiān
1614,老公,4,2.日常起居,13,40,53,ㄌㄠˇ ㄍㄨㄥ,lǎo gōng
1615,老婆,4,2.日常起居,54,50,104,ㄌㄠˇ ㄆㄛˊ,lǎo pó
1616,暖氣,4,2.日常起居,4,4,8,ㄋㄨㄢˇ ㄑㄧˋ,nuǎn qì
1617,區,4,2.日常起居,18,82,100,ㄑㄩ,qū
1618,掃,4,2.日常起居,16,35,51,ㄙㄠˇ,sǎo
1619,掃地,4,2.日常起居,6,10,16,ㄙㄠˇ ㄉㄧˋ,sǎo dì
1620,設備,4,2.日常起居,53,50,103,ㄕㄜˋ ㄅㄟˋ,shè bèi
1621,瓦斯,4,2.日常起居,6,17,23,ㄨㄚˇ ㄙ,wǎ sī
1622,文具,4,2.日常起居,4,6,10,ㄨㄣˊ ㄐㄩˋ,wén jù
1623,屋頂,4,2.日常起居,26,50,76,ㄨ ㄉㄧㄥˇ,wū dǐng
1624,巷,4,2.日常起居,9,4,13,ㄒㄧㄤˋ,xiàng
1625,巷口,4,2.日常起居,3,1,4,ㄒㄧㄤˋ ㄎㄡˇ,xiàng kǒu
1626,香水,4,2.日常起居,7,3,10,ㄒㄧㄤ ㄕㄨㄟˇ,xiāng shuǐ
1627,香菸/菸,4,2.日常起居,27,12,39,ㄒㄧㄤ ㄧㄢ/ㄧㄢ,xiāng yān/yān
1628,巷子,4,2.日常起居,8,4,12,ㄒㄧㄤˋ ˙ㄗ,xiàng zi
1629,醒,4,2.日常起居,30,12,42,ㄒㄧㄥˇ,xǐng
1630,修理,4,2.日常起居,15,21,36,ㄒㄧㄡ ㄌㄧˇ,xiū lǐ
1631,整理,4,2.日常起居,76,80,156,ㄓㄥˇ ㄌㄧˇ,zhěng lǐ
1632,煮飯,4,2.日常起居,10,30,40,ㄓㄨˇ ㄈㄢˋ,zhǔ fàn
1633,租金,4,2.日常起居,4,6,10,ㄗㄨ ㄐㄧㄣ,zū jīn
1634,做夢/作夢,4,2.日常起居,23,11,34,ㄗㄨㄛˋ ㄇㄥˋ ,zuò mèng 
1635,成長,4,3.職業,188,189,377,ㄔㄥˊ ㄓㄤˇ,chéng zhǎng
1636,地位,4,3.職業,137,32,169,ㄉㄧˋ ㄨㄟˋ,dì wèi
1637,發展,4,3.職業,407,347,754,ㄈㄚ ㄓㄢˇ,fā zhǎn
1638,工廠,4,3.職業,80,81,161,ㄍㄨㄥ ㄔㄤˇ,gōng chǎng
1639,會議,4,3.職業,121,97,218,ㄏㄨㄟˋ ㄧˋ,huì yì
1640,技術,4,3.職業,178,160,338,ㄐㄧˋ ㄕㄨˋ,jì shù
1641,記者,4,3.職業,67,73,140,ㄐㄧˋ ㄓㄜˇ,jì zhě
1642,競爭,4,3.職業,130,41,171,ㄐㄧㄥˋ ㄓㄥ,jìng zhēng
1643,開放,4,3.職業,71,46,117,ㄎㄞ ㄈㄤˋ,kāi fàng
1644,買賣,4,3.職業,18,10,28,ㄇㄞˇ ㄇㄞˋ,mǎi mài
1645,面試,4,3.職業,10,1,11,ㄇㄧㄢˋ ㄕˋ,miàn shì
1646,派,4,3.職業,158,62,220,ㄆㄞˋ,pài
1647,請假,4,3.職業,6,9,15,ㄑㄧㄥˇ ㄐㄧㄚˋ,qǐng jià
1648,人才,4,3.職業,72,12,84,ㄖㄣˊ ㄘㄞˊ,rén cái
1649,上班族,4,3.職業,10,13,23,ㄕㄤˋ ㄅㄢ ㄗㄨˊ,shàng bān zú
1650,收入,4,3.職業,50,90,140,ㄕㄡ ㄖㄨˋ,shōu rù
1651,同事,4,3.職業,82,34,116,ㄊㄨㄥˊ ㄕˋ,tóng shì
1652,退休,4,3.職業,72,81,153,ㄊㄨㄟˋ ㄒㄧㄡ,tuì xiū
1653,薪水,4,3.職業,24,28,52,ㄒㄧㄣ ㄕㄨㄟˇ,xīn shuǐ
1654,訓練,4,3.職業,200,119,319,ㄒㄩㄣˋ ㄌㄧㄢˋ,xùn liàn
1655,員工,4,3.職業,151,55,206,ㄩㄢˊ ㄍㄨㄥ,yuán gōng
1656,賺,4,3.職業,40,72,112,ㄓㄨㄢˋ,zhuàn
1657,賺錢,4,3.職業,35,63,98,ㄓㄨㄢˋ ㄑㄧㄢˊ,zhuàn qián
1658,專業,4,3.職業,150,110,260,ㄓㄨㄢ ㄧㄝˋ,zhuān yè
1659,資源,4,3.職業,105,263,368,ㄗ ㄩㄢˊ,zī yuán
1660,表演,4,4.休閒、娛樂,66,99,165,ㄅㄧㄠˇ ㄧㄢˇ,biǎo yǎn
1661,博物館,4,4.休閒、娛樂,29,45,74,ㄅㄛˊ ㄨˋ ㄍㄨㄢˇ,bó wù guǎn
1662,導演,4,4.休閒、娛樂,54,16,70,ㄉㄠˇ ㄧㄢˇ,dǎo yǎn
1663,隊,4,4.休閒、娛樂,30,31,61,ㄉㄨㄟˋ,duì
1664,鋼琴,4,4.休閒、娛樂,53,12,65,ㄍㄤ ㄑㄧㄣˊ,gāng qín
1665,歌手,4,4.休閒、娛樂,12,8,20,ㄍㄜ ㄕㄡˇ,gē shǒu
1666,觀眾,4,4.休閒、娛樂,86,267,353,ㄍㄨㄢ ㄓㄨㄥˋ,guān zhòng
1667,滑雪,4,4.休閒、娛樂,9,2,11,ㄏㄨㄚˊ ㄒㄩㄝˇ,huá xuě
1668,獎,4,4.休閒、娛樂,24,44,68,ㄐㄧㄤˇ,jiǎng
1669,節目,4,4.休閒、娛樂,66,178,244,ㄐㄧㄝˊ ㄇㄨˋ,jié mù
1670,卡通,4,4.休閒、娛樂,8,18,26,ㄎㄚˇ ㄊㄨㄥ,kǎ tōng
1671,溜冰,4,4.休閒、娛樂,2,1,3,ㄌㄧㄡ ㄅㄧㄥ,liū bīng
1672,毛筆,4,4.休閒、娛樂,5,3,8,ㄇㄠˊ ㄅㄧˇ,máo bǐ
1673,媒體,4,4.休閒、娛樂,94,108,202,ㄇㄟˊ ㄊㄧˇ,méi tǐ
1674,內容,4,4.休閒、娛樂,182,73,255,ㄋㄟˋ ㄖㄨㄥˊ,nèi róng
1675,球隊,4,4.休閒、娛樂,24,4,28,ㄑㄧㄡˊ ㄉㄨㄟˋ,qiú duì
1676,球賽,4,4.休閒、娛樂,9,1,10,ㄑㄧㄡˊ ㄙㄞˋ,qiú sài
1677,輸,4,4.休閒、娛樂,36,37,73,ㄕㄨ,shū
1678,水準,4,4.休閒、娛樂,41,16,57,ㄕㄨㄟˇ ㄓㄨㄣˇ,shuǐ zhǔn
1679,網友,4,4.休閒、娛樂,5,10,15,ㄨㄤˇ ㄧㄡˇ,wǎng yǒu
1680,舞台/舞臺,4,4.休閒、娛樂,52,67,119,ㄨˇ ㄊㄞˊ,wǔ tái
1681,享受,4,4.休閒、娛樂,89,78,167,ㄒㄧㄤˇ ㄕㄡˋ,xiǎng shòu
1682,小說,4,4.休閒、娛樂,188,22,210,ㄒㄧㄠˇ ㄕㄨㄛ,xiǎo shuō
1683,休閒,4,4.休閒、娛樂,22,20,42,ㄒㄧㄡ ㄒㄧㄢˊ,xiū xián
1684,演員,4,4.休閒、娛樂,41,21,62,ㄧㄢˇ ㄩㄢˊ,yǎn yuán
1685,養,4,4.休閒、娛樂,75,170,245,ㄧㄤˇ,yǎng
1686,藝術,4,4.休閒、娛樂,212,110,322,ㄧˋ ㄕㄨˋ,yì shù
1687,贏,4,4.休閒、娛樂,45,36,81,ㄧㄥˊ,yíng
1688,影片,4,4.休閒、娛樂,61,95,156,ㄧㄥˇ ㄆㄧㄢˋ,yǐng piàn
1689,展覽,4,4.休閒、娛樂,14,21,35,ㄓㄢˇ ㄌㄢˇ,zhǎn lǎn
1690,主題,4,4.休閒、娛樂,83,40,123,ㄓㄨˇ ㄊㄧˊ,zhǔ tí
1691,班機,4,5.交通、旅遊,5,4,9,ㄅㄢ ㄐㄧ,bān jī
1692,超過,4,5.交通、旅遊,129,244,373,ㄔㄠ ㄍㄨㄛˋ,chāo guò
1693,潮溼/潮濕,4,5.交通、旅遊,13,22,35,ㄔㄠˊ ㄕ,cháo shī
1694,出發,4,5.交通、旅遊,60,59,119,ㄔㄨ ㄈㄚ,chū fā
1695,島,4,5.交通、旅遊,55,81,136,ㄉㄠˇ,dǎo
1696,地區,4,5.交通、旅遊,129,329,458,ㄉㄧˋ ㄑㄩ,dì qū
1697,地震,4,5.交通、旅遊,16,176,192,ㄉㄧˋ ㄓㄣˋ,dì zhèn
1698,動物園,4,5.交通、旅遊,9,14,23,ㄉㄨㄥˋ ㄨˋ ㄩㄢˊ,dòng wù yuán
1699,高鐵,4,5.交通、旅遊,3,15,18,ㄍㄠ ㄊㄧㄝˇ,gāo tiě
1700,工具,4,5.交通、旅遊,99,72,171,ㄍㄨㄥ ㄐㄩˋ,gōng jù
1701,觀光,4,5.交通、旅遊,18,68,86,ㄍㄨㄢ ㄍㄨㄤ,guān guāng
1702,觀光客,4,5.交通、旅遊,8,30,38,ㄍㄨㄢ ㄍㄨㄤ ㄎㄜˋ,guān guāng kè
1703,海洋,4,5.交通、旅遊,30,132,162,ㄏㄞˇ ㄧㄤˊ,hǎi yáng
1704,紅綠燈,4,5.交通、旅遊,2,5,7,ㄏㄨㄥˊ ㄌㄩˋ ㄉㄥ,hóng lǜ dēng
1705,護照,4,5.交通、旅遊,8,4,12,ㄏㄨˋ ㄓㄠˋ,hù zhào
1706,進口,4,5.交通、旅遊,21,37,58,ㄐㄧㄣˋ ㄎㄡˇ,jìn kǒu
1707,進入,4,5.交通、旅遊,236,219,455,ㄐㄧㄣˋ ㄖㄨˋ,jìn rù
1708,旅遊,4,5.交通、旅遊,29,52,81,ㄌㄩˇ ㄧㄡˊ,lǚ yóu
1709,悶熱,4,5.交通、旅遊,5,5,10,ㄇㄣ ㄖㄜˋ,mēn rè
1710,起飛,4,5.交通、旅遊,12,5,17,ㄑㄧˇ ㄈㄟ,qǐ fēi
1711,氣候,4,5.交通、旅遊,27,261,288,ㄑㄧˋ ㄏㄡˋ,qì hòu
1712,氣溫,4,5.交通、旅遊,12,47,59,ㄑㄧˋ ㄨㄣ,qì wēn
1713,橋,4,5.交通、旅遊,49,70,119,ㄑㄧㄠˊ,qiáo
1714,人口,4,5.交通、旅遊,66,148,214,ㄖㄣˊ ㄎㄡˇ,rén kǒu
1715,人數,4,5.交通、旅遊,45,73,118,ㄖㄣˊ ㄕㄨˋ,rén shù
1716,人行道,4,5.交通、旅遊,11,3,14,ㄖㄣˊ ㄒㄧㄥˊ ㄉㄠˋ,rén xíng dào
1717,塞車,4,5.交通、旅遊,3,4,7,ㄙㄞ ㄔㄜ,sāi chē
1718,森林,4,5.交通、旅遊,56,114,170,ㄙㄣ ㄌㄧㄣˊ,sēn lín
1719,石頭/石,4,5.交通、旅遊,130,147,277,ㄕˊ ˙ㄊㄡ/ㄕˊ,shí tou/shí
1720,趟,4,5.交通、旅遊,50,72,122,ㄊㄤˋ,tàng
1721,鐵路,4,5.交通、旅遊,28,42,70,ㄊㄧㄝˇ ㄌㄨˋ,tiě lù
1722,溫暖,4,5.交通、旅遊,54,95,149,ㄨㄣ ㄋㄨㄢˇ,wēn nuǎn
1723,線,4,5.交通、旅遊,66,92,158,ㄒㄧㄢˋ,xiàn
1724,愛情,4,6.社交、人際,78,12,90,ㄞˋ ㄑㄧㄥˊ,ài qíng
1725,抱歉,4,6.社交、人際,30,12,42,ㄅㄠˋ ㄑㄧㄢˋ,bào qiàn
1726,打招呼,4,6.社交、人際,20,15,35,ㄉㄚˇ ㄓㄠ ㄏㄨ,dǎ zhāo hū
1727,典禮,4,6.社交、人際,16,15,31,ㄉㄧㄢˇ ㄌㄧˇ,diǎn lǐ
1728,分享,4,6.社交、人際,75,258,333,ㄈㄣ ㄒㄧㄤˇ,fēn xiǎng
1729,感情,4,6.社交、人際,106,81,187,ㄍㄢˇ ㄑㄧㄥˊ,gǎn qíng
1730,恭喜,4,6.社交、人際,7,31,38,ㄍㄨㄥ ㄒㄧˇ,gōng xǐ
1731,婚禮,4,6.社交、人際,24,25,49,ㄏㄨㄣ ㄌㄧˇ,hūn lǐ
1732,紀念,4,6.社交、人際,31,36,67,ㄐㄧˋ ㄋㄧㄢˋ,jì niàn
1733,交換,4,6.社交、人際,39,37,76,ㄐㄧㄠ ㄏㄨㄢˋ,jiāo huàn
1734,聯絡,4,6.社交、人際,31,30,61,ㄌㄧㄢˊ ㄌㄨㄛˋ,lián luò
1735,留言,4,6.社交、人際,9,5,14,ㄌㄧㄡˊ ㄧㄢˊ,liú yán
1736,名片,4,6.社交、人際,22,6,28,ㄇㄧㄥˊ ㄆㄧㄢˋ,míng piàn
1737,親切,4,6.社交、人際,31,15,46,ㄑㄧㄣ ㄑㄧㄝˋ,qīn qiè
1738,慶祝,4,6.社交、人際,18,31,49,ㄑㄧㄥˋ ㄓㄨˋ,qìng zhù
1739,熱情,4,6.社交、人際,78,67,145,ㄖㄜˋ ㄑㄧㄥˊ,rè qíng
1740,問好,4,6.社交、人際,3,1,4,ㄨㄣˋ ㄏㄠˇ,wèn hǎo
1741,新郎,4,6.社交、人際,7,2,9,ㄒㄧㄣ ㄌㄤˊ,xīn láng
1742,新娘,4,6.社交、人際,19,12,31,ㄒㄧㄣ ㄋㄧㄤˊ,xīn niáng
1743,邀請,4,6.社交、人際,58,61,119,ㄧㄠ ㄑㄧㄥˇ,yāo qǐng
1744,病房,4,7.身體、醫療,21,27,48,ㄅㄧㄥˋ ㄈㄤˊ,bìng fáng
1745,成熟,4,7.身體、醫療,64,54,118,ㄔㄥˊ ㄕㄡˊ,chéng shóu
1746,耳,4,7.身體、醫療,62,15,77,ㄦˇ,ěr
1747,功能,4,7.身體、醫療,170,141,311,ㄍㄨㄥ ㄋㄥˊ,gōng néng
1748,喉嚨/喉,4,7.身體、醫療,28,12,40,ㄏㄡˊ ㄌㄨㄥˊ/ㄏㄡˊ,hóu lóng/hóu
1749,呼吸,4,7.身體、醫療,79,52,131,ㄏㄨ ㄒㄧ,hū xī
1750,恢復,4,7.身體、醫療,85,75,160,ㄏㄨㄟ ㄈㄨˋ,huī fù
1751,活,4,7.身體、醫療,205,171,376,ㄏㄨㄛˊ,huó
1752,救,4,7.身體、醫療,71,95,166,ㄐㄧㄡˋ,jiù
1753,口罩,4,7.身體、醫療,3,18,21,ㄎㄡˇ ㄓㄠˋ,kǒu zhào
1754,拉肚子,4,7.身體、醫療,4,6,10,ㄌㄚ ㄉㄨˋ ˙ㄗ,lā dù zi
1755,腦子/腦,4,7.身體、醫療,152,64,216,ㄋㄠˇ ˙ㄗ/ㄋㄠˇ,nǎo zi/nǎo
1756,胖子,4,7.身體、醫療,9,4,13,ㄆㄤˋ ˙ㄗ,pàng zi
1757,皮膚,4,7.身體、醫療,64,46,110,ㄆㄧˊ ㄈㄨ,pí fū
1758,全身,4,7.身體、醫療,16,7,23,ㄑㄩㄢˊ ㄕㄣ,quán shēn
1759,傷,4,7.身體、醫療,47,46,93,ㄕㄤ,shāng
1760,受傷,4,7.身體、醫療,56,80,136,ㄕㄡˋ ㄕㄤ,shòu shāng
1761,手指頭/手指/指頭,4,7.身體、醫療,82,25,107,ㄕㄡˇ ㄓˇ ˙ㄊㄡ/ㄕㄡˇ ㄓˇ/ㄓˇ ˙ㄊㄡ,shǒu zhǐ tou/shǒu zhǐ/zhǐ tou
1762,疼痛,4,7.身體、醫療,63,17,80,ㄊㄥˊ ㄊㄨㄥˋ,téng tòng
1763,體力,4,7.身體、醫療,31,39,70,ㄊㄧˇ ㄌㄧˋ,tǐ lì
1764,停止,4,7.身體、醫療,99,62,161,ㄊㄧㄥˊ ㄓˇ,tíng zhǐ
1765,牙齒/牙,4,7.身體、醫療,57,68,125,ㄧㄚˊ ㄔˇ/ㄧㄚˊ,yá chǐ/yá
1766,眼淚/淚,4,7.身體、醫療,77,44,121,ㄧㄢˇ ㄌㄟˋ/ㄌㄟˋ,yǎn lèi/lèi
1767,用力,4,7.身體、醫療,50,28,78,ㄩㄥˋ ㄌㄧˋ,yòng lì
1768,醉,4,7.身體、醫療,18,3,21,ㄗㄨㄟˋ,zuì
1769,報名,4,8.教育、學習,9,13,22,ㄅㄠˋ ㄇㄧㄥˊ,bào míng
1770,筆記,4,8.教育、學習,28,14,42,ㄅㄧˇ ㄐㄧˋ,bǐ jì
1771,筆記本,4,8.教育、學習,13,5,18,ㄅㄧˇ ㄐㄧˋ ㄅㄣˇ,bǐ jì běn
1772,表現,4,8.教育、學習,237,84,321,ㄅㄧㄠˇ ㄒㄧㄢˋ,biǎo xiàn
1773,博士,4,8.教育、學習,111,415,526,ㄅㄛˊ ㄕˋ,bó shì
1774,補習班,4,8.教育、學習,10,12,22,ㄅㄨˇ ㄒㄧˊ ㄅㄢ,bǔ xí bān
1775,地球,4,8.教育、學習,80,346,426,ㄉㄧˋ ㄑㄧㄡˊ,dì qiú
1776,動詞,4,8.教育、學習,4,2,6,ㄉㄨㄥˋ ㄘˊ,dòng cí
1777,發明,4,8.教育、學習,66,57,123,ㄈㄚ ㄇㄧㄥˊ,fā míng
1778,發音,4,8.教育、學習,14,7,21,ㄈㄚ ㄧㄣ,fā yīn
1779,反對,4,8.教育、學習,107,77,184,ㄈㄢˇ ㄉㄨㄟˋ,fǎn duì
1780,翻譯/譯,4,8.教育、學習,64,19,83,ㄈㄢ ㄧˋ/ㄧˋ,fān yì/yì
1781,訪問/訪,4,8.教育、學習,66,99,165,ㄈㄤˇ ㄨㄣˋ/ㄈㄤˇ,fǎng wèn/fǎng
1782,分數,4,8.教育、學習,28,21,49,ㄈㄣ ㄕㄨˋ,fēn shù
1783,複習,4,8.教育、學習,4,12,16,ㄈㄨˋ ㄒㄧˊ,fù xí
1784,觀念,4,8.教育、學習,161,156,317,ㄍㄨㄢ ㄋㄧㄢˋ,guān niàn
1785,規則,4,8.教育、學習,59,14,73,ㄍㄨㄟ ㄗㄜˊ,guī zé
1786,國際,4,8.教育、學習,121,326,447,ㄍㄨㄛˊ ㄐㄧˋ,guó jì
1787,漢語,4,8.教育、學習,6,7,13,ㄏㄢˋ ㄩˇ,hàn yǔ
1788,會話,4,8.教育、學習,2,4,6,ㄏㄨㄟˋ ㄏㄨㄚˋ,huì huà
1789,級,4,8.教育、學習,35,43,78,ㄐㄧˊ,jí
1790,紀錄,4,8.教育、學習,61,114,175,ㄐㄧˋ ㄌㄨˋ,jì lù
1791,家長,4,8.教育、學習,82,85,167,ㄐㄧㄚ ㄓㄤˇ,jiā zhǎng
1792,獎學金,4,8.教育、學習,8,6,14,ㄐㄧㄤˇ ㄒㄩㄝˊ ㄐㄧㄣ,jiǎng xué jīn
1793,教師,4,8.教育、學習,96,15,111,ㄐㄧㄠˋ ㄕ,jiào shī
1794,教學,4,8.教育、學習,103,62,165,ㄐㄧㄠˋ ㄒㄩㄝˊ,jiào xué
1795,節,4,8.教育、學習,38,59,97,ㄐㄧㄝˊ,jié
1796,近年,4,8.教育、學習,30,50,80,ㄐㄧㄣˋ ㄋㄧㄢˊ,jìn nián
1797,考卷,4,8.教育、學習,5,10,15,ㄎㄠˇ ㄐㄩㄢˋ,kǎo juàn
1798,課程,4,8.教育、學習,134,92,226,ㄎㄜˋ ㄔㄥˊ,kè chéng
1799,科技,4,8.教育、學習,122,113,235,ㄎㄜ ㄐㄧˋ,kē jì
1800,課文,4,8.教育、學習,3,2,5,ㄎㄜˋ ㄨㄣˊ,kè wén
1801,科學,4,8.教育、學習,286,124,410,ㄎㄜ ㄒㄩㄝˊ,kē xué
1802,口音,4,8.教育、學習,11,1,12,ㄎㄡˇ ㄧㄣ,kǒu yīn
1803,練,4,8.教育、學習,48,62,110,ㄌㄧㄢˋ,liàn
1804,流利,4,8.教育、學習,8,4,12,ㄌㄧㄡˊ ㄌㄧˋ,liú lì
1805,留學,4,8.教育、學習,18,7,25,ㄌㄧㄡˊ ㄒㄩㄝˊ,liú xué
1806,名詞,4,8.教育、學習,30,18,48,ㄇㄧㄥˊ ㄘˊ,míng cí
1807,簽名,4,8.教育、學習,15,12,27,ㄑㄧㄢ ㄇㄧㄥˊ,qiān míng
1808,生詞,4,8.教育、學習,1,0,1,ㄕㄥ ㄘˊ,shēng cí
1809,聲調,4,8.教育、學習,9,1,10,ㄕㄥ ㄉㄧㄠˋ,shēng diào
1810,失敗,4,8.教育、學習,139,57,196,ㄕ ㄅㄞˋ,shī bài
1811,退步,4,8.教育、學習,5,5,10,ㄊㄨㄟˋ ㄅㄨˋ,tuì bù
1812,推薦,4,8.教育、學習,52,16,68,ㄊㄨㄟ ㄐㄧㄢˋ,tuī jiàn
1813,文章/文,4,8.教育、學習,209,94,303,ㄨㄣˊ ㄓㄤ/ㄨㄣˊ,wén zhāng/wén
1814,文字,4,8.教育、學習,114,57,171,ㄨㄣˊ ㄗˋ,wén zì
1815,系,4,8.教育、學習,17,14,31,ㄒㄧˋ,xì
1816,校長,4,8.教育、學習,52,69,121,ㄒㄧㄠˋ ㄓㄤˇ,xiào zhǎng
1817,學費,4,8.教育、學習,10,20,30,ㄒㄩㄝˊ ㄈㄟˋ,xué fèi
1818,演講,4,8.教育、學習,63,41,104,ㄧㄢˇ ㄐㄧㄤˇ,yǎn jiǎng
1819,研究所,4,8.教育、學習,52,26,78,ㄧㄢˊ ㄐㄧㄡˋ ㄙㄨㄛˇ,yán jiù suǒ
1820,英雄,4,8.教育、學習,90,28,118,ㄧㄥ ㄒㄩㄥˊ,yīng xióng
1821,影印,4,8.教育、學習,6,2,8,ㄧㄥˇ ㄧㄣˋ,yǐng yìn
1822,預習,4,8.教育、學習,2,2,4,ㄩˋ ㄒㄧˊ,yù xí
1823,閱讀,4,8.教育、學習,137,56,193,ㄩㄝˋ ㄉㄨˊ,yuè dú
1824,證明,4,8.教育、學習,133,56,189,ㄓㄥˋ ㄇㄧㄥˊ,zhèng míng
1825,政治,4,8.教育、學習,258,154,412,ㄓㄥˋ ㄓˋ,zhèng zhì
1826,支持,4,8.教育、學習,164,234,398,ㄓ ㄔˊ,zhī chí
1827,中文系,4,8.教育、學習,3,3,6,ㄓㄨㄥ ㄨㄣˊ ㄒㄧˋ,zhōng wén xì
1828,主任,4,8.教育、學習,56,43,99,ㄓㄨˇ ㄖㄣˋ,zhǔ rèn
1829,專家,4,8.教育、學習,123,178,301,ㄓㄨㄢ ㄐㄧㄚ,zhuān jiā
1830,專心,4,8.教育、學習,44,41,85,ㄓㄨㄢ ㄒㄧㄣ,zhuān xīn
1831,資訊,4,8.教育、學習,154,70,224,ㄗ ㄒㄩㄣˋ,zī xùn
1832,作家,4,8.教育、學習,86,18,104,ㄗㄨㄛˋ ㄐㄧㄚ,zuò jiā
1833,便利,4,9.購物、商店,16,25,41,ㄅㄧㄢˋ ㄌㄧˋ,biàn lì
1834,超級,4,9.購物、商店,30,32,62,ㄔㄠ ㄐㄧˊ,chāo jí
1835,襯衫,4,9.購物、商店,22,3,25,ㄔㄣˋ ㄕㄢ,chèn shān
1836,大小,4,9.購物、商店,72,32,104,ㄉㄚˋ ㄒㄧㄠˇ,dà xiǎo
1837,地攤,4,9.購物、商店,1,1,2,ㄉㄧˋ ㄊㄢ,dì tān
1838,電池,4,9.購物、商店,12,66,78,ㄉㄧㄢˋ ㄔˊ,diàn chí
1839,購買,4,9.購物、商店,59,24,83,ㄍㄡˋ ㄇㄞˇ,gòu mǎi
1840,顧客,4,9.購物、商店,119,14,133,ㄍㄨˋ ㄎㄜˋ,gù kè
1841,廣告,4,9.購物、商店,126,26,152,ㄍㄨㄤˇ ㄍㄠˋ,guǎng gào
1842,櫃檯/櫃台/櫃臺,4,9.購物、商店,21,4,25,ㄍㄨㄟˋ ㄊㄞˊ ,guì tái
1843,價格,4,9.購物、商店,69,77,146,ㄐㄧㄚˋ ㄍㄜˊ,jià gé
1844,剪刀,4,9.購物、商店,9,13,22,ㄐㄧㄢˇ ㄉㄠ,jiǎn dāo
1845,鏡子/鏡,4,9.購物、商店,63,28,91,ㄐㄧㄥˋ ˙ㄗ/ㄐㄧㄥˋ,jìng zi/jìng
1846,免費,4,9.購物、商店,26,38,64,ㄇㄧㄢˇ ㄈㄟˋ,miǎn fèi
1847,牛仔褲,4,9.購物、商店,7,3,10,ㄋㄧㄡˊ ㄗˇ ㄎㄨˋ,niú zǐ kù
1848,牌子/牌,4,9.購物、商店,46,29,75,ㄆㄞˊ ˙ㄗ/ㄆㄞˊ,pái zi/pái
1849,品質,4,9.購物、商店,85,117,202,ㄆㄧㄣˇ ㄓˊ,pǐn zhí
1850,鉛筆,4,9.購物、商店,12,13,25,ㄑㄧㄢ ㄅㄧˇ,qiān bǐ
1851,熱門,4,9.購物、商店,12,15,27,ㄖㄜˋ ㄇㄣˊ,rè mén
1852,數量,4,9.購物、商店,49,76,125,ㄕㄨˋ ㄌㄧㄤˋ,shù liàng
1853,塑膠,4,9.購物、商店,21,96,117,ㄙㄨˋ ㄐㄧㄠ,sù jiāo
1854,攤子,4,9.購物、商店,5,3,8,ㄊㄢ ˙ㄗ,tān zi
1855,現金,4,9.購物、商店,17,7,24,ㄒㄧㄢˋ ㄐㄧㄣ,xiàn jīn
1856,修,4,9.購物、商店,50,74,124,ㄒㄧㄡ,xiū
1857,找錢,4,9.購物、商店,1,1,2,ㄓㄠˇ ㄑㄧㄢˊ,zhǎo qián
1858,材料,4,10.餐飲、烹飪,52,105,157,ㄘㄞˊ ㄌㄧㄠˋ,cái liào
1859,茶葉,4,10.餐飲、烹飪,11,68,79,ㄔㄚˊ ㄧㄝˋ,chá yè
1860,醋,4,10.餐飲、烹飪,9,13,22,ㄘㄨˋ,cù
1861,蓋,4,10.餐飲、烹飪,108,164,272,ㄍㄞˋ,gài
1862,蓋子,4,10.餐飲、烹飪,7,12,19,ㄍㄞˋ ˙ㄗ,gài zi
1863,高麗菜,4,10.餐飲、烹飪,5,29,34,ㄍㄠ ㄌㄧˊ ㄘㄞˋ,gāo lí cài
1864,鍋子/鍋,4,10.餐飲、烹飪,51,48,99,ㄍㄨㄛ ˙ㄗ/ㄍㄨㄛ,guō zi/guō
1865,胡椒,4,10.餐飲、烹飪,7,1,8,ㄏㄨˊ ㄐㄧㄠ,hú jiāo
1866,加熱,4,10.餐飲、烹飪,7,17,24,ㄐㄧㄚ ㄖㄜˋ,jiā rè
1867,醬油,4,10.餐飲、烹飪,9,26,35,ㄐㄧㄤˋ ㄧㄡˊ,jiàng yóu
1868,口味,4,10.餐飲、烹飪,20,22,42,ㄎㄡˇ ㄨㄟˋ,kǒu wèi
1869,辣椒,4,10.餐飲、烹飪,7,18,25,ㄌㄚˋ ㄐㄧㄠ,là jiāo
1870,美食,4,10.餐飲、烹飪,11,24,35,ㄇㄟˇ ㄕˊ,měi shí
1871,奶油,4,10.餐飲、烹飪,13,9,22,ㄋㄞˇ ㄧㄡˊ,nǎi yóu
1872,皮,4,10.餐飲、烹飪,51,61,112,ㄆㄧˊ,pí
1873,切,4,10.餐飲、烹飪,21,48,69,ㄑㄧㄝ,qiē
1874,蔬菜,4,10.餐飲、烹飪,23,148,171,ㄕㄨ ㄘㄞˋ,shū cài
1875,素食,4,10.餐飲、烹飪,6,57,63,ㄙㄨˋ ㄕˊ,sù shí
1876,燙,4,10.餐飲、烹飪,12,36,48,ㄊㄤˋ,tàng
1877,蝦子/蝦,4,10.餐飲、烹飪,21,15,36,ㄒㄧㄚ ˙ㄗ/ㄒㄧㄚ,xiā zi/xiā
1878,飲食,4,10.餐飲、烹飪,70,103,173,ㄧㄣˇ ㄕˊ,yǐn shí
1879,玉米,4,10.餐飲、烹飪,14,53,67,ㄩˋ ㄇㄧˇ,yù mǐ
1880,月餅,4,10.餐飲、烹飪,4,2,6,ㄩㄝˋ ㄅㄧㄥˇ,yuè bǐng
1881,煮,4,10.餐飲、烹飪,54,154,208,ㄓㄨˇ,zhǔ
1882,粽子,4,10.餐飲、烹飪,4,8,12,ㄗㄨㄥˋ ˙ㄗ,zòng zi
1883,美金,4,11.公共服務,16,35,51,ㄇㄟˇ ㄐㄧㄣ,měi jīn
1884,美元,4,11.公共服務,121,54,175,ㄇㄟˇ ㄩㄢˊ,měi yuán
1885,密碼,4,11.公共服務,17,21,38,ㄇㄧˋ ㄇㄚˇ,mì mǎ
1886,歐元,4,11.公共服務,1,4,5,ㄡ ㄩㄢˊ,ōu yuán
1887,日圓,4,11.公共服務,16,3,19,ㄖˋ ㄩㄢˊ,rì yuán
1888,新台幣/新臺幣/台幣/臺幣,4,11.公共服務,14,66,80,ㄒㄧㄣ ㄊㄞˊ ㄅㄧˋ/ㄊㄞˊ ㄅㄧˋ ,xīn tái bì/tái bì
1889,郵差,4,11.公共服務,5,8,13,ㄧㄡˊ ㄔㄞ,yóu chāi
1890,車禍,4,12.安全,17,13,30,ㄔㄜ ㄏㄨㄛˋ,chē huò
1891,出現,4,12.安全,458,284,742,ㄔㄨ ㄒㄧㄢˋ,chū xiàn
1892,假2,4,12.安全,66,50,116,ㄐㄧㄚˇ,jiǎ
1893,警察,4,12.安全,72,52,124,ㄐㄧㄥˇ ㄔㄚˊ,jǐng chá
1894,恐怖,4,12.安全,49,126,175,ㄎㄨㄥˇ ㄅㄨˋ,kǒng bù
1895,律師,4,12.安全,58,7,65,ㄌㄩˋ ㄕ,lǜ shī
1896,騙,4,12.安全,31,34,65,ㄆㄧㄢˋ,piàn
1897,平安,4,12.安全,25,48,73,ㄆㄧㄥˊ ㄢ,píng ān
1898,搶,4,12.安全,39,30,69,ㄑㄧㄤˇ,qiǎng
1899,槍,4,12.安全,53,21,74,ㄑㄧㄤ,qiāng
1900,殺,4,12.安全,217,56,273,ㄕㄚ,shā
1901,小偷,4,12.安全,11,4,15,ㄒㄧㄠˇ ㄊㄡ,xiǎo tōu
1902,意外,4,12.安全,91,80,171,ㄧˋ ㄨㄞˋ,yì wài
1903,大自然,4,13.自然環境,52,151,203,ㄉㄚˋ ㄗˋ ㄖㄢˊ,dà zì rán
1904,老虎/虎,4,13.自然環境,104,31,135,ㄌㄠˇ ㄏㄨˇ/ㄏㄨˇ,lǎo hǔ/hǔ
1905,溼度/濕度,4,13.自然環境,6,23,29,ㄕ ㄉㄨˋ,shī dù
1906,雲,4,13.自然環境,102,54,156,ㄩㄣˊ,yún
1907,公共,4,14.社會,47,42,89,ㄍㄨㄥ ㄍㄨㄥˋ,gōng gòng
1908,公平,4,14.社會,47,29,76,ㄍㄨㄥ ㄆㄧㄥˊ,gōng píng
1909,和平,4,14.社會,45,97,142,ㄏㄜˊ ㄆㄧㄥˊ,hé píng
1910,經濟,4,14.社會,252,421,673,ㄐㄧㄥ ㄐㄧˋ,jīng jì
1911,民主,4,14.社會,60,64,124,ㄇㄧㄣˊ ㄓㄨˇ,mín zhǔ
1912,平等,4,14.社會,33,29,62,ㄆㄧㄥˊ ㄉㄥˇ,píng děng
1913,青少年,4,14.社會,74,26,100,ㄑㄧㄥ ㄕㄠˋ ㄋㄧㄢˊ,qīng shào nián
1914,權利,4,14.社會,41,27,68,ㄑㄩㄢˊ ㄌㄧˋ,quán lì
1915,土地,4,14.社會,106,331,437,ㄊㄨˇ ㄉㄧˋ,tǔ dì
1916,團體,4,14.社會,111,120,231,ㄊㄨㄢˊ ㄊㄧˇ,tuán tǐ
1917,責任,4,14.社會,120,76,196,ㄗㄜˊ ㄖㄣˋ,zé rèn
1918,戰爭,4,14.社會,157,161,318,ㄓㄢˋ ㄓㄥ,zhàn zhēng
1919,政府,4,14.社會,305,570,875,ㄓㄥˋ ㄈㄨˇ,zhèng fǔ
1920,制度,4,14.社會,129,45,174,ㄓˋ ㄉㄨˋ,zhì dù
1921,總統,4,14.社會,74,174,248,ㄗㄨㄥˇ ㄊㄨㄥˇ,zǒng tǒng
1922,紅包,4,15.文化,5,13,18,ㄏㄨㄥˊ ㄅㄠ,hóng bāo
1923,假期,4,15.文化,13,13,26,ㄐㄧㄚˋ ㄑㄧˊ,jià qí
1924,神,4,15.文化,173,69,242,ㄕㄣˊ,shén
1925,偉大,4,15.文化,76,38,114,ㄨㄟˇ ㄉㄚˋ,wěi dà
1926,好奇,4,16.情緒、態度,65,71,136,ㄏㄠˋ ㄑㄧˊ,hào qí
1927,痛苦,4,16.情緒、態度,152,72,224,ㄊㄨㄥˋ ㄎㄨˇ,tòng kǔ
1928,吸引,4,16.情緒、態度,82,77,159,ㄒㄧ ㄧㄣˇ,xī yǐn
1929,勇敢,4,16.情緒、態度,42,48,90,ㄩㄥˇ ㄍㄢˇ,yǒng gǎn
1930,自我,4,16.情緒、態度,262,76,338,ㄗˋ ㄨㄛˇ,zì wǒ
1931,電子,4,17.科技,81,42,123,ㄉㄧㄢˋ ㄗˇ,diàn zǐ
1932,計算,4,17.科技,57,25,82,ㄐㄧˋ ㄙㄨㄢˋ,jì suàn
1933,平板電腦,4,17.科技,0,0,0,ㄆㄧㄥˊ ㄅㄢˇ ㄉㄧㄢˋ ㄋㄠˇ,píng bǎn diàn nǎo
1934,數字,4,17.科技,81,54,135,ㄕㄨˋ ㄗˋ,shù zì
1935,隨身碟,4,17.科技,0,0,0,ㄙㄨㄟˊ ㄕㄣ ㄉㄧㄝˊ,suí shēn dié
1936,唉,4.5,核心詞,35,15,50,ㄞ,āi
1937,岸,4.5,5.交通、旅遊,30,27,57,ㄢˋ,àn
1938,暗,4.5,核心詞,50,20,70,ㄢˋ,àn
1939,案子/案,4.5,12.安全,70,38,108,ㄢˋ ˙ㄗ/ㄢˋ,àn zi/àn
1940,熬夜,4.5,核心詞,5,5,10,ㄠˊ ㄧㄝˋ,áo yè
1941,拜訪,4.5,6.社交、人際,40,41,81,ㄅㄞˋ ㄈㄤˇ,bài fǎng
1942,拜年,4.5,15.文化,3,1,4,ㄅㄞˋ ㄋㄧㄢˊ,bài nián
1943,辦事處,4.5,11.公共服務,6,3,9,ㄅㄢˋ ㄕˋ ㄔㄨˋ,bàn shì chù
1944,扮演,4.5,核心詞,71,52,123,ㄅㄢˋ ㄧㄢˇ,bàn yǎn
1945,寶,4.5,核心詞,43,38,81,ㄅㄠˇ,bǎo
1946,保持,4.5,核心詞,162,80,242,ㄅㄠˇ ㄔˊ,bǎo chí
1947,包裹,4.5,11.公共服務,17,8,25,ㄅㄠ ㄍㄨㄛˇ,bāo guǒ
1948,包含,4.5,核心詞,53,51,104,ㄅㄠ ㄏㄢˊ,bāo hán
1949,保證,4.5,核心詞,68,26,94,ㄅㄠˇ ㄓㄥˋ,bǎo zhèng
1950,背後,4.5,核心詞,85,71,156,ㄅㄟˋ ㄏㄡˋ,bèi hòu
1951,背景,4.5,核心詞,78,56,134,ㄅㄟˋ ㄐㄧㄥˇ,bèi jǐng
1952,背心,4.5,9.購物、商店,7,7,14,ㄅㄟˋ ㄒㄧㄣ,bèi xīn
1953,被子,4.5,2.日常起居,6,5,11,ㄅㄟˋ ˙ㄗ,bèi zi
1954,本人,4.5,核心詞,51,9,60,ㄅㄣˇ ㄖㄣˊ,běn rén
1955,避免,4.5,12.安全,132,98,230,ㄅㄧˋ ㄇㄧㄢˇ,bì miǎn
1956,鼻涕,4.5,7.身體、醫療,7,4,11,ㄅㄧˊ ㄊㄧˋ,bí tì
1957,編,4.5,核心詞,68,22,90,ㄅㄧㄢ,biān
1958,表達,4.5,16.情緒、態度,124,79,203,ㄅㄧㄠˇ ㄉㄚˊ,biǎo dá
1959,表格,4.5,核心詞,21,1,22,ㄅㄧㄠˇ ㄍㄜˊ,biǎo gé
1960,表哥,4.5,1.個人資料,5,5,10,ㄅㄧㄠˇ ㄍㄜ,biǎo gē
1961,表妹,4.5,1.個人資料,5,4,9,ㄅㄧㄠˇ ㄇㄟˋ,biǎo mèi
1962,表面,4.5,核心詞,73,59,132,ㄅㄧㄠˇ ㄇㄧㄢˋ,biǎo miàn
1963,表示,4.5,核心詞,277,243,520,ㄅㄧㄠˇ ㄕˋ,biǎo shì
1964,並,4.5,核心詞,1568,485,2053,ㄅㄧㄥˋ,bìng
1965,冰涼,4.5,核心詞,6,3,9,ㄅㄧㄥ ㄌㄧㄤˊ,bīng liáng
1966,病情,4.5,7.身體、醫療,23,20,43,ㄅㄧㄥˋ ㄑㄧㄥˊ,bìng qíng
1967,脖子/脖,4.5,7.身體、醫療,50,9,59,ㄅㄛˊ ˙ㄗ/ㄅㄛˊ,bó zi/bó
1968,布,4.5,2.日常起居,39,52,91,ㄅㄨˋ,bù
1969,不安,4.5,核心詞,94,22,116,ㄅㄨˋ ㄢ,bù ān
1970,不當,4.5,核心詞,24,11,35,ㄅㄨˊ ㄉㄤˋ,bú dàng
1971,不見得,4.5,核心詞,33,30,63,ㄅㄨˊ ㄐㄧㄢˋ ˙ㄉㄜ,bú jiàn de
1972,部門,4.5,3.職業,78,22,100,ㄅㄨˋ ㄇㄣˊ,bù mén
1973,不免,4.5,核心詞,30,5,35,ㄅㄨˋ ㄇㄧㄢˇ,bù miǎn
1974,不幸,4.5,12.安全,75,30,105,ㄅㄨˊ ㄒㄧㄥˋ,bú xìng
1975,不足,4.5,核心詞,76,51,127,ㄅㄨˋ ㄗㄨˊ,bù zú
1976,採,4.5,核心詞,36,130,166,ㄘㄞˇ,cǎi
1977,採用,4.5,核心詞,72,30,102,ㄘㄞˇ ㄩㄥˋ,cǎi yòng
1978,餐點,4.5,10.餐飲、烹飪,6,8,14,ㄘㄢ ㄉㄧㄢˇ,cān diǎn
1979,參考,4.5,核心詞,57,34,91,ㄘㄢ ㄎㄠˇ,cān kǎo
1980,藏,4.5,核心詞,70,74,144,ㄘㄤˊ,cáng
1981,操場,4.5,8.教育、學習,7,12,19,ㄘㄠ ㄔㄤˇ,cāo chǎng
1982,草地,4.5,2.日常起居,21,10,31,ㄘㄠˇ ㄉㄧˋ,cǎo dì
1983,測驗,4.5,8.教育、學習,54,11,65,ㄘㄜˋ ㄧㄢˋ,cè yàn
1984,差別,4.5,核心詞,42,43,85,ㄔㄚ ㄅㄧㄝˊ,chā bié
1985,差異,4.5,核心詞,87,35,122,ㄔㄚ ㄧˋ,chā yì
1986,產生,4.5,核心詞,313,284,597,ㄔㄢˇ ㄕㄥ,chǎn shēng
1987,長短,4.5,核心詞,9,4,13,ㄔㄤˊ ㄉㄨㄢˇ,cháng duǎn
1988,嘗試,4.5,核心詞,79,60,139,ㄔㄤˊ ㄕˋ,cháng shì
1989,常識,4.5,8.教育、學習,16,7,23,ㄔㄤˊ ㄕˋ,cháng shì
1990,成,4.5,核心詞,287,219,506,ㄔㄥˊ,chéng
1991,成果,4.5,8.教育、學習,60,52,112,ㄔㄥˊ ㄍㄨㄛˇ,chéng guǒ
1992,成就,4.5,8.教育、學習,103,49,152,ㄔㄥˊ ㄐㄧㄡˋ,chéng jiù
1993,乘客,4.5,5.交通、旅遊,18,14,32,ㄔㄥˊ ㄎㄜˋ,chéng kè
1994,成立,4.5,8.教育、學習,104,132,236,ㄔㄥˊ ㄌㄧˋ,chéng lì
1995,成年,4.5,1.個人資料,24,13,37,ㄔㄥˊ ㄋㄧㄢˊ,chéng nián
1996,成人,4.5,7.身體、醫療,70,11,81,ㄔㄥˊ ㄖㄣˊ,chéng rén
1997,承認,4.5,核心詞,102,21,123,ㄔㄥˊ ㄖㄣˋ,chéng rèn
1998,稱為,4.5,核心詞,125,81,206,ㄔㄥ ㄨㄟˊ,chēng wéi
1999,尺,4.5,9.購物、商店,31,14,45,ㄔˇ,chǐ
2000,持續,4.5,核心詞,127,150,277,ㄔˊ ㄒㄩˋ,chí xù
2001,重2,4.5,核心詞,115,151,266,ㄔㄨㄥˊ,chóng
2002,衝1,4.5,核心詞,32,19,51,ㄔㄨㄥ,chōng
2003,充滿,4.5,16.情緒、態度,176,111,287,ㄔㄨㄥ ㄇㄢˇ,chōng mǎn
2004,衝突,4.5,核心詞,95,109,204,ㄔㄨㄥ ㄊㄨˊ,chōng tú
2005,處1,4.5,核心詞,288,106,394,ㄔㄨˋ,chù
2006,出版,4.5,8.教育、學習,153,27,180,ㄔㄨ ㄅㄢˇ,chū bǎn
2007,出產,4.5,10.餐飲、烹飪,4,7,11,ㄔㄨ ㄔㄢˇ,chū chǎn
2008,除非,4.5,核心詞,65,17,82,ㄔㄨˊ ㄈㄟ,chú fēi
2009,處理,4.5,核心詞,241,199,440,ㄔㄨˇ ㄌㄧˇ,chǔ lǐ
2010,初一,4.5,15.文化,5,3,8,ㄔㄨ ㄧ,chū yī
2011,出院,4.5,7.身體、醫療,8,5,13,ㄔㄨ ㄩㄢˋ,chū yuàn
2012,初中,4.5,1.個人資料,6,7,13,ㄔㄨ ㄓㄨㄥ,chū zhōng
2013,傳來,4.5,核心詞,58,12,70,ㄔㄨㄢˊ ㄌㄞˊ,chuán lái
2014,傳說,4.5,15.文化,70,34,104,ㄔㄨㄢˊ ㄕㄨㄛ,chuán shuō
2015,傳真,4.5,3.職業,5,2,7,ㄔㄨㄢˊ ㄓㄣ,chuán zhēn
2016,窗口,4.5,11.公共服務,15,2,17,ㄔㄨㄤ ㄎㄡˇ,chuāng kǒu
2017,創新,4.5,3.職業,132,13,145,ㄔㄨㄤˋ ㄒㄧㄣ,chuàng xīn
2018,創意,4.5,3.職業,89,105,194,ㄔㄨㄤˋ ㄧˋ,chuàng yì
2019,創造,4.5,核心詞,136,61,197,ㄔㄨㄤˋ ㄗㄠˋ,chuàng zào
2020,春聯,4.5,15.文化,1,8,9,ㄔㄨㄣ ㄌㄧㄢˊ,chūn lián
2021,刺激,4.5,核心詞,107,50,157,ㄘˋ ㄐㄧ,cì jī
2022,從此,4.5,核心詞,101,43,144,ㄘㄨㄥˊ ㄘˇ,cóng cǐ
2023,從事,4.5,3.職業,85,84,169,ㄘㄨㄥˊ ㄕˋ,cóng shì
2024,存檔,4.5,17.科技,2,1,3,ㄘㄨㄣˊ ㄉㄤˇ,cún dǎng
2025,打扮,4.5,2.日常起居,21,9,30,ㄉㄚˇ ㄅㄢˋ,dǎ bàn
2026,打包,4.5,核心詞,6,10,16,ㄉㄚˇ ㄅㄠ,dǎ bāo
2027,達到,4.5,5.交通、旅遊,136,138,274,ㄉㄚˊ ㄉㄠˋ,dá dào
2028,大方,4.5,6.社交、人際,14,9,23,ㄉㄚˋ ㄈㄤ,dà fāng
2029,打架,4.5,核心詞,17,10,27,ㄉㄚˇ ㄐㄧㄚˋ,dǎ jià
2030,大量,4.5,3.職業,101,151,252,ㄉㄚˋ ㄌㄧㄤˋ,dà liàng
2031,大名,4.5,6.社交、人際,20,1,21,ㄉㄚˋ ㄇㄧㄥˊ,dà míng
2032,打噴嚏,4.5,7.身體、醫療,3,3,6,ㄉㄚˇ ㄆㄣ ㄊㄧˋ,dǎ pēn tì
2033,打聽,4.5,核心詞,19,4,23,ㄉㄚˇ ㄊㄧㄥ,dǎ tīng
2034,大約,4.5,核心詞,116,139,255,ㄉㄚˋ ㄩㄝ,dà yuē
2035,打字,4.5,核心詞,11,5,16,ㄉㄚˇ ㄗˋ,dǎ zì
2036,待會兒,4.5,核心詞,6,7,13,ㄉㄞˋ ㄏㄨㄟˇㄦ,dài huǐr
2037,代名詞,4.5,8.教育、學習,5,3,8,ㄉㄞˋ ㄇㄧㄥˊ ㄘˊ,dài míng cí
2038,單純,4.5,核心詞,55,52,107,ㄉㄢ ㄔㄨㄣˊ,dān chún
2039,當初,4.5,核心詞,54,138,192,ㄉㄤ ㄔㄨ,dāng chū
2040,當地,4.5,5.交通、旅遊,86,255,341,ㄉㄤ ㄉㄧˋ,dāng dì
2041,當年,4.5,核心詞,102,74,176,ㄉㄤ ㄋㄧㄢˊ,dāng nián
2042,當天,4.5,核心詞,48,32,80,ㄉㄤˋ ㄊㄧㄢ,dàng tiān
2043,到達,4.5,5.交通、旅遊,61,43,104,ㄉㄠˋ ㄉㄚˊ,dào dá
2044,道德,4.5,8.教育、學習,74,15,89,ㄉㄠˋ ㄉㄜˊ,dào dé
2045,到底,4.5,核心詞,156,415,571,ㄉㄠˋ ㄉㄧˇ,dào dǐ
2046,道理,4.5,核心詞,100,76,176,ㄉㄠˋ ㄌㄧˇ,dào lǐ
2047,道路,4.5,5.交通、旅遊,52,69,121,ㄉㄠˋ ㄌㄨˋ,dào lù
2048,倒是,4.5,核心詞,53,25,78,ㄉㄠˋ ㄕˋ,dào shì
2049,等待,4.5,核心詞,80,48,128,ㄉㄥˇ ㄉㄞˋ,děng dài
2050,地板,4.5,2.日常起居,48,19,67,ㄉㄧˋ ㄅㄢˇ,dì bǎn
2051,地理,4.5,8.教育、學習,27,48,75,ㄉㄧˋ ㄌㄧˇ,dì lǐ
2052,弟妹,4.5,核心詞,6,2,8,ㄉㄧˋ ㄇㄟˋ,dì mèi
2053,的確,4.5,核心詞,133,74,207,ㄉㄧˊ ㄑㄩㄝˋ,dí què
2054,地下室,4.5,2.日常起居,13,5,18,ㄉㄧˋ ㄒㄧㄚˋ ㄕˋ,dì xià shì
2055,電器,4.5,2.日常起居,16,15,31,ㄉㄧㄢˋ ㄑㄧˋ,diàn qì
2056,電視劇,4.5,4.休閒、娛樂,6,2,8,ㄉㄧㄢˋ ㄕˋ ㄐㄩˋ,diàn shì jù
2057,電視台/電視臺,4.5,4.休閒、娛樂,13,28,41,ㄉㄧㄢˋ ㄕˋ ㄊㄞˊ,diàn shì tái
2058,點頭,4.5,核心詞,55,4,59,ㄉㄧㄢˇ ㄊㄡˊ,diǎn tóu
2059,典型,4.5,核心詞,52,22,74,ㄉㄧㄢˇ ㄒㄧㄥˊ,diǎn xíng
2060,調查,4.5,8.教育、學習,99,164,263,ㄉㄧㄠˋ ㄔㄚˊ,diào chá
2061,釣魚,4.5,4.休閒、娛樂,13,7,20,ㄉㄧㄠˋ ㄩˊ,diào yú
2062,訂購,4.5,9.購物、商店,6,5,11,ㄉㄧㄥˋ ㄍㄡˋ,dìng gòu
2063,訂婚,4.5,6.社交、人際,9,3,12,ㄉㄧㄥˋ ㄏㄨㄣ,dìng hūn
2064,毒,4.5,12.安全,41,79,120,ㄉㄨˊ,dú
2065,度過/渡過,4.5,5.交通、旅遊,49,42,91,ㄉㄨˋ ㄍㄨㄛˋ ,dù guò 
2066,度假,4.5,5.交通、旅遊,18,11,29,ㄉㄨˋ ㄐㄧㄚˋ,dù jià
2067,讀者,4.5,8.教育、學習,145,23,168,ㄉㄨˊ ㄓㄜˇ,dú zhě
2068,端,4.5,核心詞,61,42,103,ㄉㄨㄢ,duān
2069,對待,4.5,核心詞,49,37,86,ㄉㄨㄟˋ ㄉㄞˋ,duì dài
2070,對手,4.5,4.休閒、娛樂,55,11,66,ㄉㄨㄟˋ ㄕㄡˇ,duì shǒu
2071,發表,4.5,8.教育、學習,92,39,131,ㄈㄚ ㄅㄧㄠˇ,fā biǎo
2072,發財,4.5,核心詞,7,5,12,ㄈㄚ ㄘㄞˊ,fā cái
2073,發出,4.5,2.日常起居,115,30,145,ㄈㄚ ㄔㄨ,fā chū
2074,髮型,4.5,2.日常起居,8,3,11,ㄈㄚˇ ㄒㄧㄥˊ,fǎ xíng
2075,發炎,4.5,7.身體、醫療,18,19,37,ㄈㄚ ㄧㄢˊ,fā yán
2076,犯,4.5,12.安全,58,20,78,ㄈㄢˋ,fàn
2077,反,4.5,14.社會,107,94,201,ㄈㄢˇ,fǎn
2078,範圍,4.5,8.教育、學習,83,90,173,ㄈㄢˋ ㄨㄟˊ,fàn wéi
2079,反正,4.5,核心詞,51,81,132,ㄈㄢˇ ㄓㄥˋ,fǎn zhèng
2080,犯罪,4.5,12.安全,47,14,61,ㄈㄢˋ ㄗㄨㄟˋ,fàn zuì
2081,方式,4.5,8.教育、學習,495,470,965,ㄈㄤ ㄕˋ,fāng shì
2082,放鬆,4.5,核心詞,56,34,90,ㄈㄤˋ ㄙㄨㄥ,fàng sōng
2083,方形,4.5,核心詞,4,2,6,ㄈㄤ ㄒㄧㄥˊ,fāng xíng
2084,放學,4.5,8.教育、學習,13,29,42,ㄈㄤˋ ㄒㄩㄝˊ,fàng xué
2085,費,4.5,核心詞,23,12,35,ㄈㄟˋ,fèi
2086,肥胖,4.5,7.身體、醫療,12,27,39,ㄈㄟˊ ㄆㄤˋ,féi pàng
2087,粉,4.5,10.餐飲、烹飪,11,53,64,ㄈㄣˇ,fěn
2088,分別,4.5,核心詞,79,44,123,ㄈㄣ ㄅㄧㄝˊ,fēn bié
2089,粉紅,4.5,核心詞,9,3,12,ㄈㄣˇ ㄏㄨㄥˊ,fěn hóng
2090,分手,4.5,6.社交、人際,19,1,20,ㄈㄣ ㄕㄡˇ,fēn shǒu
2091,瘋,4.5,核心詞,29,7,36,ㄈㄥ,fēng
2092,否則,4.5,核心詞,102,32,134,ㄈㄡˇ ㄗㄜˊ,fǒu zé
2093,幅,4.5,核心詞,57,39,96,ㄈㄨˊ,fú
2094,付出,4.5,核心詞,54,121,175,ㄈㄨˋ ㄔㄨ,fù chū
2095,夫婦,4.5,1.個人資料,58,22,80,ㄈㄨ ㄈㄨˋ,fū fù
2096,負責,4.5,3.職業,143,95,238,ㄈㄨˋ ㄗㄜˊ,fù zé
2097,服裝,4.5,9.購物、商店,26,16,42,ㄈㄨˊ ㄓㄨㄤ,fú zhuāng
2098,該,4.5,核心詞,563,206,769,ㄍㄞ,gāi
2099,改善,4.5,2.日常起居,104,105,209,ㄍㄞˇ ㄕㄢˋ,gǎi shàn
2100,趕,4.5,核心詞,31,23,54,ㄍㄢˇ,gǎn
2101,趕緊,4.5,核心詞,46,31,77,ㄍㄢˇ ㄐㄧㄣˇ,gǎn jǐn
2102,高大,4.5,核心詞,24,6,30,ㄍㄠ ㄉㄚˋ,gāo dà
2103,高速,4.5,5.交通、旅遊,22,25,47,ㄍㄠ ㄙㄨˋ,gāo sù
2104,隔壁,4.5,2.日常起居,24,23,47,ㄍㄜˊ ㄅㄧˋ,gé bì
2105,歌唱,4.5,4.休閒、娛樂,14,10,24,ㄍㄜ ㄔㄤˋ,gē chàng
2106,歌詞,4.5,核心詞,11,17,28,ㄍㄜ ㄘˊ,gē cí
2107,格子,4.5,2.日常起居,6,2,8,ㄍㄜˊ ˙ㄗ,gé zi
2108,個子,4.5,7.身體、醫療,22,5,27,ㄍㄜˋ ˙ㄗ,gè zi
2109,各自,4.5,核心詞,56,25,81,ㄍㄜˋ ㄗˋ,gè zì
2110,根本,4.5,核心詞,262,167,429,ㄍㄣ ㄅㄣˇ,gēn běn
2111,根據/據,4.5,核心詞,260,230,490,ㄍㄣ ㄐㄩˋ/ㄐㄩˋ,gēn jù/jù
2112,工程師,4.5,3.職業,32,16,48,ㄍㄨㄥ ㄔㄥˊ ㄕ,gōng chéng shī
2113,功夫,4.5,15.文化,33,16,49,ㄍㄨㄥ ㄈㄨ,gōng fū
2114,公開,4.5,8.教育、學習,67,27,94,ㄍㄨㄥ ㄎㄞ,gōng kāi
2115,購物,4.5,9.購物、商店,21,17,38,ㄍㄡˋ ㄨˋ,gòu wù
2116,古代,4.5,8.教育、學習,45,35,80,ㄍㄨˇ ㄉㄞˋ,gǔ dài
2117,固定,4.5,核心詞,58,75,133,ㄍㄨˋ ㄉㄧㄥˋ,gù dìng
2118,故鄉,4.5,1.個人資料,26,32,58,ㄍㄨˋ ㄒㄧㄤ,gù xiāng
2119,颳,4.5,核心詞,6,2,8,ㄍㄨㄚ,guā
2120,掛號,4.5,7.身體、醫療,2,2,4,ㄍㄨㄚˋ ㄏㄠˋ,guà hào
2121,怪不得,4.5,核心詞,4,4,8,ㄍㄨㄞˋ ㄅㄨˋ ˙ㄉㄜ,guài bù de
2122,管理,4.5,3.職業,235,115,350,ㄍㄨㄢˇ ㄌㄧˇ,guǎn lǐ
2123,關於,4.5,核心詞,162,40,202,ㄍㄨㄢ ㄩˊ,guān yú
2124,官員,4.5,14.社會,112,27,139,ㄍㄨㄢ ㄩㄢˊ,guān yuán
2125,光線,4.5,2.日常起居,33,21,54,ㄍㄨㄤ ㄒㄧㄢˋ,guāng xiàn
2126,鬼,4.5,15.文化,71,18,89,ㄍㄨㄟˇ,guǐ
2127,規模,4.5,3.職業,58,78,136,ㄍㄨㄟ ㄇㄛˊ,guī mó
2128,過分/過份,4.5,核心詞,33,11,44,ㄍㄨㄛˋ ㄈㄣˋ,guò fèn
2129,過敏,4.5,7.身體、醫療,15,41,56,ㄍㄨㄛˋ ㄇㄧㄣˇ,guò mǐn
2130,果然,4.5,核心詞,77,23,100,ㄍㄨㄛˇ ㄖㄢˊ,guǒ rán
2131,過夜,4.5,核心詞,13,1,14,ㄍㄨㄛˋ ㄧㄝˋ,guò yè
2132,國語,4.5,8.教育、學習,11,18,29,ㄍㄨㄛˊ ㄩˇ,guó yǔ
2133,哈欠,4.5,7.身體、醫療,4,3,7,ㄏㄚ ㄑㄧㄢˋ,hā qiàn
2134,海報,4.5,9.購物、商店,9,9,18,ㄏㄞˇ ㄅㄠˋ,hǎi bào
2135,海灘,4.5,4.休閒、娛樂,13,11,24,ㄏㄞˇ ㄊㄢ,hǎi tān
2136,汗水,4.5,7.身體、醫療,10,11,21,ㄏㄢˋ ㄕㄨㄟˇ,hàn shuǐ
2137,好動,4.5,1.個人資料,6,5,11,ㄏㄠˋ ㄉㄨㄥˋ,hào dòng
2138,好學,4.5,8.教育、學習,5,2,7,ㄏㄠˋ ㄒㄩㄝˊ,hào xué
2139,好運,4.5,核心詞,10,3,13,ㄏㄠˇ ㄩㄣˋ,hǎo yùn
2140,合理,4.5,核心詞,62,17,79,ㄏㄜˊ ㄌㄧˇ,hé lǐ
2141,合約,4.5,2.日常起居,17,6,23,ㄏㄜˊ ㄩㄝ,hé yuē
2142,喝醉,4.5,7.身體、醫療,8,1,9,ㄏㄜ ㄗㄨㄟˋ,hē zuì
2143,黑暗,4.5,13.自然環境,60,22,82,ㄏㄟ ㄢˋ,hēi àn
2144,恨,4.5,核心詞,56,14,70,ㄏㄣˋ,hèn
2145,後果,4.5,核心詞,51,23,74,ㄏㄡˋ ㄍㄨㄛˇ,hòu guǒ
2146,湖,4.5,5.交通、旅遊,40,33,73,ㄏㄨˊ,hú
2147,互動,4.5,核心詞,85,102,187,ㄏㄨˋ ㄉㄨㄥˋ,hù dòng
2148,忽略,4.5,核心詞,55,22,77,ㄏㄨ ㄌㄩㄝˋ,hū lüè
2149,戶外,4.5,4.休閒、娛樂,18,32,50,ㄏㄨˋ ㄨㄞˋ,hù wài
2150,鬍子/鬍,4.5,7.身體、醫療,30,5,35,ㄏㄨˊ ˙ㄗ/ㄏㄨˊ,hú zi/hú
2151,花費,4.5,核心詞,22,18,40,ㄏㄨㄚ ㄈㄟˋ,huā fèi
2152,畫面,4.5,4.休閒、娛樂,41,83,124,ㄏㄨㄚˋ ㄇㄧㄢˋ,huà miàn
2153,花生,4.5,10.餐飲、烹飪,9,21,30,ㄏㄨㄚ ㄕㄥ,huā shēng
2154,懷疑,4.5,核心詞,122,36,158,ㄏㄨㄞˊ ㄧˊ,huái yí
2155,回頭,4.5,核心詞,58,22,80,ㄏㄨㄟˊ ㄊㄡˊ,huí tóu
2156,回想,4.5,核心詞,33,16,49,ㄏㄨㄟˊ ㄒㄧㄤˇ,huí xiǎng
2157,婚姻,4.5,1.個人資料,104,33,137,ㄏㄨㄣ ㄧㄣ,hūn yīn
2158,貨,4.5,9.購物、商店,25,23,48,ㄏㄨㄛˋ,huò
2159,活力,4.5,1.個人資料,47,21,68,ㄏㄨㄛˊ ㄌㄧˋ,huó lì
2160,基礎,4.5,3.職業,139,66,205,ㄐㄧ ㄔㄨˇ,jī chǔ
2161,及格,4.5,8.教育、學習,7,6,13,ㄐㄧˊ ㄍㄜˊ,jí gé
2162,積極,4.5,1.個人資料,91,84,175,ㄐㄧ ㄐㄧˊ,jī jí
2163,急忙,4.5,核心詞,40,1,41,ㄐㄧˊ ㄇㄤˊ,jí máng
2164,技巧,4.5,8.教育、學習,84,26,110,ㄐㄧˋ ㄑㄧㄠˇ,jì qiǎo
2165,既然,4.5,核心詞,107,81,188,ㄐㄧˋ ㄖㄢˊ,jì rán
2166,即使,4.5,核心詞,265,101,366,ㄐㄧˊ ㄕˇ,jí shǐ
2167,吉他,4.5,4.休閒、娛樂,10,2,12,ㄐㄧˊ ㄊㄚ,jí tā
2168,記憶,4.5,15.文化,169,93,262,ㄐㄧˋ ㄧˋ,jì yì
2169,急診,4.5,7.身體、醫療,4,8,12,ㄐㄧˊ ㄓㄣˇ,jí zhěn
2170,集中,4.5,核心詞,67,43,110,ㄐㄧˊ ㄓㄨㄥ,jí zhōng
2171,嫁,4.5,1.個人資料,29,25,54,ㄐㄧㄚˋ,jià
2172,家電,4.5,2.日常起居,8,5,13,ㄐㄧㄚ ㄉㄧㄢˋ,jiā diàn
2173,家教,4.5,3.職業,9,6,15,ㄐㄧㄚ ㄐㄧㄠˋ,jiā jiào
2174,加強,4.5,核心詞,44,46,90,ㄐㄧㄚ ㄑㄧㄤˊ,jiā qiáng
2175,假如,4.5,核心詞,123,89,212,ㄐㄧㄚˇ ㄖㄨˊ,jiǎ rú
2176,價值,4.5,9.購物、商店,190,137,327,ㄐㄧㄚˋ ㄓˊ,jià zhí
2177,假裝,4.5,核心詞,36,8,44,ㄐㄧㄚˇ ㄓㄨㄤ,jiǎ zhuāng
2178,煎,4.5,10.餐飲、烹飪,13,16,29,ㄐㄧㄢ,jiān
2179,尖,4.5,核心詞,19,10,29,ㄐㄧㄢ,jiān
2180,減肥,4.5,7.身體、醫療,11,10,21,ㄐㄧㄢˇ ㄈㄟˊ,jiǎn féi
2181,漸漸/漸,4.5,核心詞,119,57,176,ㄐㄧㄢˋ ㄐㄧㄢˋ/ㄐㄧㄢˋ,jiàn jiàn/jiàn
2182,簡直,4.5,核心詞,92,16,108,ㄐㄧㄢˇ ㄓˊ,jiǎn zhí
2183,建築,4.5,2.日常起居,74,128,202,ㄐㄧㄢˋ ㄓㄨˊ,jiàn zhú
2184,江,4.5,核心詞,65,30,95,ㄐㄧㄤ,jiāng
2185,降低,4.5,核心詞,64,101,165,ㄐㄧㄤˋ ㄉㄧ,jiàng dī
2186,將近,4.5,核心詞,33,126,159,ㄐㄧㄤ ㄐㄧㄣˋ,jiāng jìn
2187,腳步,4.5,核心詞,48,50,98,ㄐㄧㄠˇ ㄅㄨˋ,jiǎo bù
2188,膠帶,4.5,9.購物、商店,6,17,23,ㄐㄧㄠ ㄉㄞˋ,jiāo dài
2189,交流,4.5,6.社交、人際,33,43,76,ㄐㄧㄠ ㄌㄧㄡˊ,jiāo liú
2190,郊外,4.5,2.日常起居,7,4,11,ㄐㄧㄠ ㄨㄞˋ,jiāo wài
2191,叫醒,4.5,2.日常起居,7,3,10,ㄐㄧㄠˋ ㄒㄧㄥˇ,jiào xǐng
2192,接觸,4.5,6.社交、人際,88,124,212,ㄐㄧㄝ ㄔㄨˋ,jiē chù
2193,街道,4.5,5.交通、旅遊,25,18,43,ㄐㄧㄝ ㄉㄠˋ,jiē dào
2194,階段,4.5,核心詞,131,87,218,ㄐㄧㄝ ㄉㄨㄢˋ,jiē duàn
2195,結合,4.5,核心詞,78,102,180,ㄐㄧㄝˊ ㄏㄜˊ,jié hé
2196,接近,4.5,核心詞,88,65,153,ㄐㄧㄝ ㄐㄧㄣˋ,jiē jìn
2197,結論,4.5,8.教育、學習,58,13,71,ㄐㄧㄝˊ ㄌㄨㄣˋ,jié lùn
2198,節慶,4.5,6.社交、人際,5,11,16,ㄐㄧㄝˊ ㄑㄧㄥˋ,jié qìng
2199,斤,4.5,核心詞,24,59,83,ㄐㄧㄣ,jīn
2200,今後,4.5,核心詞,23,4,27,ㄐㄧㄣ ㄏㄡˋ,jīn hòu
2201,金錢,4.5,9.購物、商店,49,29,78,ㄐㄧㄣ ㄑㄧㄢˊ,jīn qián
2202,今日,4.5,核心詞,81,20,101,ㄐㄧㄣ ㄖˋ,jīn rì
2203,進一步,4.5,核心詞,83,49,132,ㄐㄧㄣˋ ㄧˊ ㄅㄨˋ,jìn yí bù
2204,靜,4.5,核心詞,28,25,53,ㄐㄧㄥˋ,jìng
2205,經理,4.5,3.職業,47,9,56,ㄐㄧㄥ ㄌㄧˇ,jīng lǐ
2206,竟然/竟,4.5,核心詞,284,129,413,ㄐㄧㄥˋ ㄖㄢˊ/ㄐㄧㄥˋ,jìng rán/jìng
2207,景色,4.5,5.交通、旅遊,13,12,25,ㄐㄧㄥˇ ㄙㄜˋ,jǐng sè
2208,驚訝,4.5,16.情緒、態度,76,34,110,ㄐㄧㄥ ㄧㄚˋ,jīng yà
2209,酒吧,4.5,10.餐飲、烹飪,19,1,20,ㄐㄧㄡˇ ㄅㄚ,jiǔ bā
2210,救護車,4.5,7.身體、醫療,5,7,12,ㄐㄧㄡˋ ㄏㄨˋ ㄔㄜ,jiù hù chē
2211,舅舅/舅,4.5,1.個人資料,20,4,24,ㄐㄧㄡˋ ˙ㄐㄧㄡ/ㄐㄧㄡˋ,jiù jiu/jiù
2212,舅媽,4.5,1.個人資料,3,1,4,ㄐㄧㄡˋ ㄇㄚ,jiù mā
2213,就算,4.5,核心詞,108,88,196,ㄐㄧㄡˋ ㄙㄨㄢˋ,jiù suàn
2214,聚,4.5,6.社交、人際,26,27,53,ㄐㄩˋ,jù
2215,聚餐,4.5,6.社交、人際,3,4,7,ㄐㄩˋ ㄘㄢ,jù cān
2216,舉例,4.5,核心詞,26,10,36,ㄐㄩˇ ㄌㄧˋ,jǔ lì
2217,居民,4.5,5.交通、旅遊,50,143,193,ㄐㄩ ㄇㄧㄣˊ,jū mín
2218,居然,4.5,核心詞,64,43,107,ㄐㄩ ㄖㄢˊ,jū rán
2219,舉手,4.5,8.教育、學習,8,16,24,ㄐㄩˇ ㄕㄡˇ,jǔ shǒu
2220,據說,4.5,核心詞,67,16,83,ㄐㄩˋ ㄕㄨㄛ,jù shuō
2221,具體,4.5,核心詞,65,25,90,ㄐㄩˋ ㄊㄧˇ,jù tǐ
2222,絕對,4.5,核心詞,170,127,297,ㄐㄩㄝˊ ㄉㄨㄟˋ,jué duì
2223,角色,4.5,4.休閒、娛樂,201,100,301,ㄐㄩㄝˊ ㄙㄜˋ/ㄐㄧㄠˇ ㄙㄜˋ,jué sè /jiǎo sè
2224,決心,4.5,核心詞,57,39,96,ㄐㄩㄝˊ ㄒㄧㄣ,jué xīn
2225,軍隊,4.5,14.社會,82,28,110,ㄐㄩㄣ ㄉㄨㄟˋ,jūn duì
2226,卡車,4.5,5.交通、旅遊,23,14,37,ㄎㄚˇ ㄔㄜ,kǎ chē
2227,開動,4.5,10.餐飲、烹飪,4,6,10,ㄎㄞ ㄉㄨㄥˋ,kāi dòng
2228,開花,4.5,核心詞,13,29,42,ㄎㄞ ㄏㄨㄚ,kāi huā
2229,開水,4.5,10.餐飲、烹飪,8,7,15,ㄎㄞ ㄕㄨㄟˇ,kāi shuǐ
2230,砍,4.5,13.自然環境,33,38,71,ㄎㄢˇ,kǎn
2231,看不起,4.5,核心詞,9,5,14,ㄎㄢˋ  ㄅㄨˋ ㄑㄧˇ,kàn bù qǐ
2232,看得起,4.5,核心詞,2,1,3,ㄎㄢˋ ˙ㄉㄜ ㄑㄧˇ,kàn de qǐ
2233,看來,4.5,核心詞,88,44,132,ㄎㄢˋ ㄌㄞˊ,kàn lái
2234,可,4.5,核心詞,1109,380,1489,ㄎㄜˇ,kě
2235,客戶,4.5,9.購物、商店,86,30,116,ㄎㄜˋ ㄏㄨˋ,kè hù
2236,可靠,4.5,核心詞,28,4,32,ㄎㄜˇ ㄎㄠˋ,kě kào
2237,課堂,4.5,8.教育、學習,24,16,40,ㄎㄜˋ ㄊㄤˊ,kè táng
2238,科系,4.5,8.教育、學習,7,7,14,ㄎㄜ ㄒㄧˋ,kē xì
2239,可笑,4.5,核心詞,21,0,21,ㄎㄜˇ ㄒㄧㄠˋ,kě xiào
2240,客運,4.5,5.交通、旅遊,3,2,5,ㄎㄜˋ ㄩㄣˋ,kè yùn
2241,肯,4.5,核心詞,103,23,126,ㄎㄣˇ,kěn
2242,肯定,4.5,核心詞,134,69,203,ㄎㄣˇ ㄉㄧㄥˋ,kěn dìng
2243,空中,4.5,13.自然環境,36,28,64,ㄎㄨㄥ ㄓㄨㄥ,kōng zhōng
2244,口水,4.5,7.身體、醫療,15,6,21,ㄎㄡˇ ㄕㄨㄟˇ,kǒu shuǐ
2245,扣子,4.5,9.購物、商店,2,0,2,ㄎㄡˋ ˙ㄗ,kòu zi
2246,款式,4.5,核心詞,6,4,10,ㄎㄨㄢˇ ㄕˋ,kuǎn shì
2247,拉鍊,4.5,9.購物、商店,2,0,2,ㄌㄚ ㄌㄧㄢˋ,lā liàn
2248,來回,4.5,核心詞,21,15,36,ㄌㄞˊ ㄏㄨㄟˊ,lái huí
2249,來源,4.5,核心詞,59,71,130,ㄌㄞˊ ㄩㄢˊ,lái yuán
2250,懶得,4.5,核心詞,9,3,12,ㄌㄢˇ ˙ㄉㄜ,lǎn de
2251,浪漫,4.5,4.休閒、娛樂,31,29,60,ㄌㄤˋ ㄇㄢˋ,làng màn
2252,老年,4.5,14.社會,15,8,23,ㄌㄠˇ ㄋㄧㄢˊ,lǎo nián
2253,樂觀,4.5,核心詞,58,42,100,ㄌㄜˋ ㄍㄨㄢ,lè guān
2254,樂趣,4.5,核心詞,45,35,80,ㄌㄜˋ ㄑㄩˋ,lè qù
2255,類型,4.5,核心詞,68,17,85,ㄌㄟˋ ㄒㄧㄥˊ,lèi xíng
2256,冷門,4.5,9.購物、商店,2,0,2,ㄌㄥˇ ㄇㄣˊ,lěng mén
2257,理髮,4.5,2.日常起居,3,2,5,ㄌㄧˇ ㄈㄚˇ,lǐ fǎ
2258,離婚,4.5,1.個人資料,44,22,66,ㄌㄧˊ ㄏㄨㄣ,lí hūn
2259,力氣,4.5,7.身體、醫療,38,25,63,ㄌㄧˋ ㄑㄧˋ,lì qì
2260,例外,4.5,核心詞,34,5,39,ㄌㄧˋ ㄨㄞˋ,lì wài
2261,理想,4.5,1.個人資料,100,59,159,ㄌㄧˇ ㄒㄧㄤˇ,lǐ xiǎng
2262,戀愛,4.5,6.社交、人際,20,9,29,ㄌㄧㄢˋ ㄞˋ,liàn ài
2263,臉紅,4.5,16.情緒、態度,9,1,10,ㄌㄧㄢˇ ㄏㄨㄥˊ,liǎn hóng
2264,連續,4.5,核心詞,49,51,100,ㄌㄧㄢˊ ㄒㄩˋ,lián xù
2265,良好,4.5,核心詞,74,32,106,ㄌㄧㄤˊ ㄏㄠˇ,liáng hǎo
2266,了不起,4.5,6.社交、人際,31,25,56,ㄌㄧㄠˇ ㄅㄨˋ ㄑㄧˇ,liǎo bù qǐ
2267,林,4.5,核心詞,40,98,138,ㄌㄧㄣˊ,lín
2268,淋浴,4.5,2.日常起居,4,1,5,ㄌㄧㄣˊ ㄩˋ,lín yù
2269,零食,4.5,10.餐飲、烹飪,5,14,19,ㄌㄧㄥˊ ㄕˊ,líng shí
2270,留念,4.5,4.休閒、娛樂,2,2,4,ㄌㄧㄡˊ ㄋㄧㄢˋ,liú niàn
2271,露營,4.5,4.休閒、娛樂,5,3,8,ㄌㄨˋ ㄧㄥˊ,lù yíng
2272,論文,4.5,8.教育、學習,63,8,71,ㄌㄨㄣˋ ㄨㄣˊ,lùn wén
2273,麥,4.5,10.餐飲、烹飪,10,17,27,ㄇㄞˋ,mài
2274,買單,4.5,核心詞,2,1,3,ㄇㄞˇ ㄉㄢ,mǎi dān
2275,賣座,4.5,4.休閒、娛樂,2,0,2,ㄇㄞˋ ㄗㄨㄛˋ,mài zuò
2276,毛病,4.5,7.身體、醫療,37,9,46,ㄇㄠˊ ㄅㄧㄥˋ,máo bìng
2277,貿易,4.5,3.職業,47,35,82,ㄇㄠˋ ㄧˋ,mào yì
2278,美好,4.5,核心詞,68,46,114,ㄇㄟˇ ㄏㄠˇ,měi hǎo
2279,美容院,4.5,2.日常起居,2,2,4,ㄇㄟˇ ㄖㄨㄥˊ ㄩㄢˋ,měi róng yuàn
2280,美味,4.5,10.餐飲、烹飪,18,29,47,ㄇㄟˇ ㄨㄟˋ,měi wèi
2281,門市,4.5,9.購物、商店,3,2,5,ㄇㄣˊ ㄕˋ,mén shì
2282,米飯,4.5,10.餐飲、烹飪,6,10,16,ㄇㄧˇ ㄈㄢˋ,mǐ fàn
2283,米粉,4.5,10.餐飲、烹飪,3,5,8,ㄇㄧˇ ㄈㄣˇ,mǐ fěn
2284,迷人,4.5,核心詞,25,7,32,ㄇㄧˊ ㄖㄣˊ,mí rén
2285,面,4.5,核心詞,142,113,255,ㄇㄧㄢˋ,miàn
2286,面對,4.5,核心詞,264,238,502,ㄇㄧㄢˋ ㄉㄨㄟˋ,miàn duì
2287,麵粉,4.5,10.餐飲、烹飪,9,21,30,ㄇㄧㄢˋ ㄈㄣˇ,miàn fěn
2288,面談,4.5,3.職業,9,2,11,ㄇㄧㄢˋ ㄊㄢˊ,miàn tán
2289,秒鐘,4.5,核心詞,21,17,38,ㄇㄧㄠˇㄓㄨㄥ,miǎozhōng
2290,民間,4.5,14.社會,63,46,109,ㄇㄧㄣˊ ㄐㄧㄢ,mín jiān
2291,民宿,4.5,5.交通、旅遊,4,15,19,ㄇㄧㄣˊ ㄙㄨˋ,mín sù
2292,民眾,4.5,14.社會,59,327,386,ㄇㄧㄣˊ ㄓㄨㄥˋ,mín zhòng
2293,民族,4.5,8.教育、學習,99,69,168,ㄇㄧㄣˊ ㄗㄨˊ,mín zú
2294,名稱,4.5,核心詞,46,22,68,ㄇㄧㄥˊ ㄔㄥ,míng chēng
2295,名叫,4.5,1.個人資料,48,6,54,ㄇㄧㄥˊ ㄐㄧㄠˋ,míng jiào
2296,命令,4.5,核心詞,86,9,95,ㄇㄧㄥˋ ㄌㄧㄥˋ,mìng lìng
2297,名牌,4.5,9.購物、商店,9,8,17,ㄇㄧㄥˊ ㄆㄞˊ,míng pái
2298,明星,4.5,4.休閒、娛樂,30,17,47,ㄇㄧㄥˊ ㄒㄧㄥ,míng xīng
2299,命運,4.5,核心詞,70,44,114,ㄇㄧㄥˋ ㄩㄣˋ,mìng yùn
2300,末,4.5,核心詞,50,19,69,ㄇㄛˋ,mò
2301,木,4.5,核心詞,36,40,76,ㄇㄨˋ,mù
2302,目的地,4.5,5.交通、旅遊,13,12,25,ㄇㄨˋ ㄉㄧˋ ㄉㄧˋ,mù dì dì
2303,木頭,4.5,2.日常起居,23,37,60,ㄇㄨˋ ˙ㄊㄡ,mù tou
2304,拿手,4.5,核心詞,6,4,10,ㄋㄚˊ ㄕㄡˇ,ná shǒu
2305,耐心,4.5,3.職業,39,31,70,ㄋㄞˋ ㄒㄧㄣ,nài xīn
2306,難道,4.5,核心詞,90,45,135,ㄋㄢˊ ㄉㄠˋ,nán dào
2307,難得,4.5,核心詞,32,49,81,ㄋㄢˊ ㄉㄜˊ,nán dé
2308,難怪,4.5,核心詞,30,34,64,ㄋㄢˊ ㄍㄨㄞˋ,nán guài
2309,男士,4.5,核心詞,16,3,19,ㄋㄢˊ ㄕˋ,nán shì
2310,難忘,4.5,16.情緒、態度,15,11,26,ㄋㄢˊ ㄨㄤˋ,nán wàng
2311,男子,4.5,核心詞,52,12,64,ㄋㄢˊ ㄗˇ,nán zǐ
2312,腦袋,4.5,7.身體、醫療,48,16,64,ㄋㄠˇ ㄉㄞˋ,nǎo dài
2313,內褲,4.5,9.購物、商店,5,2,7,ㄋㄟˋㄎㄨˋ,nèi kù
2314,內心,4.5,核心詞,113,62,175,ㄋㄟˋ ㄒㄧㄣ,nèi xīn
2315,內衣,4.5,9.購物、商店,6,2,8,ㄋㄟˋ ㄧ,nèi yī
2316,膩,4.5,10.餐飲、烹飪,7,8,15,ㄋㄧˋ,nì
2317,年代,4.5,核心詞,50,83,133,ㄋㄧㄢˊ ㄉㄞˋ,nián dài
2318,年糕,4.5,10.餐飲、烹飪,2,6,8,ㄋㄧㄢˊ ㄍㄠ,nián gāo
2319,寧可,4.5,核心詞,23,6,29,ㄋㄧㄥˊ ㄎㄜˇ,níng kě
2320,檸檬,4.5,10.餐飲、烹飪,7,12,19,ㄋㄧㄥˊ ㄇㄥˊ,níng méng
2321,寧願,4.5,核心詞,18,10,28,ㄋㄧㄥˊ ㄩㄢˋ,níng yuàn
2322,弄錯,4.5,核心詞,7,2,9,ㄋㄨㄥˋ ㄘㄨㄛˋ,nòng cuò
2323,農藥,4.5,13.自然環境,4,162,166,ㄋㄨㄥˊ ㄧㄠˋ,nóng yào
2324,女士,4.5,核心詞,82,19,101,ㄋㄩˇ ㄕˋ,nǚ shì
2325,女子,4.5,核心詞,82,14,96,ㄋㄩˇ ㄗˇ,nǚ zǐ
2326,暖和,4.5,5.交通、旅遊,7,4,11,ㄋㄨㄢˇ ˙ㄏㄨㄛ,nuǎn huo
2327,偶爾/偶而,4.5,核心詞,73,38,111,ㄡˇ ㄦˇ/ㄡˇ ㄦˊ,ǒu ěr/ǒu ér
2328,排球,4.5,4.休閒、娛樂,2,1,3,ㄆㄞˊ ㄑㄧㄡˊ,pái qiú
2329,拍手,4.5,核心詞,7,7,14,ㄆㄞ ㄕㄡˇ,pāi shǒu
2330,配合,4.5,核心詞,66,73,139,ㄆㄟˋ ㄏㄜˊ,pèi hé
2331,碰面,4.5,6.社交、人際,12,4,16,ㄆㄥˋ ㄇㄧㄢˋ,pèng miàn
2332,匹1,4.5,核心詞,42,12,54,ㄆㄧ,pī
2333,皮帶,4.5,2.日常起居,8,6,14,ㄆㄧˊ ㄉㄞˋ,pí dài
2334,批評,4.5,核心詞,86,25,111,ㄆㄧ ㄆㄧㄥˊ,pī píng
2335,脾氣,4.5,1.個人資料,35,22,57,ㄆㄧˊ ㄑㄧˋ,pí qì
2336,騙人,4.5,12.安全,6,6,12,ㄆㄧㄢˋ ㄖㄣˊ,piàn rén
2337,騙子,4.5,12.安全,9,3,12,ㄆㄧㄢˋ ˙ㄗ,piàn zi
2338,品牌,4.5,9.購物、商店,104,29,133,ㄆㄧㄣˇ ㄆㄞˊ,pǐn pái
2339,平,4.5,核心詞,18,48,66,ㄆㄧㄥˊ,píng
2340,平靜,4.5,核心詞,53,30,83,ㄆㄧㄥˊ ㄐㄧㄥˋ,píng jìng
2341,乒乓球,4.5,4.休閒、娛樂,2,2,4,ㄆㄧㄥ ㄆㄤ ㄑㄧㄡˊ,pīng pāng qiú
2342,婆婆,4.5,1.個人資料,34,46,80,ㄆㄛˊ ˙ㄆㄛ,pó po
2343,期待,4.5,核心詞,92,110,202,ㄑㄧˊ ㄉㄞˋ,qí dài
2344,氣氛,4.5,核心詞,61,48,109,ㄑㄧˋ ㄈㄣ,qì fēn
2345,氣功,4.5,15.文化,6,3,9,ㄑㄧˋ ㄍㄨㄥ,qì gōng
2346,期間,4.5,核心詞,110,72,182,ㄑㄧˊ ㄐㄧㄢ,qí jiān
2347,期望,4.5,核心詞,51,36,87,ㄑㄧˊ ㄨㄤˋ,qí wàng
2348,氣象,4.5,5.交通、旅遊,10,63,73,ㄑㄧˋ ㄒㄧㄤˋ,qì xiàng
2349,企業,4.5,3.職業,310,61,371,ㄑㄧˋ ㄧㄝˋ,qì yè
2350,旗子,4.5,2.日常起居,3,5,8,ㄑㄧˊ ˙ㄗ,qí zi
2351,妻子/妻,4.5,1.個人資料,196,29,225,ㄑㄧ ˙ㄗ / ㄑㄧ,qī zi / qī
2352,前進,4.5,核心詞,62,32,94,ㄑㄧㄢˊ ㄐㄧㄣˋ,qián jìn
2353,千萬,4.5,核心詞,59,48,107,ㄑㄧㄢ ㄨㄢˋ,qiān wàn
2354,強大,4.5,核心詞,52,24,76,ㄑㄧㄤˊ ㄉㄚˋ,qiáng dà
2355,敲,4.5,核心詞,34,18,52,ㄑㄧㄠ,qiāo
2356,親愛,4.5,核心詞,44,11,55,ㄑㄧㄣ ㄞˋ,qīn ài
2357,親密,4.5,6.社交、人際,46,10,56,ㄑㄧㄣ ㄇㄧˋ,qīn mì
2358,親人,4.5,1.個人資料,23,34,57,ㄑㄧㄣ ㄖㄣˊ,qīn rén
2359,清,4.5,核心詞,114,56,170,ㄑㄧㄥ,qīng
2360,請教,4.5,核心詞,23,70,93,ㄑㄧㄥˇ ㄐㄧㄠˋ,qǐng jiào
2361,青年,4.5,14.社會,77,68,145,ㄑㄧㄥ ㄋㄧㄢˊ,qīng nián
2362,清早,4.5,核心詞,5,2,7,ㄑㄧㄥ ㄗㄠˇ,qīng zǎo
2363,求,4.5,核心詞,110,79,189,ㄑㄧㄡˊ,qiú
2364,取,4.5,核心詞,84,68,152,ㄑㄩˇ,qǔ
2365,區域,4.5,2.日常起居,57,96,153,ㄑㄩ ㄩˋ,qū yù
2366,勸,4.5,核心詞,45,13,58,ㄑㄩㄢˋ,quàn
2367,缺點,4.5,核心詞,40,19,59,ㄑㄩㄝ ㄉㄧㄢˇ,quē diǎn
2368,熱量,4.5,10.餐飲、烹飪,11,31,42,ㄖㄜˋ ㄌㄧㄤˋ,rè liàng
2369,忍,4.5,核心詞,25,21,46,ㄖㄣˇ,rěn
2370,認得,4.5,核心詞,20,7,27,ㄖㄣˋ ˙ㄉㄜ,rèn de
2371,任何,4.5,核心詞,510,214,724,ㄖㄣˋ ㄏㄜˊ,rèn hé
2372,人家1,4.5,2.日常起居,110,436,546,ㄖㄣˊ ㄐㄧㄚ,rén jiā
2373,人類,4.5,核心詞,292,279,571,ㄖㄣˊ ㄌㄟˋ,rén lèi
2374,人們,4.5,核心詞,311,70,381,ㄖㄣˊ ˙ㄇㄣ,rén men
2375,人民,4.5,1.個人資料,114,126,240,ㄖㄣˊ ㄇㄧㄣˊ,rén mín
2376,人生,4.5,核心詞,261,271,532,ㄖㄣˊ ㄕㄥ,rén shēng
2377,任務,4.5,核心詞,90,92,182,ㄖㄣˋ ㄨˋ,rèn wù
2378,扔,4.5,核心詞,14,4,18,ㄖㄥ,rēng
2379,日常,4.5,核心詞,79,53,132,ㄖˋ ㄔㄤˊ,rì cháng
2380,日出,4.5,核心詞,7,7,14,ㄖˋ ㄔㄨ,rì chū
2381,肉類,4.5,10.餐飲、烹飪,5,8,13,ㄖㄡˋㄌㄟˋ,ròu lèi
2382,入,4.5,核心詞,106,119,225,ㄖㄨˋ,rù
2383,如今,4.5,核心詞,121,77,198,ㄖㄨˊ ㄐㄧㄣ,rú jīn
2384,入境,4.5,5.交通、旅遊,4,12,16,ㄖㄨˋ ㄐㄧㄥˋ,rù jìng
2385,弱,4.5,核心詞,39,29,68,ㄖㄨㄛˋ,ruò
2386,若是,4.5,核心詞,68,13,81,ㄖㄨㄛˋ ㄕˋ,ruò shì
2387,賽跑,4.5,4.休閒、娛樂,6,7,13,ㄙㄞˋ ㄆㄠˇ,sài pǎo
2388,三角形,4.5,核心詞,9,6,15,ㄙㄢ ㄐㄧㄠˇ ㄒㄧㄥˊ,sān jiǎo xíng
2389,掃把,4.5,2.日常起居,4,7,11,ㄙㄠˋ ㄅㄚˇ,sào bǎ
2390,嫂嫂,4.5,核心詞,7,2,9,ㄙㄠˇ ˙ㄙㄠ,sǎo sao
2391,色彩,4.5,核心詞,40,32,72,ㄙㄜˋ ㄘㄞˇ,sè cǎi
2392,沙,4.5,核心詞,25,53,78,ㄕㄚ,shā
2393,沙灘,4.5,4.休閒、娛樂,13,17,30,ㄕㄚ ㄊㄢ,shā tān
2394,沙子,4.5,13.自然環境,6,17,23,ㄕㄚ ˙ㄗ,shā zi
2395,上帝,4.5,15.文化,96,17,113,ㄕㄤˋ ㄉㄧˋ,shàng dì
2396,傷害,4.5,12.安全,99,93,192,ㄕㄤ ㄏㄞˋ,shāng hài
2397,上街,4.5,核心詞,5,8,13,ㄕㄤˋ ㄐㄧㄝ,shàng jiē
2398,傷心,4.5,核心詞,39,23,62,ㄕㄤ ㄒㄧㄣ,shāng xīn
2399,少年,4.5,1.個人資料,62,15,77,ㄕㄠˋ ㄋㄧㄢˊ,shào nián
2400,少女,4.5,1.個人資料,33,7,40,ㄕㄠˋ ㄋㄩˇ,shào nǚ
2401,設計,4.5,3.職業,269,206,475,ㄕㄜˋ ㄐㄧˋ,shè jì
2402,社區,4.5,8.教育、學習,122,243,365,ㄕㄜˋ ㄑㄩ,shè qū
2403,身,4.5,7.身體、醫療,456,280,736,ㄕㄣ,shēn
2404,伸,4.5,7.身體、醫療,22,7,29,ㄕㄣ,shēn
2405,身材,4.5,7.身體、醫療,33,10,43,ㄕㄣ ㄘㄞˊ,shēn cái
2406,身分/身份,4.5,3.職業,84,45,129,ㄕㄣ ㄈㄣˋ,shēn fèn
2407,深刻,4.5,核心詞,65,80,145,ㄕㄣ ㄎㄜˋ,shēn kè
2408,深夜,4.5,核心詞,19,6,25,ㄕㄣ ㄧㄝˋ,shēn yè
2409,甚至,4.5,核心詞,491,370,861,ㄕㄣˋ ㄓˋ,shèn zhì
2410,生產,4.5,3.職業,125,164,289,ㄕㄥ ㄔㄢˇ,shēng chǎn
2411,升級,4.5,3.職業,6,5,11,ㄕㄥ ㄐㄧˊ,shēng jí
2412,勝利,4.5,4.休閒、娛樂,60,10,70,ㄕㄥˋ ㄌㄧˋ,shèng lì
2413,生命,4.5,核心詞,381,370,751,ㄕㄥ ㄇㄧㄥˋ,shēng mìng
2414,生肖,4.5,核心詞,2,3,5,ㄕㄥ ㄒㄧㄠˋ,shēng xiào
2415,生長,4.5,13.自然環境,42,124,166,ㄕㄥ ㄓㄤˇ,shēng zhǎng
2416,時代,4.5,核心詞,275,151,426,ㄕˊ ㄉㄞˋ,shí dài
2417,適當,4.5,核心詞,77,35,112,ㄕˋ ㄉㄤˋ,shì dàng
2418,實際,4.5,8.教育、學習,190,197,387,ㄕˊ ㄐㄧˋ,shí jì
2419,失戀,4.5,6.社交、人際,5,2,7,ㄕ ㄌㄧㄢˋ,shī liàn
2420,室內,4.5,2.日常起居,0,0,0,ㄕˋ ㄋㄟˋ,shì nèi
2421,時期,4.5,核心詞,149,105,254,ㄕˊ ㄑㄧˊ,shí qí
2422,室外,4.5,2.日常起居,0,0,0,ㄕˋ ㄨㄞˋ,shì wài
2423,失望,4.5,16.情緒、態度,52,24,76,ㄕ ㄨㄤˋ,shī wàng
2424,實現,4.5,8.教育、學習,91,34,125,ㄕˊ ㄒㄧㄢˋ,shí xiàn
2425,事業,4.5,3.職業,130,64,194,ㄕˋ ㄧㄝˋ,shì yè
2426,適應,4.5,核心詞,70,56,126,ㄕˋ ㄧㄥˋ,shì yìng
2427,實用,4.5,核心詞,27,21,48,ㄕˊ ㄩㄥˋ,shí yòng
2428,首,4.5,核心詞,143,113,256,ㄕㄡˇ,shǒu
2429,受得了,4.5,核心詞,3,3,6,ㄕㄡˋ ˙ㄉㄜ ㄌㄧㄠˇ,shòu de liǎo
2430,收費,4.5,2.日常起居,6,6,12,ㄕㄡ ㄈㄟˋ,shōu fèi
2431,收集,4.5,8.教育、學習,25,66,91,ㄕㄡ ㄐㄧˊ,shōu jí
2432,受騙,4.5,12.安全,5,2,7,ㄕㄡˋ ㄆㄧㄢˋ,shòu piàn
2433,手術,4.5,7.身體、醫療,53,61,114,ㄕㄡˇ ㄕㄨˋ,shǒu shù
2434,熟悉,4.5,核心詞,77,53,130,ㄕㄡˊ ㄒㄧ,shóu xī
2435,叔父,4.5,1.個人資料,10,0,10,ㄕㄨˊ ㄈㄨˋ,shú fù
2436,數學,4.5,8.教育、學習,76,41,117,ㄕㄨˋ ㄒㄩㄝˊ,shù xué
2437,梳子,4.5,2.日常起居,5,0,5,ㄕㄨ ˙ㄗ,shū zi
2438,帥哥,4.5,核心詞,3,3,6,ㄕㄨㄞˋ ㄍㄜ,shuài gē
2439,雙方,4.5,14.社會,81,65,146,ㄕㄨㄤ ㄈㄤ,shuāng fāng
2440,睡眠,4.5,7.身體、醫療,71,40,111,ㄕㄨㄟˋ ㄇㄧㄢˊ,shuì mián
2441,說不定,4.5,核心詞,47,28,75,ㄕㄨㄛ ㄅㄨˊ ㄉㄧㄥˋ,shuō bú dìng
2442,絲,4.5,核心詞,60,34,94,ㄙ,sī
2443,四處,4.5,核心詞,49,26,75,ㄙˋ ㄔㄨˋ,sì chù
2444,思考,4.5,核心詞,257,99,356,ㄙ ㄎㄠˇ,sī kǎo
2445,死亡,4.5,7.身體、醫療,118,151,269,ㄙˇ ㄨㄤˊ,sǐ wáng
2446,四周,4.5,核心詞,53,17,70,ㄙˋ ㄓㄡ,sì zhōu
2447,蒜,4.5,10.餐飲、烹飪,4,7,11,ㄙㄨㄢˋ,suàn
2448,算了,4.5,核心詞,20,17,37,ㄙㄨㄢˋ ˙ㄌㄜ,suàn le
2449,算是,4.5,核心詞,79,122,201,ㄙㄨㄢˋ ㄕˋ,suàn shì
2450,縮水,4.5,9.購物、商店,2,4,6,ㄙㄨㄛ ㄕㄨㄟˇ,suō shuǐ
2451,抬/擡,4.5,核心詞,36,25,61,ㄊㄞˊ,tái
2452,太極拳,4.5,4.休閒、娛樂,2,4,6,ㄊㄞˋ ㄐㄧˊ ㄑㄩㄢˊ,tài jí quán
2453,彈,4.5,4.休閒、娛樂,49,31,80,ㄊㄢˊ,tán
2454,攤販,4.5,9.購物、商店,4,7,11,ㄊㄢ ㄈㄢˋ,tān fàn
2455,談戀愛,4.5,6.社交、人際,6,7,13,ㄊㄢˊ ㄌㄧㄢˋ ㄞˋ,tán liàn ài
2456,攤位,4.5,9.購物、商店,6,10,16,ㄊㄢ ㄨㄟˋ,tān wèi
2457,湯圓,4.5,10.餐飲、烹飪,4,8,12,ㄊㄤ ㄩㄢˊ,tāng yuán
2458,逃,4.5,12.安全,37,16,53,ㄊㄠˊ,táo
2459,特點,4.5,核心詞,22,12,34,ㄊㄜˋ ㄉㄧㄢˇ,tè diǎn
2460,特性,4.5,核心詞,47,43,90,ㄊㄜˋ ㄒㄧㄥˋ,tè xìng
2461,疼,4.5,核心詞,16,23,39,ㄊㄥˊ,téng
2462,提高,4.5,核心詞,81,61,142,ㄊㄧˊ ㄍㄠ,tí gāo
2463,提供,4.5,核心詞,279,186,465,ㄊㄧˊ ㄍㄨㄥ,tí gōng
2464,體重,4.5,7.身體、醫療,45,26,71,ㄊㄧˇ ㄓㄨㄥˋ,tǐ zhòng
2465,梯子,4.5,2.日常起居,6,1,7,ㄊㄧ ˙ㄗ,tī zi
2466,田,4.5,核心詞,53,307,360,ㄊㄧㄢˊ,tián
2467,天空,4.5,13.自然環境,63,25,88,ㄊㄧㄢ ㄎㄨㄥ,tiān kōng
2468,天生,4.5,核心詞,49,19,68,ㄊㄧㄢ ㄕㄥ,tiān shēng
2469,挑戰,4.5,核心詞,123,101,224,ㄊㄧㄠˇ ㄓㄢˋ,tiǎo zhàn
2470,調整,4.5,核心詞,73,55,128,ㄊㄧㄠˊ ㄓㄥˇ,tiáo zhěng
2471,鐵,4.5,核心詞,42,50,92,ㄊㄧㄝˇ,tiě
2472,聽話,4.5,核心詞,18,5,23,ㄊㄧㄥ ㄏㄨㄚˋ,tīng huà
2473,通,4.5,核心詞,62,39,101,ㄊㄨㄥ,tōng
2474,童年,4.5,1.個人資料,50,28,78,ㄊㄨㄥˊ ㄋㄧㄢˊ,tóng nián
2475,同情,4.5,核心詞,47,7,54,ㄊㄨㄥˊ ㄑㄧㄥˊ,tóng qíng
2476,統一,4.5,8.教育、學習,60,28,88,ㄊㄨㄥˇ ㄧ,tǒng yī
2477,投資,4.5,3.職業,118,57,175,ㄊㄡˊ ㄗ,tóu zī
2478,吐1,4.5,核心詞,45,26,71,ㄊㄨˋ,tù
2479,吐2,4.5,核心詞,45,26,71,ㄊㄨˇ,tǔ
2480,圖畫,4.5,核心詞,10,5,15,ㄊㄨˊ ㄏㄨㄚˋ,tú huà
2481,圖書,4.5,8.教育、學習,21,4,25,ㄊㄨˊ ㄕㄨ,tú shū
2482,兔子/兔,4.5,1.個人資料,32,10,42,ㄊㄨˋ ˙ㄗ/ㄊㄨˋ,tù zi/tù
2483,團,4.5,核心詞,51,30,81,ㄊㄨㄢˊ,tuán
2484,團隊,4.5,3.職業,73,96,169,ㄊㄨㄢˊ ㄉㄨㄟˋ,tuán duì
2485,退,4.5,9.購物、商店,43,40,83,ㄊㄨㄟˋ,tuì
2486,推動,4.5,3.職業,55,98,153,ㄊㄨㄟ ㄉㄨㄥˋ,tuī dòng
2487,挖,4.5,核心詞,38,58,96,ㄨㄚ,wā
2488,娃娃,4.5,核心詞,19,23,42,ㄨㄚˊ ˙ㄨㄚ,wá wa
2489,外表,4.5,1.個人資料,33,17,50,ㄨㄞˋ ㄅㄧㄠˇ,wài biǎo
2490,完成,4.5,核心詞,205,193,398,ㄨㄢˊ ㄔㄥˊ,wán chéng
2491,完美,4.5,核心詞,67,35,102,ㄨㄢˊ ㄇㄟˇ,wán měi
2492,完整,4.5,核心詞,69,69,138,ㄨㄢˊ ㄓㄥˇ,wán zhěng
2493,王,4.5,15.文化,111,79,190,ㄨㄤˊ,wáng
2494,往往,4.5,核心詞,165,52,217,ㄨㄤˇ ㄨㄤˇ,wǎng wǎng
2495,餵,4.5,2.日常起居,41,39,80,ㄨㄟˋ,wèi
2496,為1,4.5,核心詞,2687,1519,4206,ㄨㄟˋ,wèi
2497,危機,4.5,核心詞,78,153,231,ㄨㄟˊ ㄐㄧ,wéi jī
2498,微笑,4.5,核心詞,92,23,115,ㄨㄟˊ ㄒㄧㄠˋ,wéi xiào
2499,位置,4.5,2.日常起居,110,128,238,ㄨㄟˋ ㄓˋ,wèi zhì
2500,溫,4.5,核心詞,10,46,56,ㄨㄣ,wēn
2501,穩定,4.5,7.身體、醫療,74,124,198,ㄨㄣˇ ㄉㄧㄥˋ,wěn dìng
2502,問號,4.5,8.教育、學習,3,3,6,ㄨㄣˋ ㄏㄠˋ,wèn hào
2503,文件,4.5,8.教育、學習,50,8,58,ㄨㄣˊ ㄐㄧㄢˋ,wén jiàn
2504,文學,4.5,8.教育、學習,100,22,122,ㄨㄣˊ ㄒㄩㄝˊ,wén xué
2505,握,4.5,核心詞,46,13,59,ㄨㄛˋ,wò
2506,握手,4.5,6.社交、人際,18,9,27,ㄨㄛˋ ㄕㄡˇ,wò shǒu
2507,誤點,4.5,5.交通、旅遊,2,1,3,ㄨˋ ㄉㄧㄢˇ,wù diǎn
2508,吸,4.5,10.餐飲、烹飪,36,34,70,ㄒㄧ,xī
2509,喜酒,4.5,15.文化,2,2,4,ㄒㄧˇ ㄐㄧㄡˇ,xǐ jiǔ
2510,喜事,4.5,15.文化,4,1,5,ㄒㄧˇ ㄕˋ,xǐ shì
2511,吸收,4.5,7.身體、醫療,39,81,120,ㄒㄧ ㄕㄡ,xī shōu
2512,喜帖,4.5,15.文化,1,2,3,ㄒㄧˇ ㄊㄧㄝˇ,xǐ tiě
2513,吸菸,4.5,2.日常起居,6,2,8,ㄒㄧ ㄧㄢ,xī yān
2514,西元,4.5,核心詞,47,55,102,ㄒㄧ ㄩㄢˊ,xī yuán
2515,西裝,4.5,9.購物、商店,17,7,24,ㄒㄧ ㄓㄨㄤ,xī zhuāng
2516,下棋,4.5,4.休閒、娛樂,9,7,16,ㄒㄧㄚˋ ㄑㄧˊ,xià qí
2517,嚇一跳,4.5,16.情緒、態度,5,4,9,ㄒㄧㄚˋ ㄧˊ ㄊㄧㄠˋ,xià yí tiào
2518,現場,4.5,12.安全,49,166,215,ㄒㄧㄢˋ ㄔㄤˇ,xiàn chǎng
2519,現實,4.5,核心詞,121,29,150,ㄒㄧㄢˋ ㄕˊ,xiàn shí
2520,現象,4.5,核心詞,188,161,349,ㄒㄧㄢˋ ㄒㄧㄤˋ,xiàn xiàng
2521,限制/限,4.5,核心詞,85,58,143,ㄒㄧㄢˋ ㄓˋ/ㄒㄧㄢˋ,xiàn zhì/xiàn
2522,響,4.5,2.日常起居,56,21,77,ㄒㄧㄤˇ,xiǎng
2523,相處,4.5,6.社交、人際,59,69,128,ㄒㄧㄤ ㄔㄨˇ,xiāng chǔ
2524,鄉村,4.5,2.日常起居,17,18,35,ㄒㄧㄤ ㄘㄨㄣ,xiāng cūn
2525,相關,4.5,核心詞,145,76,221,ㄒㄧㄤ ㄍㄨㄢ,xiāng guān
2526,詳細,4.5,核心詞,51,28,79,ㄒㄧㄤˊ ㄒㄧˋ,xiáng xì
2527,想像力,4.5,核心詞,29,7,36,ㄒㄧㄤˇ ㄒㄧㄤˋ ㄌㄧˋ,xiǎng xiàng lì
2528,曉得,4.5,核心詞,79,107,186,ㄒㄧㄠˇ ˙ㄉㄜ,xiǎo de
2529,小販,4.5,9.購物、商店,6,3,9,ㄒㄧㄠˇ ㄈㄢˋ,xiǎo fàn
2530,效果,4.5,7.身體、醫療,155,124,279,ㄒㄧㄠˋ ㄍㄨㄛˇ,xiào guǒ
2531,笑話,4.5,核心詞,25,12,37,ㄒㄧㄠˋ ㄏㄨㄚˋ,xiào huà
2532,效率,4.5,核心詞,57,38,95,ㄒㄧㄠˋ ㄌㄩˋ,xiào lǜ
2533,小氣,4.5,核心詞,3,3,6,ㄒㄧㄠˇ ㄑㄧˋ,xiǎo qì
2534,笑容,4.5,核心詞,45,36,81,ㄒㄧㄠˋ ㄖㄨㄥˊ,xiào róng
2535,消失,4.5,核心詞,109,68,177,ㄒㄧㄠ ㄕ,xiāo shī
2536,小提琴,4.5,4.休閒、娛樂,12,9,21,ㄒㄧㄠˇ ㄊㄧˊ ㄑㄧㄣˊ,xiǎo tí qín
2537,血型,4.5,7.身體、醫療,2,1,3,ㄒㄧㄝˇ ㄒㄧㄥˊ,xiě xíng
2538,協助,4.5,核心詞,124,115,239,ㄒㄧㄝˊ ㄓㄨˋ,xié zhù
2539,寫作,4.5,8.教育、學習,66,12,78,ㄒㄧㄝˇ ㄗㄨㄛˋ,xiě zuò
2540,信件,4.5,11.公共服務,18,4,22,ㄒㄧㄣˋ ㄐㄧㄢˋ,xìn jiàn
2541,信任,4.5,核心詞,80,43,123,ㄒㄧㄣˋ ㄖㄣˋ,xìn rèn
2542,欣賞,4.5,4.休閒、娛樂,73,41,114,ㄒㄧㄣ ㄕㄤˇ,xīn shǎng
2543,性別,4.5,14.社會,39,7,46,ㄒㄧㄥˋ ㄅㄧㄝˊ,xìng bié
2544,幸福,4.5,核心詞,115,203,318,ㄒㄧㄥˋ ㄈㄨˊ,xìng fú
2545,性格,4.5,1.個人資料,78,16,94,ㄒㄧㄥˋ ㄍㄜˊ,xìng gé
2546,幸好,4.5,核心詞,25,28,53,ㄒㄧㄥˋ ㄏㄠˇ,xìng hǎo
2547,幸虧,4.5,核心詞,10,3,13,ㄒㄧㄥˋ ㄎㄨㄟ,xìng kuī
2548,形容,4.5,核心詞,49,48,97,ㄒㄧㄥˊ ㄖㄨㄥˊ,xíng róng
2549,形容詞,4.5,8.教育、學習,6,3,9,ㄒㄧㄥˊ ㄖㄨㄥˊ ㄘˊ,xíng róng cí
2550,形狀,4.5,9.購物、商店,42,42,84,ㄒㄧㄥˊ ㄓㄨㄤˋ,xíng zhuàng
2551,熊,4.5,13.自然環境,48,37,85,ㄒㄩㄥˊ,xióng
2552,兄,4.5,核心詞,26,15,41,ㄒㄩㄥ,xiōng
2553,宣布/宣佈,4.5,8.教育、學習,62,73,135,ㄒㄩㄢ ㄅㄨˋ,xuān bù
2554,學會,4.5,核心詞,111,74,185,ㄒㄩㄝˊ ㄏㄨㄟˋ,xué huì
2555,學位,4.5,8.教育、學習,26,7,33,ㄒㄩㄝˊ ㄨㄟˋ,xué wèi
2556,學問,4.5,8.教育、學習,43,25,68,ㄒㄩㄝˊ ㄨㄣˋ,xué wèn
2557,學院,4.5,8.教育、學習,73,22,95,ㄒㄩㄝˊ ㄩㄢˋ,xué yuàn
2558,學者,4.5,8.教育、學習,101,45,146,ㄒㄩㄝˊ ㄓㄜˇ,xué zhě
2559,迅速,4.5,核心詞,75,39,114,ㄒㄩㄣˋ ㄙㄨˋ,xùn sù
2560,壓,4.5,核心詞,40,53,93,ㄧㄚ,yā
2561,牙醫,4.5,7.身體、醫療,6,9,15,ㄧㄚˊ ㄧ,yá yī
2562,鴨子/鴨,4.5,10.餐飲、烹飪,28,27,55,ㄧㄚ ˙ㄗ/ㄧㄚ,yā zi/yā
2563,煙,4.5,核心詞,40,24,64,ㄧㄢ,yān
2564,演出,4.5,4.休閒、娛樂,52,39,91,ㄧㄢˇ ㄔㄨ,yǎn chū
2565,眼光,4.5,核心詞,50,23,73,ㄧㄢˇ ㄍㄨㄤ,yǎn guāng
2566,眼前,4.5,核心詞,96,35,131,ㄧㄢˇ ㄑㄧㄢˊ,yǎn qián
2567,陽光,4.5,13.自然環境,61,84,145,ㄧㄤˊ ㄍㄨㄤ,yáng guāng
2568,羊肉,4.5,10.餐飲、烹飪,4,1,5,ㄧㄤˊㄖㄡˋ,yáng ròu
2569,陽台/陽臺,4.5,2.日常起居,14,16,30,ㄧㄤˊ ㄊㄞˊ,yáng tái
2570,搖,4.5,10.餐飲、烹飪,40,20,60,ㄧㄠˊ,yáo
2571,腰,4.5,7.身體、醫療,62,33,95,ㄧㄠ,yāo
2572,要不是,4.5,核心詞,16,7,23,ㄧㄠˋ ㄅㄨˊ ㄕˋ,yào bú shì
2573,業務,4.5,3.職業,56,11,67,ㄧㄝˋ ㄨˋ,yè wù
2574,醫,4.5,7.身體、醫療,13,35,48,ㄧ,yī
2575,一般來說,4.5,核心詞,15,15,30,ㄧˋ ㄅㄢ ㄌㄞˊ ㄕㄨㄛ,yì bān lái shuō
2576,一帶,4.5,核心詞,48,28,76,ㄧˊ ㄉㄞˋ,yí dài
2577,移動,4.5,核心詞,63,40,103,ㄧˊ ㄉㄨㄥˋ,yí dòng
2578,一方面,4.5,核心詞,65,70,135,ㄧˋ ㄈㄤ ㄇㄧㄢˋ,yì fāng miàn
2579,以來,4.5,核心詞,94,112,206,ㄧˇ ㄌㄞˊ,yǐ lái
2580,姨媽,4.5,1.個人資料,7,3,10,ㄧˊ ㄇㄚ,yí mā
2581,一旁,4.5,5.交通、旅遊,1,0,1,ㄧˋ ㄆㄤˊ,yì páng
2582,一生,4.5,核心詞,103,56,159,ㄧˋ ㄕㄥ,yì shēng
2583,一時,4.5,核心詞,80,20,100,ㄧˋ ㄕˊ,yì shí
2584,一天到晚,4.5,核心詞,7,6,13,ㄧˋ ㄊㄧㄢ ㄉㄠˋ ㄨㄢˇ,yì tiān dào wǎn
2585,一向,4.5,核心詞,67,15,82,ㄧˊ ㄒㄧㄤˋ,yí xiàng
2586,醫學,4.5,7.身體、醫療,76,64,140,ㄧ ㄒㄩㄝˊ,yī xué
2587,一再,4.5,核心詞,55,19,74,ㄧˊ ㄗㄞˋ,yí zài
2588,一陣子,4.5,核心詞,31,32,63,ㄧˊ ㄓㄣˋ ˙ㄗ,yí zhèn zi
2589,銀,4.5,核心詞,36,9,45,ㄧㄣˊ,yín
2590,因此,4.5,核心詞,707,377,1084,ㄧㄣ ㄘˇ,yīn cǐ
2591,引起,4.5,12.安全,144,92,236,ㄧㄣˇ ㄑㄧˇ,yǐn qǐ
2592,因素,4.5,核心詞,129,78,207,ㄧㄣ ㄙㄨˋ,yīn sù
2593,印象,4.5,核心詞,94,117,211,ㄧㄣˋ ㄒㄧㄤˋ,yìn xiàng
2594,音樂家,4.5,4.休閒、娛樂,11,6,17,ㄧㄣ ㄩㄝˋ ㄐㄧㄚ,yīn yuè jiā
2595,應當,4.5,核心詞,26,4,30,ㄧㄥ ㄉㄤ,yīng dāng
2596,嬰兒,4.5,核心詞,108,40,148,ㄧㄥ ㄦˊ,yīng ér
2597,影像,4.5,4.休閒、娛樂,51,53,104,ㄧㄥˇ ㄒㄧㄤˋ,yǐng xiàng
2598,影子/影,4.5,13.自然環境,31,13,44,ㄧㄥˇ ˙ㄗ/ㄧㄥˇ,yǐng zi/yǐng
2599,用餐,4.5,10.餐飲、烹飪,18,18,36,ㄩㄥˋ ㄘㄢ,yòng cān
2600,用具,4.5,2.日常起居,6,3,9,ㄩㄥˋ ㄐㄩˋ,yòng jù
2601,勇氣,4.5,16.情緒、態度,58,44,102,ㄩㄥˇ ㄑㄧˋ,yǒng qì
2602,由,4.5,核心詞,694,320,1014,ㄧㄡˊ,yóu
2603,優點,4.5,核心詞,40,26,66,ㄧㄡ ㄉㄧㄢˇ,yōu diǎn
2604,油膩,4.5,10.餐飲、烹飪,4,4,8,ㄧㄡˊ ㄋㄧˋ,yóu nì
2605,由於,4.5,核心詞,304,110,414,ㄧㄡˊ ㄩˊ,yóu yú
2606,幼稚園,4.5,8.教育、學習,20,18,38,ㄧㄡˋ ㄓˋ ㄩㄢˊ,yòu zhì yuán
2607,與,4.5,核心詞,3290,1103,4393,ㄩˇ,yǔ
2608,預報,4.5,5.交通、旅遊,3,16,19,ㄩˋ ㄅㄠˋ,yù bào
2609,愉快,4.5,核心詞,78,23,101,ㄩˊ ㄎㄨㄞˋ,yú kuài
2610,預期,4.5,核心詞,47,21,68,ㄩˋ ㄑㄧˊ,yù qí
2611,於是,4.5,核心詞,484,93,577,ㄩˊ ㄕˋ,yú shì
2612,原本,4.5,核心詞,137,202,339,ㄩㄢˊ ㄅㄣˇ,yuán běn
2613,元旦,4.5,15.文化,5,1,6,ㄩㄢˊ ㄉㄢˋ,yuán dàn
2614,原諒,4.5,6.社交、人際,31,20,51,ㄩㄢˊ ㄌㄧㄤˋ,yuán liàng
2615,原味,4.5,10.餐飲、烹飪,4,8,12,ㄩㄢˊ ㄨㄟˋ,yuán wèi
2616,元宵,4.5,15.文化,2,4,6,ㄩㄢˊ ㄒㄧㄠ,yuán xiāo
2617,圓形,4.5,9.購物、商店,11,7,18,ㄩㄢˊ ㄒㄧㄥˊ,yuán xíng
2618,原則,4.5,8.教育、學習,117,46,163,ㄩㄢˊ ㄗㄜˊ,yuán zé
2619,月光,4.5,13.自然環境,15,3,18,ㄩㄝˋ ㄍㄨㄤ,yuè guāng
2620,樂團,4.5,4.休閒、娛樂,15,7,22,ㄩㄝˋ ㄊㄨㄢˊ,yuè tuán
2621,在乎,4.5,核心詞,51,21,72,ㄗㄞˋ ㄏㄨ,zài hū
2622,再三,4.5,核心詞,18,7,25,ㄗㄞˋ ㄙㄢ,zài sān
2623,糟,4.5,核心詞,56,20,76,ㄗㄠ,zāo
2624,早晨,4.5,核心詞,39,8,47,ㄗㄠˇ ㄔㄣˊ,zǎo chén
2625,造成,4.5,核心詞,273,541,814,ㄗㄠˋ ㄔㄥˊ,zào chéng
2626,暫時,4.5,核心詞,56,38,94,ㄓㄢˋ ㄕˊ,zhàn shí
2627,章,4.5,核心詞,205,15,220,ㄓㄤ,zhāng
2628,帳單,4.5,9.購物、商店,9,2,11,ㄓㄤˋ ㄉㄢ,zhàng dān
2629,丈夫,4.5,1.個人資料,150,15,165,ㄓㄤˋ ㄈㄨ,zhàng fū
2630,帳號,4.5,1.個人資料,2,2,4,ㄓㄤˋㄏㄠˋ,zhàng hào
2631,張開,4.5,7.身體、醫療,28,10,38,ㄓㄤ ㄎㄞ,zhāng kāi
2632,招手,4.5,核心詞,7,2,9,ㄓㄠ ㄕㄡˇ,zhāo shǒu
2633,折扣,4.5,9.購物、商店,5,3,8,ㄓㄜˊ ㄎㄡˋ,zhé kòu
2634,哲學,4.5,8.教育、學習,57,17,74,ㄓㄜˊ ㄒㄩㄝˊ,zhé xué
2635,真實,4.5,16.情緒、態度,123,50,173,ㄓㄣ ㄕˊ,zhēn shí
2636,爭,4.5,14.社會,48,30,78,ㄓㄥ,zhēng
2637,政策,4.5,14.社會,96,133,229,ㄓㄥˋ ㄘㄜˋ,zhèng cè
2638,證據,4.5,12.安全,89,37,126,ㄓㄥˋ ㄐㄩˋ,zhèng jù
2639,整體,4.5,3.職業,60,27,87,ㄓㄥˇ ㄊㄧˇ,zhěng tǐ
2640,止,4.5,7.身體、醫療,99,62,161,ㄓˇ,zhǐ
2641,直到,4.5,核心詞,169,72,241,ㄓˊ ㄉㄠˋ,zhí dào
2642,指導,4.5,8.教育、學習,57,39,96,ㄓˇ ㄉㄠˇ,zhǐ dǎo
2643,製造/製,4.5,3.職業,123,150,273,ㄓˋ ㄗㄠˋ/ㄓˋ,zhì zào/zhì
2644,中2,4.5,核心詞,3605,1443,5048,ㄓㄨㄥˋ,zhòng
2645,重大,4.5,核心詞,78,50,128,ㄓㄨㄥˋ ㄉㄚˋ,zhòng dà
2646,中年,4.5,14.社會,39,26,65,ㄓㄨㄥ ㄋㄧㄢˊ,zhōng nián
2647,週年/周年,4.5,核心詞,10,23,33,ㄓㄡ ㄋㄧㄢˊ ,zhōu nián 
2648,周圍,4.5,核心詞,56,28,84,ㄓㄡ ㄨㄟˊ,zhōu wéi
2649,主動,4.5,核心詞,74,55,129,ㄓㄨˇ ㄉㄨㄥˋ,zhǔ dòng
2650,主管,4.5,3.職業,108,13,121,ㄓㄨˇ ㄍㄨㄢˇ,zhǔ guǎn
2651,住戶,4.5,2.日常起居,7,7,14,ㄓㄨˋ ㄏㄨˋ,zhù hù
2652,主意,4.5,核心詞,51,9,60,ㄓㄨˇ ㄧˋ,zhǔ yì
2653,住院,4.5,7.身體、醫療,19,30,49,ㄓㄨˋ ㄩㄢˋ,zhù yuàn
2654,專門,4.5,核心詞,57,56,113,ㄓㄨㄢ ㄇㄣˊ,zhuān mén
2655,追求,4.5,核心詞,111,54,165,ㄓㄨㄟ ㄑㄧㄡˊ,zhuī qiú
2656,準,4.5,核心詞,31,18,49,ㄓㄨㄣˇ,zhǔn
2657,紫,4.5,核心詞,15,16,31,ㄗˇ,zǐ
2658,資本,4.5,14.社會,33,7,40,ㄗ ㄅㄣˇ,zī běn
2659,自從,4.5,核心詞,55,63,118,ㄗˋ ㄘㄨㄥˊ,zì cóng
2660,自來水,4.5,2.日常起居,5,25,30,ㄗˋ ㄌㄞˊ ㄕㄨㄟˇ,zì lái shuǐ
2661,字幕,4.5,4.休閒、娛樂,2,1,3,ㄗˋ ㄇㄨˋ,zì mù
2662,自殺,4.5,12.安全,70,13,83,ㄗˋ ㄕㄚ,zì shā
2663,仔細,4.5,核心詞,112,61,173,ㄗˇ ㄒㄧˋ,zǐ xì
2664,自在,4.5,核心詞,57,22,79,ㄗˋ ㄗㄞˋ,zì zài
2665,自助,4.5,核心詞,7,6,13,ㄗˋ ㄓㄨˋ,zì zhù
2666,總統府,4.5,14.社會,7,4,11,ㄗㄨㄥˇ ㄊㄨㄥˇ ㄈㄨˇ,zǒng tǒng fǔ
2667,組,4.5,核心詞,91,85,176,ㄗㄨˇ,zǔ
2668,組合,4.5,3.職業,63,25,88,ㄗㄨˇ ㄏㄜˊ,zǔ hé
2669,最初,4.5,核心詞,48,16,64,ㄗㄨㄟˋ ㄔㄨ,zuì chū
2670,哎,5,核心詞,10,10,20,ㄞ,āi
2671,挨打,5,核心詞,7,0,7,ㄞ ㄉㄚˇ,āi dǎ
2672,挨餓,5,核心詞,6,6,12,ㄞ ㄜˋ,āi è
2673,愛護,5,核心詞,10,31,41,ㄞˋ ㄏㄨˋ,ài hù
2674,挨罵,5,核心詞,4,2,6,ㄞ ㄇㄚˋ,āi mà
2675,愛惜,5,核心詞,5,12,17,ㄞˋ ㄒㄧˊ,ài xí
2676,矮小,5,7.身體、醫療,8,0,8,ㄞˇ ㄒㄧㄠˇ,ǎi xiǎo
2677,癌症/癌,5,7.身體、醫療,66,91,157,ㄞˊ ㄓㄥˋ / ㄞˊ,ái zhèng / ái
2678,安定,5,14.社會,31,26,57,ㄢ ㄉㄧㄥˋ,ān dìng
2679,案件,5,12.安全,23,11,34,ㄢˋ ㄐㄧㄢˋ,àn jiàn
2680,案例,5,核心詞,48,22,70,ㄢˋ ㄌㄧˋ,àn lì
2681,按摩,5,7.身體、醫療,26,16,42,ㄢˋ ㄇㄛˊ,àn mó
2682,按時,5,核心詞,7,3,10,ㄢˋ ㄕˊ,àn shí
2683,暗示,5,12.安全,38,7,45,ㄢˋ ㄕˋ,àn shì
2684,安慰,5,核心詞,52,27,79,ㄢ ㄨㄟˋ,ān wèi
2685,安心,5,核心詞,24,50,74,ㄢ ㄒㄧㄣ,ān xīn
2686,暗中,5,12.安全,21,2,23,ㄢˋ ㄓㄨㄥ,àn zhōng
2687,昂貴,5,2.日常起居,20,15,35,ㄤˊ ㄍㄨㄟˋ,áng guì
2688,拔,5,核心詞,15,76,91,ㄅㄚˊ,bá
2689,八成,5,核心詞,9,12,21,ㄅㄚ ㄔㄥˊ,bā chéng
2690,罷工,5,14.社會,8,12,20,ㄅㄚˋ ㄍㄨㄥ,bà gōng
2691,罷了,5,核心詞,37,1,38,ㄅㄚˋ ˙ㄌㄜ,bà le
2692,罷免,5,14.社會,2,1,3,ㄅㄚˋ ㄇㄧㄢˇ,bà miǎn
2693,把握,5,核心詞,40,40,80,ㄅㄚˇ ㄨㄛˋ,bǎ wò
2694,拜,5,1.個人資料,35,25,60,ㄅㄞˋ,bài
2695,白日夢,5,2.日常起居,6,3,9,ㄅㄞˊ ㄖˋ ㄇㄥˋ,bái rì mèng
2696,拜託,5,核心詞,26,50,76,ㄅㄞˋ ㄊㄨㄛ,bài tuō
2697,擺脫,5,12.安全,32,19,51,ㄅㄞˇ ㄊㄨㄛ,bǎi tuō
2698,拌,5,10.餐飲、烹飪,7,14,21,ㄅㄢˋ,bàn
2699,版,5,核心詞,20,7,27,ㄅㄢˇ,bǎn
2700,版本,5,4.休閒、娛樂,27,8,35,ㄅㄢˇ ㄅㄣˇ,bǎn běn
2701,辦公,5,3.職業,11,5,16,ㄅㄢˋ ㄍㄨㄥ,bàn gōng
2702,班級,5,8.教育、學習,11,11,22,ㄅㄢ ㄐㄧˊ,bān jí
2703,辦理,5,核心詞,19,4,23,ㄅㄢˋ ㄌㄧˇ,bàn lǐ
2704,半路,5,核心詞,8,3,11,ㄅㄢˋ ㄌㄨˋ,bàn lù
2705,伴侶,5,6.社交、人際,21,3,24,ㄅㄢˋ ㄌㄩˇ,bàn lǚ
2706,伴隨,5,7.身體、醫療,23,15,38,ㄅㄢˋ ㄙㄨㄟˊ,bàn suí
2707,半途,5,5.交通、旅遊,4,3,7,ㄅㄢˋ ㄊㄨˊ,bàn tú
2708,搬運,5,核心詞,7,12,19,ㄅㄢ ㄩㄣˋ,bān yùn
2709,綁,5,核心詞,30,29,59,ㄅㄤˇ,bǎng
2710,幫手,5,核心詞,6,12,18,ㄅㄤ ㄕㄡˇ,bāng shǒu
2711,傍晚,5,核心詞,29,14,43,ㄅㄤ ㄨㄢˇ,bāng wǎn
2712,報案,5,12.安全,4,2,6,ㄅㄠˋ ㄢˋ,bào àn
2713,寶貝,5,核心詞,33,27,60,ㄅㄠˇ ㄅㄟˋ,bǎo bèi
2714,保存,5,5.交通、旅遊,35,74,109,ㄅㄠˇ ㄘㄨㄣˊ,bǎo cún
2715,報到,5,8.教育、學習,9,7,16,ㄅㄠˋ ㄉㄠˋ,bào dào
2716,報導,5,4.休閒、娛樂,74,99,173,ㄅㄠˋ ㄉㄠˇ,bào dǎo
2717,爆發,5,12.安全,43,59,102,ㄅㄠˋ ㄈㄚ,bào fā
2718,報復,5,12.安全,21,7,28,ㄅㄠˋ ㄈㄨˋ,bào fù
2719,保管,5,5.交通、旅遊,7,3,10,ㄅㄠˇ ㄍㄨㄢˇ,bǎo guǎn
2720,寶貴,5,核心詞,24,19,43,ㄅㄠˇ ㄍㄨㄟˋ,bǎo guì
2721,報警,5,12.安全,6,2,8,ㄅㄠˋ ㄐㄧㄥˇ,bào jǐng
2722,報刊,5,4.休閒、娛樂,5,1,6,ㄅㄠˋ ㄎㄢ,bào kān
2723,暴力,5,12.安全,59,44,103,ㄅㄠˋ ㄌㄧˋ,bào lì
2724,保留,5,核心詞,42,47,89,ㄅㄠˇ ㄌㄧㄡˊ,bǎo liú
2725,保守,5,8.教育、學習,25,18,43,ㄅㄠˇ ㄕㄡˇ,bǎo shǒu
2726,包圍,5,12.安全,29,13,42,ㄅㄠ ㄨㄟˊ,bāo wéi
2727,保險,5,核心詞,27,15,42,ㄅㄠˇ ㄒㄧㄢˇ,bǎo xiǎn
2728,爆炸,5,12.安全,21,49,70,ㄅㄠˋ ㄓㄚˋ,bào zhà
2729,保障,5,14.社會,21,34,55,ㄅㄠˇ ㄓㄤˋ,bǎo zhàng
2730,保重,5,6.社交、人際,4,3,7,ㄅㄠˇ ㄓㄨㄥˋ,bǎo zhòng
2731,包裝,5,9.購物、商店,21,57,78,ㄅㄠ ㄓㄨㄤ,bāo zhuāng
2732,輩,5,15.文化,18,10,28,ㄅㄟˋ,bèi
2733,悲哀,5,16.情緒、態度,20,2,22,ㄅㄟ ㄞ,bēi āi
2734,悲慘,5,核心詞,21,5,26,ㄅㄟ ㄘㄢˇ,bēi cǎn
2735,被動,5,核心詞,20,5,25,ㄅㄟˋ ㄉㄨㄥˋ,bèi dòng
2736,悲觀,5,核心詞,32,7,39,ㄅㄟ ㄍㄨㄢ,bēi guān
2737,悲劇,5,4.休閒、娛樂,38,15,53,ㄅㄟ ㄐㄩˋ,bēi jù
2738,北極,5,13.自然環境,5,55,60,ㄅㄟˇ ㄐㄧˊ,běi jí
2739,背叛,5,16.情緒、態度,19,4,23,ㄅㄟˋ ㄆㄢˋ,bèi pàn
2740,悲傷,5,16.情緒、態度,38,25,63,ㄅㄟ ㄕㄤ,bēi shāng
2741,背影,5,核心詞,9,5,14,ㄅㄟˋ ㄧㄥˇ,bèi yǐng
2742,輩子,5,核心詞,68,84,152,ㄅㄟˋ ˙ㄗ,bèi zi
2743,本領,5,核心詞,20,2,22,ㄅㄣˇ ㄌㄧㄥˇ,běn lǐng
2744,本能,5,核心詞,32,4,36,ㄅㄣˇ ㄋㄥˊ,běn néng
2745,本錢,5,核心詞,6,5,11,ㄅㄣˇ ㄑㄧㄢˊ,běn qián
2746,本身,5,核心詞,151,210,361,ㄅㄣˇ ㄕㄣ,běn shēn
2747,本事,5,核心詞,24,4,28,ㄅㄣˇ ㄕˋ / ㄅㄣˇ ˙ㄕ,běn shì / běn shi
2748,本土,5,核心詞,19,21,40,ㄅㄣˇ ㄊㄨˇ,běn tǔ
2749,本性,5,1.個人資料,19,9,28,ㄅㄣˇ ㄒㄧㄥˋ,běn xìng
2750,笨重,5,核心詞,4,1,5,ㄅㄣˋ ㄓㄨㄥˋ,bèn zhòng
2751,閉,5,核心詞,19,6,25,ㄅㄧˋ,bì
2752,逼,5,核心詞,51,15,66,ㄅㄧ,bī
2753,必備,5,核心詞,8,8,16,ㄅㄧˋ ㄅㄟˋ,bì bèi
2754,彼此,5,6.社交、人際,159,74,233,ㄅㄧˇ ㄘˇ,bǐ cǐ
2755,必定,5,核心詞,46,7,53,ㄅㄧˋ ㄉㄧㄥˋ,bì dìng
2756,避風港,5,核心詞,3,0,3,ㄅㄧˋ ㄈㄥ ㄍㄤˇ,bì fēng gǎng
2757,畢竟,5,核心詞,82,56,138,ㄅㄧˋ ㄐㄧㄥˋ,bì jìng
2758,避開,5,12.安全,24,10,34,ㄅㄧˋ ㄎㄞ,bì kāi
2759,鼻孔,5,7.身體、醫療,8,3,11,ㄅㄧˊ ㄎㄨㄥˇ,bí kǒng
2760,比例,5,5.交通、旅遊,58,73,131,ㄅㄧˇ ㄌㄧˋ,bǐ lì
2761,比率,5,5.交通、旅遊,10,7,17,ㄅㄧˇ ㄌㄩˋ,bǐ lǜ
2762,必然,5,核心詞,65,10,75,ㄅㄧˋ ㄖㄢˊ,bì rán
2763,比喻,5,8.教育、學習,17,9,26,ㄅㄧˇ ㄩˋ,bǐ yù
2764,閉嘴,5,核心詞,7,1,8,ㄅㄧˋ ㄗㄨㄟˇ,bì zuǐ
2765,扁,5,10.餐飲、烹飪,9,7,16,ㄅㄧㄢˇ  ,biǎn  
2766,變動,5,核心詞,22,13,35,ㄅㄧㄢˋ ㄉㄨㄥˋ,biàn dòng
2767,編輯,5,8.教育、學習,39,17,56,ㄅㄧㄢ ㄐㄧˊ,biān jí
2768,編劇,5,4.休閒、娛樂,24,2,26,ㄅㄧㄢ ㄐㄩˋ,biān jù
2769,辨識,5,核心詞,19,15,34,ㄅㄧㄢˋ ㄕˋ,biàn shì
2770,表決,5,14.社會,3,9,12,ㄅㄧㄠˇ ㄐㄩㄝˊ,biǎo jué
2771,表明,5,8.教育、學習,27,4,31,ㄅㄧㄠˇ ㄇㄧㄥˊ,biǎo míng
2772,標籤,5,9.購物、商店,20,13,33,ㄅㄧㄠ ㄑㄧㄢ,biāo qiān
2773,標題,5,8.教育、學習,20,7,27,ㄅㄧㄠ ㄊㄧˊ,biāo tí
2774,賓客,5,6.社交、人際,13,5,18,ㄅㄧㄣ ㄎㄜˋ,bīn kè
2775,兵,5,12.安全,77,19,96,ㄅㄧㄥ,bīng
2776,病床,5,7.身體、醫療,7,7,14,ㄅㄧㄥˋ ㄔㄨㄤˊ,bìng chuáng
2777,病毒,5,7.身體、醫療,30,101,131,ㄅㄧㄥˋ ㄉㄨˊ,bìng dú
2778,冰冷,5,核心詞,16,8,24,ㄅㄧㄥ ㄌㄥˇ,bīng lěng
2779,病痛,5,7.身體、醫療,11,15,26,ㄅㄧㄥˋ ㄊㄨㄥˋ,bìng tòng
2780,薄,5,核心詞,27,26,53,ㄅㄛˊ,bó
2781,撥,5,核心詞,19,13,32,ㄅㄛ,bō
2782,波,5,13.自然環境,43,64,107,ㄅㄛ,bō
2783,不便,5,核心詞,18,13,31,ㄅㄨˊ ㄅㄧㄢˋ,bú biàn
2784,補充,5,7.身體、醫療,43,36,79,ㄅㄨˇ ㄔㄨㄥ,bǔ chōng
2785,步道,5,5.交通、旅遊,18,28,46,ㄅㄨˋ ㄉㄠˋ,bù dào
2786,不得已,5,16.情緒、態度,14,8,22,ㄅㄨˋ ㄉㄜˊ ㄧˇ,bù dé yǐ
2787,不妨,5,核心詞,38,7,45,ㄅㄨˋ ㄈㄤˊ,bù fáng
2788,不敢當,5,6.社交、人際,1,2,3,ㄅㄨˋ ㄍㄢˇ ㄉㄤ,bù gǎn dāng
2789,不顧,5,16.情緒、態度,27,9,36,ㄅㄨˊ ㄍㄨˋ,bú gù
2790,補課,5,8.教育、學習,1,1,2,ㄅㄨˇ ㄎㄜˋ,bǔ kè
2791,不可思議,5,16.情緒、態度,31,22,53,ㄅㄨˋ ㄎㄜˇ ㄙ ㄧˋ,bù kě sī yì
2792,不利,5,核心詞,34,8,42,ㄅㄨˊ ㄌㄧˋ,bú lì
2793,不料,5,核心詞,22,4,26,ㄅㄨˊ ㄌㄧㄠˋ,bú liào
2794,部落,5,5.交通、旅遊,72,132,204,ㄅㄨˋ ㄌㄨㄛˋ,bù luò
2795,不滿,5,16.情緒、態度,46,11,57,ㄅㄨˋ ㄇㄢˇ,bù mǎn
2796,不明,5,核心詞,23,9,32,ㄅㄨˋ ㄇㄧㄥˊ,bù míng
2797,不然,5,核心詞,52,164,216,ㄅㄨˋ ㄖㄢˊ,bù rán
2798,部屬,5,3.職業,46,2,48,ㄅㄨˋ ㄕㄨˇ,bù shǔ
2799,部位,5,7.身體、醫療,41,12,53,ㄅㄨˋ ㄨㄟˋ,bù wèi
2800,補習,5,8.教育、學習,6,18,24,ㄅㄨˇ ㄒㄧˊ,bǔ xí
2801,布置/佈置,5,2.日常起居,14,17,31,ㄅㄨˋ ㄓˋ,bù zhì
2802,不止,5,核心詞,16,9,25,ㄅㄨˋ ㄓˇ,bù zhǐ
2803,不知不覺,5,核心詞,23,10,33,ㄅㄨˋ ㄓ ㄅㄨˋ ㄐㄩㄝˊ,bù zhī bù jué
2804,步驟,5,8.教育、學習,47,31,78,ㄅㄨˋ ㄗㄡˋ,bù zòu
2805,踩,5,核心詞,27,36,63,ㄘㄞˇ,cǎi
2806,猜測,5,核心詞,20,5,25,ㄘㄞ ㄘㄜˋ,cāi cè
2807,財產,5,14.社會,36,17,53,ㄘㄞˊ ㄔㄢˇ,cái chǎn
2808,採訪,5,4.休閒、娛樂,21,74,95,ㄘㄞˇ ㄈㄤˇ,cǎi fǎng
2809,財富,5,14.社會,43,13,56,ㄘㄞˊ ㄈㄨˋ,cái fù
2810,採購,5,9.購物、商店,19,8,27,ㄘㄞˇ ㄍㄡˋ,cǎi gòu
2811,才華,5,1.個人資料,22,4,26,ㄘㄞˊ ㄏㄨㄚˊ,cái huá
2812,才能,5,核心詞,16,1,17,ㄘㄞˊ ㄋㄥˊ,cái néng
2813,裁判,5,4.休閒、娛樂,7,2,9,ㄘㄞˊ ㄆㄢˋ,cái pàn
2814,採取,5,核心詞,118,46,164,ㄘㄞˇ ㄑㄩˇ,cǎi qǔ
2815,菜色,5,10.餐飲、烹飪,7,8,15,ㄘㄞˋ ㄙㄜˋ,cài sè
2816,彩色,5,核心詞,15,21,36,ㄘㄞˇ ㄙㄜˋ,cǎi sè
2817,財務,5,3.職業,32,10,42,ㄘㄞˊ ㄨˋ,cái wù
2818,猜想,5,核心詞,27,3,30,ㄘㄞ ㄒㄧㄤˇ,cāi xiǎng
2819,材質,5,9.購物、商店,10,49,59,ㄘㄞˊ ㄓˊ,cái zhí
2820,慘,5,核心詞,22,33,55,ㄘㄢˇ,cǎn
2821,餐具,5,10.餐飲、烹飪,6,13,19,ㄘㄢ ㄐㄩˋ,cān jù
2822,殘酷,5,12.安全,25,9,34,ㄘㄢˊ ㄎㄨˋ,cán kù
2823,殘忍,5,12.安全,17,8,25,ㄘㄢˊ ㄖㄣˇ,cán rěn
2824,參與,5,核心詞,151,127,278,ㄘㄢ ㄩˋ,cān yù
2825,慘重,5,核心詞,7,21,28,ㄘㄢˇ ㄓㄨㄥˋ,cǎn zhòng
2826,蒼白,5,7.身體、醫療,20,1,21,ㄘㄤ ㄅㄞˊ,cāng bái
2827,倉庫,5,2.日常起居,15,13,28,ㄘㄤ ㄎㄨˋ,cāng kù
2828,草原,5,5.交通、旅遊,23,14,37,ㄘㄠˇ ㄩㄢˊ,cǎo yuán
2829,操作,5,核心詞,51,37,88,ㄘㄠ ㄗㄨㄛˋ,cāo zuò
2830,冊,5,核心詞,47,8,55,ㄘㄜˋ,cè
2831,策略,5,8.教育、學習,126,24,150,ㄘㄜˋ ㄌㄩㄝˋ,cè lüè
2832,測試,5,核心詞,44,34,78,ㄘㄜˋ ㄕˋ,cè shì
2833,冊子,5,核心詞,2,0,2,ㄘㄜˋ ˙ㄗ,cè zi
2834,插,5,核心詞,30,40,70,ㄔㄚ,chā
2835,差距,5,核心詞,20,25,45,ㄔㄚ ㄐㄩˋ,chā jù
2836,插嘴,5,核心詞,8,1,9,ㄔㄚ ㄗㄨㄟˇ,chā zuǐ
2837,拆,5,核心詞,12,18,30,ㄔㄞ,chāi
2838,產地,5,10.餐飲、烹飪,4,9,13,ㄔㄢˇ ㄉㄧˋ,chǎn dì
2839,產量,5,9.購物、商店,14,68,82,ㄔㄢˇ ㄌㄧㄤˋ,chǎn liàng
2840,產業,5,3.職業,83,103,186,ㄔㄢˇ ㄧㄝˋ,chǎn yè
2841,嘗/嚐,5,10.餐飲、烹飪,24,15,39,ㄔㄤˊ,cháng
2842,長處,5,核心詞,22,1,23,ㄔㄤˊ ㄔㄨˋ,cháng chù
2843,場次,5,8.教育、學習,1,4,5,ㄔㄤˇ ㄘˋ,chǎng cì
2844,場地,5,2.日常起居,8,18,26,ㄔㄤˇ ㄉㄧˋ,chǎng dì
2845,場合,5,6.社交、人際,33,18,51,ㄔㄤˇ ㄏㄜˊ,chǎng hé
2846,場景,5,4.休閒、娛樂,28,21,49,ㄔㄤˇ ㄐㄧㄥˇ,chǎng jǐng
2847,長久,5,核心詞,23,17,40,ㄔㄤˊ ㄐㄧㄡˇ,cháng jiǔ
2848,廠商,5,3.職業,33,32,65,ㄔㄤˇ ㄕㄤ,chǎng shāng
2849,長壽,5,7.身體、醫療,17,11,28,ㄔㄤˊ ㄕㄡˋ,cháng shòu
2850,場所,5,2.日常起居,31,18,49,ㄔㄤˇ ㄙㄨㄛˇ,chǎng suǒ
2851,長途,5,5.交通、旅遊,9,3,12,ㄔㄤˊ ㄊㄨˊ,cháng tú
2852,長遠,5,核心詞,10,11,21,ㄔㄤˊ ㄩㄢˇ,cháng yuǎn
2853,抄,5,核心詞,13,10,23,ㄔㄠ,chāo
2854,超出,5,5.交通、旅遊,14,5,19,ㄔㄠ ㄔㄨ,chāo chū
2855,潮流,5,14.社會,17,12,29,ㄔㄠˊ ㄌㄧㄡˊ,cháo liú
2856,吵鬧,5,核心詞,7,3,10,ㄔㄠˇ ㄋㄠˋ,chǎo nào
2857,鈔票,5,11.公共服務,11,7,18,ㄔㄠ ㄆㄧㄠˋ,chāo piào
2858,超人,5,4.休閒、娛樂,25,7,32,ㄔㄠ ㄖㄣˊ,chāo rén
2859,嘲笑,5,16.情緒、態度,20,3,23,ㄔㄠˊ ㄒㄧㄠˋ,cháo xiào
2860,超越,5,核心詞,58,20,78,ㄔㄠ ㄩㄝˋ,chāo yuè
2861,車道,5,5.交通、旅遊,13,4,17,ㄔㄜ ㄉㄠˋ,chē dào
2862,澈底/徹底,5,核心詞,72,24,96,ㄔㄜˋ ㄉㄧˇ,chè dǐ
2863,車輛,5,核心詞,16,22,38,ㄔㄜ ㄌㄧㄤˋ,chē liàng
2864,車廂,5,5.交通、旅遊,16,9,25,ㄔㄜ ㄒㄧㄤ,chē xiāng
2865,沉/沈,5,核心詞,26,25,51,ㄔㄣˊ ,chén 
2866,沉默/沈默,5,16.情緒、態度,57,10,67,ㄔㄣˊ ㄇㄛˋ,chén mò
2867,陳述,5,8.教育、學習,21,3,24,ㄔㄣˊ ㄕㄨˋ,chén shù
2868,趁早,5,核心詞,3,1,4,ㄔㄣˋ ㄗㄠˇ,chèn zǎo
2869,沉重/沈重,5,核心詞,39,25,64,ㄔㄣˊ ㄓㄨㄥˋ,chén zhòng
2870,撐,5,核心詞,28,27,55,ㄔㄥ,chēng
2871,稱1,5,11.公共服務,188,76,264,ㄔㄥ,chēng
2872,成本,5,9.購物、商店,68,73,141,ㄔㄥˊ ㄅㄣˇ,chéng běn
2873,懲罰,5,12.安全,32,13,45,ㄔㄥˊ ㄈㄚˊ,chéng fá
2874,成分/成份,5,10.餐飲、烹飪,41,93,134,ㄔㄥˊ ㄈㄣˋ,chéng fèn
2875,稱呼,5,核心詞,25,11,36,ㄔㄥ ㄏㄨ,chēng hū
2876,成就感,5,核心詞,13,32,45,ㄔㄥˊ ㄐㄧㄡˋ ㄍㄢˇ,chéng jiù gǎn
2877,成名,5,4.休閒、娛樂,6,3,9,ㄔㄥˊ ㄇㄧㄥˊ,chéng míng
2878,承諾,5,核心詞,35,31,66,ㄔㄥˊ ㄋㄨㄛˋ,chéng nuò
2879,誠實,5,16.情緒、態度,31,13,44,ㄔㄥˊ ㄕˊ,chéng shí
2880,程式,5,3.職業,28,7,35,ㄔㄥˊ ㄕˋ,chéng shì
2881,成為,5,核心詞,534,390,924,ㄔㄥˊ ㄨㄟˊ,chéng wéi
2882,成效,5,8.教育、學習,20,16,36,ㄔㄥˊ ㄒㄧㄠˋ,chéng xiào
2883,成語,5,8.教育、學習,5,9,14,ㄔㄥˊ ㄩˇ,chéng yǔ
2884,成員,5,3.職業,85,53,138,ㄔㄥˊ ㄩㄢˊ,chéng yuán
2885,稱讚,5,6.社交、人際,26,7,33,ㄔㄥ ㄗㄢˋ,chēng zàn
2886,乘坐,5,5.交通、旅遊,8,3,11,ㄔㄥˊ ㄗㄨㄛˋ,chéng zuò
2887,持,5,核心詞,33,21,54,ㄔˊ,chí
2888,翅膀/翅,5,13.自然環境,38,17,55,ㄔˋ ㄅㄤˇ/ㄔˋ,chì bǎng/chì
2889,尺寸,5,9.購物、商店,13,13,26,ㄔˊ ˙ㄘㄨㄣ/ㄔˇ ㄘㄨㄣˋ,chí cun/chǐ cùn
2890,吃驚,5,16.情緒、態度,27,2,29,ㄔ ㄐㄧㄥ,chī jīng
2891,吃苦,5,核心詞,8,10,18,ㄔ ㄎㄨˇ,chī kǔ
2892,吃虧,5,核心詞,7,2,9,ㄔ ㄎㄨㄟ,chī kuī
2893,吃力,5,核心詞,11,10,21,ㄔ ㄌㄧˋ,chī lì
2894,遲早,5,核心詞,14,4,18,ㄔˊ ㄗㄠˇ,chí zǎo
2895,寵,5,16.情緒、態度,7,3,10,ㄔㄨㄥˇ,chǒng
2896,沖,5,10.餐飲、烹飪,15,25,40,ㄔㄨㄥ,chōng
2897,崇拜,5,16.情緒、態度,35,9,44,ㄔㄨㄥˊ ㄅㄞˋ,chóng bài
2898,衝動,5,16.情緒、態度,38,9,47,ㄔㄨㄥ ㄉㄨㄥˋ,chōng dòng
2899,充分/充份,5,核心詞,79,29,108,ㄔㄨㄥ ㄈㄣˋ ,chōng fèn 
2900,重複,5,8.教育、學習,77,30,107,ㄔㄨㄥˊ ㄈㄨˋ,chóng fù
2901,重覆,5,核心詞,7,4,11,ㄔㄨㄥˊ ㄈㄨˋ,chóng fù
2902,重建,5,5.交通、旅遊,25,58,83,ㄔㄨㄥˊ ㄐㄧㄢˋ,chóng jiàn
2903,充實,5,核心詞,21,13,34,ㄔㄨㄥ ㄕˊ,chōng shí
2904,重現,5,15.文化,10,8,18,ㄔㄨㄥˊ ㄒㄧㄢˋ,chóng xiàn
2905,重新,5,核心詞,169,161,330,ㄔㄨㄥˊ ㄒㄧㄣ,chóng xīn
2906,蟲子/蟲,5,13.自然環境,30,132,162,ㄔㄨㄥˊ ˙ㄗ/ㄔㄨㄥˊ,chóng zi/chóng
2907,重組,5,核心詞,10,5,15,ㄔㄨㄥˊ ㄗㄨˇ,chóng zǔ
2908,充足,5,5.交通、旅遊,13,23,36,ㄔㄨㄥ ㄗㄨˊ,chōng zú
2909,抽,5,核心詞,33,37,70,ㄔㄡ,chōu
2910,抽空,5,核心詞,4,3,7,ㄔㄡ ㄎㄨㄥˋ,chōu kòng
2911,抽屜,5,核心詞,21,11,32,ㄔㄡ ㄊㄧˋ,chōu tì
2912,抽象,5,8.教育、學習,23,5,28,ㄔㄡ ㄒㄧㄤˋ,chōu xiàng
2913,出版社,5,8.教育、學習,48,4,52,ㄔㄨ ㄅㄢˇ ㄕㄜˋ,chū bǎn shè
2914,出兵,5,12.安全,19,22,41,ㄔㄨ ㄅㄧㄥ,chū bīng
2915,初步,5,核心詞,14,17,31,ㄔㄨ ㄅㄨˋ,chū bù
2916,出差,5,3.職業,9,4,13,ㄔㄨ ㄔㄞ,chū chāi
2917,除此之外,5,核心詞,24,31,55,ㄔㄨˊ ㄘˇ ㄓ ㄨㄞˋ,chú cǐ zhī wài
2918,儲存,5,17.科技,24,30,54,ㄔㄨˊ ㄘㄨㄣˊ,chú cún
2919,出錯,5,核心詞,10,5,15,ㄔㄨ ㄘㄨㄛˋ,chū cuò
2920,處罰,5,12.安全,22,18,40,ㄔㄨˇ ㄈㄚˊ,chǔ fá
2921,處方,5,7.身體、醫療,22,4,26,ㄔㄨˇ ㄈㄤ,chǔ fāng
2922,出軌,5,12.安全,2,2,4,ㄔㄨ ㄍㄨㄟˇ,chū guǐ
2923,出海,5,5.交通、旅遊,8,9,17,ㄔㄨ ㄏㄞˇ,chū hǎi
2924,初級,5,8.教育、學習,4,2,6,ㄔㄨ ㄐㄧˊ,chū jí
2925,出境,5,12.安全,3,1,4,ㄔㄨ ㄐㄧㄥˋ,chū jìng
2926,出路,5,核心詞,12,11,23,ㄔㄨ ㄌㄨˋ,chū lù
2927,出名,5,核心詞,11,6,17,ㄔㄨ ㄇㄧㄥˊ,chū míng
2928,出色,5,核心詞,21,2,23,ㄔㄨ ㄙㄜˋ,chū sè
2929,出身,5,1.個人資料,45,17,62,ㄔㄨ ㄕㄣ,chū shēn
2930,出生率,5,14.社會,1,1,2,ㄔㄨ ㄕㄥ ㄌㄩˋ,chū shēng lǜ
2931,廚師,5,10.餐飲、烹飪,11,12,23,ㄔㄨˊ ㄕ,chú shī
2932,出手,5,4.休閒、娛樂,15,5,20,ㄔㄨ ㄕㄡˇ,chū shǒu
2933,除外,5,核心詞,4,0,4,ㄔㄨˊ ㄨㄞˋ,chú wài
2934,出外,5,核心詞,9,9,18,ㄔㄨ ㄨㄞˋ,chū wài
2935,出席,5,6.社交、人際,24,13,37,ㄔㄨ ㄒㄧˊ,chū xí
2936,出血,5,7.身體、醫療,10,7,17,ㄔㄨ ㄒㄧㄝˇ,chū xiě
2937,出自,5,核心詞,29,7,36,ㄔㄨ ㄗˋ,chū zì
2938,出走,5,核心詞,11,9,20,ㄔㄨ ㄗㄡˇ,chū zǒu
2939,串,5,核心詞,23,17,40,ㄔㄨㄢˋ,chuàn
2940,喘,5,7.身體、醫療,25,11,36,ㄔㄨㄢˇ,chuǎn
2941,傳播,5,8.教育、學習,38,29,67,ㄔㄨㄢˊ ㄅㄛˋ,chuán bò
2942,傳達,5,6.社交、人際,28,20,48,ㄔㄨㄢˊ ㄉㄚˊ,chuán dá
2943,傳教,5,15.文化,9,6,15,ㄔㄨㄢˊ ㄐㄧㄠˋ,chuán jiào
2944,傳奇,5,15.文化,23,10,33,ㄔㄨㄢˊ ㄑㄧˊ,chuán qí
2945,喘氣,5,7.身體、醫療,7,1,8,ㄔㄨㄢˇ ㄑㄧˋ,chuǎn qì
2946,傳染,5,7.身體、醫療,8,25,33,ㄔㄨㄢˊ ㄖㄢˇ,chuán rǎn
2947,傳送,5,17.科技,12,3,15,ㄔㄨㄢˊ ㄙㄨㄥˋ,chuán sòng
2948,穿越,5,5.交通、旅遊,21,15,36,ㄔㄨㄢ ㄩㄝˋ,chuān yuè
2949,船隻,5,5.交通、旅遊,14,16,30,ㄔㄨㄢˊ ㄓ,chuán zhī
2950,穿著,5,2.日常起居,44,15,59,ㄔㄨㄢ ㄓㄨㄛˊ,chuān zhuó
2951,闖,5,12.安全,12,5,17,ㄔㄨㄤˇ,chuǎng
2952,創辦,5,8.教育、學習,21,15,36,ㄔㄨㄤˋ ㄅㄢˋ,chuàng bàn
2953,床單,5,2.日常起居,7,2,9,ㄔㄨㄤˊ ㄉㄢ,chuáng dān
2954,創立,5,核心詞,24,17,41,ㄔㄨㄤˋ ㄌㄧˋ,chuàng lì
2955,創業,5,3.職業,34,26,60,ㄔㄨㄤˋ ㄧㄝˋ,chuàng yè
2956,創作,5,4.休閒、娛樂,78,68,146,ㄔㄨㄤˋ ㄗㄨㄛˋ,chuàng zuò
2957,吹牛,5,核心詞,6,4,10,ㄔㄨㄟ ㄋㄧㄡˊ,chuī niú
2958,純,5,核心詞,29,37,66,ㄔㄨㄣˊ,chún
2959,刺,5,10.餐飲、烹飪,32,16,48,ㄘˋ,cì
2960,此,5,核心詞,899,130,1029,ㄘˇ,cǐ
2961,此後,5,核心詞,23,2,25,ㄘˇ ㄏㄡˋ,cǐ hòu
2962,詞彙,5,8.教育、學習,15,1,16,ㄘˊ ㄏㄨㄟˋ,cí huì
2963,次女,5,核心詞,2,0,2,ㄘˋㄋㄩˇ,cì nǚ
2964,次數,5,核心詞,28,11,39,ㄘˋ ㄕㄨˋ,cì shù
2965,此外,5,核心詞,107,20,127,ㄘˇ ㄨㄞˋ,cǐ wài
2966,辭職,5,3.職業,18,7,25,ㄘˊ ㄓˊ,cí zhí
2967,次子,5,1.個人資料,7,1,8,ㄘˋ ㄗˇ,cì zǐ
2968,匆忙,5,核心詞,11,3,14,ㄘㄨㄥ ㄇㄤˊ,cōng máng
2969,從頭到尾,5,核心詞,12,8,20,ㄘㄨㄥˊ ㄊㄡˊ ㄉㄠˋ ㄨㄟˇ,cóng tóu dào wěi
2970,促使,5,核心詞,25,11,36,ㄘㄨˋ ㄕˇ,cù shǐ
2971,粗心,5,核心詞,5,3,8,ㄘㄨ ㄒㄧㄣ,cū xīn
2972,催,5,核心詞,17,18,35,ㄘㄨㄟ,cuī
2973,脆弱,5,7.身體、醫療,26,25,51,ㄘㄨㄟˋ ㄖㄨㄛˋ,cuì ruò
2974,吋,5,核心詞,10,6,16,ㄘㄨㄣˋ,cùn
2975,寸,5,9.購物、商店,21,13,34,ㄘㄨㄣˋ,cùn
2976,存款,5,11.公共服務,8,16,24,ㄘㄨㄣˊ ㄎㄨㄢˇ,cún kuǎn
2977,存在,5,核心詞,237,101,338,ㄘㄨㄣˊ ㄗㄞˋ,cún zài
2978,村子/村,5,核心詞,72,117,189,ㄘㄨㄣ ˙ㄗ/ㄘㄨㄣ,cūn zi/cūn
2979,錯過,5,核心詞,19,13,32,ㄘㄨㄛˋ ㄍㄨㄛˋ,cuò guò
2980,挫折,5,核心詞,62,43,105,ㄘㄨㄛˋ ㄓㄜˊ,cuò zhé
2981,打敗,5,4.休閒、娛樂,22,10,32,ㄉㄚˇ ㄅㄞˋ,dǎ bài
2982,大半,5,核心詞,18,12,30,ㄉㄚˋ ㄅㄢˋ,dà bàn
2983,大便,5,7.身體、醫療,12,6,18,ㄉㄚˋ ㄅㄧㄢˋ,dà biàn
2984,搭乘,5,5.交通、旅遊,15,15,30,ㄉㄚ ㄔㄥˊ,dā chéng
2985,大膽,5,16.情緒、態度,30,9,39,ㄉㄚˋ ㄉㄢˇ,dà dǎn
2986,大地,5,13.自然環境,38,61,99,ㄉㄚˋ ㄉㄧˋ,dà dì
2987,打動,5,16.情緒、態度,9,5,14,ㄉㄚˇ ㄉㄨㄥˋ,dǎ dòng
2988,打賭,5,核心詞,9,1,10,ㄉㄚˇ ㄉㄨˇ,dǎ dǔ
2989,打斷,5,核心詞,29,4,33,ㄉㄚˇ ㄉㄨㄢˋ,dǎ duàn
2990,大夫,5,7.身體、醫療,23,7,30,ㄉㄚˋ ㄈㄨ / ㄉㄞˋ ˙ㄈㄨ,dà fū / dài fu
2991,大會,5,14.社會,35,24,59,ㄉㄚˋ ㄏㄨㄟˋ,dà huì
2992,打擊,5,核心詞,47,34,81,ㄉㄚˇ ㄐㄧˊ,dǎ jí
2993,大街小巷,5,2.日常起居,4,6,10,ㄉㄚˋ ㄐㄧㄝ ㄒㄧㄠˇ ㄒㄧㄤˋ,dà jiē xiǎo xiàng
2994,打瞌睡,5,7.身體、醫療,5,5,10,ㄉㄚˇ ㄎㄜ ㄕㄨㄟˋ,dǎ kē shuì
2995,打獵,5,4.休閒、娛樂,21,6,27,ㄉㄚˇ ㄌㄧㄝˋ,dǎ liè
2996,大腦,5,7.身體、醫療,235,28,263,ㄉㄚˋ ㄋㄠˇ,dà nǎo
2997,大排長龍,5,5.交通、旅遊,2,6,8,ㄉㄚˋ ㄆㄞˊ ㄔㄤˊ ㄌㄨㄥˊ,dà pái cháng lóng
2998,搭配,5,核心詞,21,34,55,ㄉㄚ ㄆㄟˋ,dā pèi
2999,打破,5,12.安全,38,26,64,ㄉㄚˇ ㄆㄛˋ,dǎ pò
3000,打氣,5,16.情緒、態度,6,8,14,ㄉㄚˇ ㄑㄧˋ,dǎ qì
3001,大清早,5,核心詞,3,5,8,ㄉㄚˋ ㄑㄧㄥ ㄗㄠˇ,dà qīng zǎo
3002,大師,5,8.教育、學習,54,31,85,ㄉㄚˋ ㄕ,dà shī
3003,大王,5,核心詞,28,2,30,ㄉㄚˋ ㄨㄤˊ,dà wáng
3004,大象/象,5,13.自然環境,33,54,87,ㄉㄚˋ ㄒㄧㄤˋ/ㄒㄧㄤˋ,dà xiàng/xiàng
3005,大西洋,5,13.自然環境,6,8,14,ㄉㄚˋ ㄒㄧ ㄧㄤˊ,dà xī yáng
3006,打仗,5,14.社會,19,5,24,ㄉㄚˇ ㄓㄤˋ,dǎ zhàng
3007,大致,5,核心詞,27,7,34,ㄉㄚˋ ㄓˋ,dà zhì
3008,大眾,5,14.社會,78,45,123,ㄉㄚˋ ㄓㄨㄥˋ,dà zhòng
3009,待,5,核心詞,123,56,179,ㄉㄞˋ,dài
3010,呆,5,核心詞,15,7,22,ㄉㄞ,dāi
3011,逮捕,5,12.安全,27,12,39,ㄉㄞˋ ㄅㄨˇ,dài bǔ
3012,代溝,5,核心詞,2,1,3,ㄉㄞˋ ㄍㄡ,dài gōu
3013,代價,5,2.日常起居,36,26,62,ㄉㄞˋ ㄐㄧㄚˋ,dài jià
3014,代課,5,8.教育、學習,1,1,2,ㄉㄞˋ ㄎㄜˋ,dài kè
3015,貸款,5,11.公共服務,24,16,40,ㄉㄞˋ ㄎㄨㄢˇ,dài kuǎn
3016,代理,5,3.職業,19,3,22,ㄉㄞˋ ㄌㄧˇ,dài lǐ
3017,帶領,5,核心詞,45,46,91,ㄉㄞˋ ㄌㄧㄥˇ,dài lǐng
3018,帶路,5,核心詞,4,1,5,ㄉㄞˋ ㄌㄨˋ,dài lù
3019,代替,5,核心詞,23,23,46,ㄉㄞˋ ㄊㄧˋ,dài tì
3020,待遇,5,3.職業,22,9,31,ㄉㄞˋ ㄩˋ,dài yù
3021,膽,5,核心詞,18,10,28,ㄉㄢˇ,dǎn
3022,單,5,核心詞,37,36,73,ㄉㄢ,dān
3023,單獨,5,核心詞,36,9,45,ㄉㄢ ㄉㄨˊ,dān dú
3024,單價,5,9.購物、商店,1,3,4,ㄉㄢ ㄐㄧㄚˋ,dān jià
3025,單親,5,核心詞,6,11,17,ㄉㄢ ㄑㄧㄣ,dān qīn
3026,擔任,5,核心詞,125,68,193,ㄉㄢ ㄖㄣˋ,dān rèn
3027,單身,5,1.個人資料,12,4,16,ㄉㄢ ㄕㄣ,dān shēn
3028,誕生,5,1.個人資料,33,22,55,ㄉㄢˋ ㄕㄥ,dàn shēng
3029,單位,5,3.職業,82,70,152,ㄉㄢ ㄨㄟˋ,dān wèi
3030,耽誤,5,核心詞,6,4,10,ㄉㄢ ㄨˋ,dān wù
3031,膽小,5,核心詞,7,1,8,ㄉㄢˇ ㄒㄧㄠˇ,dǎn xiǎo
3032,單一,5,核心詞,32,20,52,ㄉㄢ ㄧ,dān yī
3033,擔憂,5,核心詞,27,15,42,ㄉㄢ ㄧㄡ,dān yōu
3034,但願,5,核心詞,14,5,19,ㄉㄢˋ ㄩㄢˋ,dàn yuàn
3035,膽子,5,16.情緒、態度,8,4,12,ㄉㄢˇ ˙ㄗ,dǎn zi
3036,當2,5,核心詞,1150,895,2045,ㄉㄤˋ,dàng
3037,擋,5,核心詞,16,16,32,ㄉㄤˇ,dǎng
3038,檔案,5,8.教育、學習,41,5,46,ㄉㄤˇ ㄢˋ,dǎng àn
3039,當兵,5,3.職業,7,11,18,ㄉㄤ ㄅㄧㄥ,dāng bīng
3040,當場,5,核心詞,26,10,36,ㄉㄤ ㄔㄤˊ,dāng cháng
3041,當代,5,8.教育、學習,36,10,46,ㄉㄤ ㄉㄞˋ,dāng dài
3042,當今,5,核心詞,17,5,22,ㄉㄤ ㄐㄧㄣ,dāng jīn
3043,當局,5,14.社會,18,22,40,ㄉㄤ ㄐㄩˊ,dāng jú
3044,當面,5,核心詞,11,4,15,ㄉㄤ ㄇㄧㄢˋ,dāng miàn
3045,當日,5,核心詞,10,1,11,ㄉㄤ ㄖˋ,dāng rì
3046,當心,5,核心詞,5,1,6,ㄉㄤ ㄒㄧㄣ,dāng xīn
3047,當選,5,14.社會,9,14,23,ㄉㄤ ㄒㄩㄢˇ,dāng xuǎn
3048,道2,5,核心詞,491,164,655,ㄉㄠˋ,dào
3049,道地,5,10.餐飲、烹飪,4,2,6,ㄉㄠˋ ㄉㄧˋ,dào dì
3050,禱告,5,15.文化,19,12,31,ㄉㄠˇ ㄍㄠˋ,dǎo gào
3051,倒楣,5,核心詞,13,10,23,ㄉㄠˇ ㄇㄟˊ,dǎo méi
3052,道歉,5,6.社交、人際,24,42,66,ㄉㄠˋ ㄑㄧㄢˋ,dào qiàn
3053,倒數,5,核心詞,5,6,11,ㄉㄠˋ ㄕㄨˇ,dào shǔ
3054,倒退,5,核心詞,6,3,9,ㄉㄠˋ ㄊㄨㄟˋ,dào tuì
3055,道謝,5,6.社交、人際,8,1,9,ㄉㄠˋ ㄒㄧㄝˋ,dào xiè
3056,得意,5,核心詞,32,4,36,ㄉㄜˊ ㄧˋ,dé yì
3057,得知,5,核心詞,51,16,67,ㄉㄜˊ ㄓ,dé zhī
3058,瞪,5,核心詞,33,5,38,ㄉㄥˋ,dèng
3059,等不及,5,核心詞,5,4,9,ㄉㄥˇ ㄅㄨˋ ㄐㄧˊ,děng bù jí
3060,燈光,5,2.日常起居,31,18,49,ㄉㄥ ㄍㄨㄤ,dēng guāng
3061,等候,5,核心詞,24,10,34,ㄉㄥˇ ㄏㄡˋ,děng hòu
3062,燈火,5,核心詞,9,4,13,ㄉㄥ ㄏㄨㄛˇ,dēng huǒ
3063,登記,5,2.日常起居,11,13,24,ㄉㄥ ㄐㄧˋ,dēng jì
3064,燈泡,5,核心詞,7,40,47,ㄉㄥ ㄆㄠˋ,dēng pào
3065,登山,5,4.休閒、娛樂,13,10,23,ㄉㄥ ㄕㄢ,dēng shān
3066,等於,5,核心詞,75,147,222,ㄉㄥˇ ㄩˊ,děng yú
3067,遞,5,核心詞,10,2,12,ㄉㄧˋ,dì
3068,滴,5,10.餐飲、烹飪,29,43,72,ㄉㄧ,dī
3069,地帶,5,5.交通、旅遊,17,9,26,ㄉㄧˋ ㄉㄞˋ,dì dài
3070,地瓜,5,10.餐飲、烹飪,7,58,65,ㄉㄧˋ ㄍㄨㄚ,dì guā
3071,低級,5,8.教育、學習,4,1,5,ㄉㄧ ㄐㄧˊ,dī jí
3072,抵抗,5,12.安全,27,13,40,ㄉㄧˇ ㄎㄤˋ,dǐ kàng
3073,低落,5,核心詞,17,6,23,ㄉㄧ ㄌㄨㄛˋ,dī luò
3074,敵人,5,12.安全,94,16,110,ㄉㄧˊ ㄖㄣˊ,dí rén
3075,低聲,5,核心詞,33,1,34,ㄉㄧ ㄕㄥ,dī shēng
3076,地形,5,5.交通、旅遊,15,68,83,ㄉㄧˋ ㄒㄧㄥˊ,dì xíng
3077,敵意,5,核心詞,23,3,26,ㄉㄧˊ ㄧˋ,dí yì
3078,弟子,5,15.文化,26,17,43,ㄉㄧˋ ㄗˇ,dì zǐ
3079,電動,5,核心詞,8,28,36,ㄉㄧㄢˋ ㄉㄨㄥˋ,diàn dòng
3080,典範,5,8.教育、學習,25,26,51,ㄉㄧㄢˇ ㄈㄢˋ,diǎn fàn
3081,點名,5,8.教育、學習,4,3,7,ㄉㄧㄢˇ ㄇㄧㄥˊ,diǎn míng
3082,電線,5,17.科技,8,11,19,ㄉㄧㄢˋ ㄒㄧㄢˋ,diàn xiàn
3083,電信,5,17.科技,6,2,8,ㄉㄧㄢˋ ㄒㄧㄣˋ,diàn xìn
3084,點子,5,核心詞,31,12,43,ㄉㄧㄢˇ ˙ㄗ,diǎn zi
3085,調2,5,核心詞,23,35,58,ㄉㄧㄠˋ,diào
3086,釣,5,4.休閒、娛樂,7,7,14,ㄉㄧㄠˋ,diào
3087,掉落,5,核心詞,11,7,18,ㄉㄧㄠˋ ㄌㄨㄛˋ,diào luò
3088,碟,5,10.餐飲、烹飪,4,2,6,ㄉㄧㄝˊ,dié
3089,跌,5,核心詞,14,7,21,ㄉㄧㄝˊ,dié
3090,跌倒,5,7.身體、醫療,15,28,43,ㄉㄧㄝˊ ㄉㄠˇ,dié dǎo
3091,頂,5,核心詞,66,45,111,ㄉㄧㄥˇ,dǐng
3092,叮,5,2.日常起居,5,12,17,ㄉㄧㄥ,dīng
3093,盯,5,核心詞,61,16,77,ㄉㄧㄥ,dīng
3094,訂單,5,9.購物、商店,12,13,25,ㄉㄧㄥˋ ㄉㄢ,dìng dān
3095,頂多,5,核心詞,15,12,27,ㄉㄧㄥˇ ㄉㄨㄛ,dǐng duō
3096,頂樓,5,2.日常起居,4,7,11,ㄉㄧㄥˇ ㄌㄡˊ,dǐng lóu
3097,定期,5,核心詞,22,24,46,ㄉㄧㄥˋ ㄑㄧˊ,dìng qí
3098,定時,5,核心詞,8,11,19,ㄉㄧㄥˋ ㄕˊ,dìng shí
3099,定義,5,8.教育、學習,58,31,89,ㄉㄧㄥˋ ㄧˋ,dìng yì
3100,訂製,5,9.購物、商店,4,2,6,ㄉㄧㄥˋ ㄓˋ,dìng zhì
3101,丟臉,5,16.情緒、態度,11,10,21,ㄉㄧㄡ ㄌㄧㄢˇ,diū liǎn
3102,凍,5,10.餐飲、烹飪,8,12,20,ㄉㄨㄥˋ,dòng
3103,動不動,5,核心詞,8,5,13,ㄉㄨㄥˋ ㄅㄨˊ ㄉㄨㄥˋ,dòng bú dòng
3104,動畫,5,4.休閒、娛樂,7,6,13,ㄉㄨㄥˋ ㄏㄨㄚˋ,dòng huà
3105,動機,5,核心詞,60,19,79,ㄉㄨㄥˋ ㄐㄧ,dòng jī
3106,動力,5,核心詞,36,41,77,ㄉㄨㄥˋ ㄌㄧˋ,dòng lì
3107,動人,5,核心詞,22,13,35,ㄉㄨㄥˋ ㄖㄣˊ,dòng rén
3108,動身,5,核心詞,8,1,9,ㄉㄨㄥˋ ㄕㄣ,dòng shēn
3109,懂事,5,核心詞,10,16,26,ㄉㄨㄥˇ ㄕˋ,dǒng shì
3110,動手,5,核心詞,34,28,62,ㄉㄨㄥˋ ㄕㄡˇ,dòng shǒu
3111,動聽,5,核心詞,6,1,7,ㄉㄨㄥˋ ㄊㄧㄥ,dòng tīng
3112,賭,5,4.休閒、娛樂,18,10,28,ㄉㄨˇ,dǔ
3113,賭博,5,4.休閒、娛樂,11,11,22,ㄉㄨˇ ㄅㄛˊ,dǔ bó
3114,賭場,5,5.交通、旅遊,9,8,17,ㄉㄨˇ ㄔㄤˊ,dǔ cháng
3115,堵車,5,5.交通、旅遊,1,1,2,ㄉㄨˇ ㄔㄜ,dǔ chē
3116,堵塞,5,7.身體、醫療,4,5,9,ㄉㄨˇ ㄙㄜˋ,dǔ sè
3117,獨特,5,核心詞,50,35,85,ㄉㄨˊ ㄊㄜˋ,dú tè
3118,毒藥,5,7.身體、醫療,10,3,13,ㄉㄨˊ ㄧㄠˋ,dú yào
3119,獨自,5,核心詞,44,10,54,ㄉㄨˊ ㄗˋ,dú zì
3120,獨子,5,1.個人資料,3,5,8,ㄉㄨˊ ㄗˇ,dú zǐ
3121,斷,5,核心詞,38,41,79,ㄉㄨㄢˋ,duàn
3122,短處,5,核心詞,5,0,5,ㄉㄨㄢˇ ㄔㄨˋ,duǎn chù
3123,段落,5,8.教育、學習,9,4,13,ㄉㄨㄢˋ ㄌㄨㄛˋ,duàn luò
3124,短暫,5,核心詞,30,18,48,ㄉㄨㄢˇ ㄓㄢˋ,duǎn zhàn
3125,對比,5,核心詞,18,8,26,ㄉㄨㄟˋ ㄅㄧˇ,duì bǐ
3126,對付,5,12.安全,33,7,40,ㄉㄨㄟˋ ˙ㄈㄨ,duì fu
3127,對抗,5,14.社會,49,43,92,ㄉㄨㄟˋ ㄎㄤˋ,duì kàng
3128,對立,5,8.教育、學習,27,19,46,ㄉㄨㄟˋ ㄌㄧˋ,duì lì
3129,隊伍,5,4.休閒、娛樂,29,20,49,ㄉㄨㄟˋ ㄨˇ,duì wǔ
3130,對於,5,核心詞,357,443,800,ㄉㄨㄟˋ ㄩˊ,duì yú
3131,蹲,5,核心詞,25,14,39,ㄉㄨㄣ,dūn
3132,墮胎,5,14.社會,6,1,7,ㄉㄨㄛˋ ㄊㄞ,duò tāi
3133,多餘,5,核心詞,15,17,32,ㄉㄨㄛ ㄩˊ,duō yú
3134,多元,5,核心詞,32,23,55,ㄉㄨㄛ ㄩㄢˊ,duō yuán
3135,鵝,5,13.自然環境,12,6,18,ㄜˊ,é
3136,惡化,5,7.身體、醫療,24,28,52,ㄜˋ ㄏㄨㄚˋ,è huà
3137,惡劣,5,核心詞,19,22,41,ㄜˋ ㄌㄧㄝˋ,è liè
3138,惡夢,5,2.日常起居,10,6,16,ㄜˋ ㄇㄥˋ,è mèng
3139,額頭,5,7.身體、醫療,18,4,22,ㄜˊ ˙ㄊㄡ,é tou
3140,額外,5,核心詞,17,11,28,ㄜˊ ㄨㄞˋ,é wài
3141,噁心,5,7.身體、醫療,13,10,23,ㄜˇ ㄒㄧㄣ,ě xīn
3142,而,5,核心詞,3445,1656,5101,ㄦˊ,ér
3143,耳環,5,9.購物、商店,5,2,7,ㄦˇ ㄏㄨㄢˊ,ěr huán
3144,兒時,5,核心詞,7,4,11,ㄦˊ ㄕˊ,ér shí
3145,罰,5,12.安全,18,13,31,ㄈㄚˊ,fá
3146,發達,5,8.教育、學習,23,30,53,ㄈㄚ ㄉㄚˊ,fā dá
3147,發呆,5,核心詞,6,5,11,ㄈㄚ ㄉㄞ,fā dāi
3148,發動,5,12.安全,47,39,86,ㄈㄚ ㄉㄨㄥˋ,fā dòng
3149,發抖,5,核心詞,19,5,24,ㄈㄚ ㄉㄡˇ,fā dǒu
3150,發瘋,5,核心詞,12,5,17,ㄈㄚ ㄈㄥ,fā fēng
3151,法官,5,12.安全,25,7,32,ㄈㄚˇ ㄍㄨㄢ,fǎ guān
3152,發揮,5,核心詞,94,82,176,ㄈㄚ ㄏㄨㄟ,fā huī
3153,發覺,5,核心詞,30,38,68,ㄈㄚ ㄐㄩㄝˊ,fā jué
3154,罰款,5,12.安全,4,3,7,ㄈㄚˊ ㄎㄨㄢˇ,fá kuǎn
3155,發脾氣,5,核心詞,15,14,29,ㄈㄚ ㄆㄧˊ ㄑㄧˋ,fā pí qì
3156,發起,5,14.社會,14,25,39,ㄈㄚ ㄑㄧˇ,fā qǐ
3157,發誓,5,16.情緒、態度,21,6,27,ㄈㄚ ㄕˋ,fā shì
3158,法庭,5,12.安全,24,5,29,ㄈㄚˇ ㄊㄧㄥˊ,fǎ tíng
3159,發問,5,核心詞,10,2,12,ㄈㄚ ㄨㄣˋ,fā wèn
3160,發行,5,8.教育、學習,25,10,35,ㄈㄚ ㄒㄧㄥˊ,fā xíng
3161,發言,5,8.教育、學習,19,6,25,ㄈㄚ ㄧㄢˊ,fā yán
3162,發育,5,7.身體、醫療,21,22,43,ㄈㄚ ㄩˋ,fā yù
3163,法院,5,12.安全,21,16,37,ㄈㄚˇ ㄩㄢˋ,fǎ yuàn
3164,法子,5,核心詞,8,2,10,ㄈㄚˊ ˙ㄗ,fá zi
3165,番,5,核心詞,114,28,142,ㄈㄢ,fān
3166,反駁,5,8.教育、學習,21,1,22,ㄈㄢˇ ㄅㄛˊ,fǎn bó
3167,犯錯,5,核心詞,20,11,31,ㄈㄢˋ ㄘㄨㄛˋ,fàn cuò
3168,反而,5,核心詞,158,157,315,ㄈㄢˇ ㄦˊ,fǎn ér
3169,犯法,5,12.安全,5,1,6,ㄈㄢˋ ㄈㄚˇ,fàn fǎ
3170,犯規,5,12.安全,3,1,4,ㄈㄢˋ ㄍㄨㄟ,fàn guī
3171,返回,5,核心詞,33,8,41,ㄈㄢˇ ㄏㄨㄟˊ,fǎn huí
3172,反抗,5,14.社會,29,37,66,ㄈㄢˇ ㄎㄤˋ,fǎn kàng
3173,翻臉,5,16.情緒、態度,4,1,5,ㄈㄢ ㄌㄧㄢˇ,fān liǎn
3174,販賣,5,9.購物、商店,12,13,25,ㄈㄢˋ ㄇㄞˋ,fàn mài
3175,反面,5,核心詞,11,1,12,ㄈㄢˇ ㄇㄧㄢˋ,fǎn miàn
3176,煩人,5,核心詞,4,1,5,ㄈㄢˊ ㄖㄣˊ,fán rén
3177,繁榮,5,14.社會,17,14,31,ㄈㄢˊ ㄖㄨㄥˊ,fán róng
3178,凡事,5,核心詞,22,13,35,ㄈㄢˊ ㄕˋ,fán shì
3179,反省,5,核心詞,22,40,62,ㄈㄢˇ ㄒㄧㄥˇ,fǎn xǐng
3180,反映,5,核心詞,48,13,61,ㄈㄢˇ ㄧㄥˋ,fǎn yìng
3181,仿冒,5,9.購物、商店,2,2,4,ㄈㄤˇ ㄇㄠˋ,fǎng mào
3182,放屁,5,7.身體、醫療,4,9,13,ㄈㄤˋ ㄆㄧˋ,fàng pì
3183,防守,5,4.休閒、娛樂,16,3,19,ㄈㄤˊ ㄕㄡˇ,fáng shǒu
3184,放手,5,核心詞,18,12,30,ㄈㄤˋ ㄕㄡˇ,fàng shǒu
3185,訪談,5,8.教育、學習,27,5,32,ㄈㄤˇ ㄊㄢˊ,fǎng tán
3186,方言,5,8.教育、學習,7,2,9,ㄈㄤ ㄧㄢˊ,fāng yán
3187,防止,5,12.安全,29,38,67,ㄈㄤˊ ㄓˇ,fáng zhǐ
3188,肥,5,10.餐飲、烹飪,17,58,75,ㄈㄟˊ,féi
3189,肺,5,7.身體、醫療,26,15,41,ㄈㄟˋ,fèi
3190,非,5,核心詞,381,128,509,ㄈㄟ,fēi
3191,非法,5,12.安全,9,19,28,ㄈㄟ ㄈㄚˇ,fēi fǎ
3192,廢話,5,核心詞,5,2,7,ㄈㄟˋ ㄏㄨㄚˋ,fèi huà
3193,飛快,5,核心詞,16,1,17,ㄈㄟ ㄎㄨㄞˋ,fēi kuài
3194,費力,5,核心詞,12,4,16,ㄈㄟˋ ㄌㄧˋ,fèi lì
3195,廢氣,5,13.自然環境,3,7,10,ㄈㄟˋ ㄑㄧˋ,fèi qì
3196,費時,5,核心詞,5,4,9,ㄈㄟˋ ㄕˊ,fèi shí
3197,廢水,5,14.社會,1,25,26,ㄈㄟˋ ㄕㄨㄟˇ,fèi shuǐ
3198,飛行,5,5.交通、旅遊,26,15,41,ㄈㄟ ㄒㄧㄥˊ,fēi xíng
3199,分辨,5,核心詞,23,17,40,ㄈㄣ ㄅㄧㄢˋ,fēn biàn
3200,紛紛,5,核心詞,53,47,100,ㄈㄣ ㄈㄣ,fēn fēn
3201,吩咐,5,核心詞,27,1,28,ㄈㄣ ㄈㄨˋ,fēn fù
3202,分類,5,核心詞,30,48,78,ㄈㄣ ㄌㄟˋ,fēn lèi
3203,分離,5,核心詞,24,18,42,ㄈㄣ ㄌㄧˊ,fēn lí
3204,分裂,5,14.社會,28,15,43,ㄈㄣ ㄌㄧㄝˋ,fēn liè
3205,憤怒,5,16.情緒、態度,68,12,80,ㄈㄣˋ ㄋㄨˋ,fèn nù
3206,分配,5,3.職業,26,26,52,ㄈㄣ ㄆㄟˋ,fēn pèi
3207,分散,5,核心詞,17,13,30,ㄈㄣ ㄙㄢˋ,fēn sàn
3208,粉絲,5,4.休閒、娛樂,3,3,6,ㄈㄣˇ ㄙ,fěn sī
3209,分析,5,8.教育、學習,175,83,258,ㄈㄣ ㄒㄧ,fēn xī
3210,縫1,5,7.身體、醫療,17,20,37,ㄈㄥˊ,féng
3211,逢,5,15.文化,22,13,35,ㄈㄥˊ,féng
3212,封閉,5,2.日常起居,19,21,40,ㄈㄥ ㄅㄧˋ,fēng bì
3213,諷刺,5,16.情緒、態度,28,7,35,ㄈㄥˋ ㄘˋ,fèng cì
3214,瘋狂,5,12.安全,44,8,52,ㄈㄥ ㄎㄨㄤˊ,fēng kuáng
3215,蜂蜜,5,10.餐飲、烹飪,8,6,14,ㄈㄥ ㄇㄧˋ,fēng mì
3216,封面,5,4.休閒、娛樂,13,24,37,ㄈㄥ ㄇㄧㄢˋ,fēng miàn
3217,風氣,5,核心詞,19,9,28,ㄈㄥ ㄑㄧˋ,fēng qì
3218,風趣,5,1.個人資料,6,2,8,ㄈㄥ ㄑㄩˋ,fēng qù
3219,風水,5,15.文化,23,3,26,ㄈㄥ ㄕㄨㄟˇ,fēng shuǐ
3220,風俗,5,15.文化,14,4,18,ㄈㄥ ㄙㄨˊ,fēng sú
3221,風險,5,核心詞,79,46,125,ㄈㄥ ㄒㄧㄢˇ,fēng xiǎn
3222,瘋子,5,12.安全,13,2,15,ㄈㄥ ˙ㄗ,fēng zi
3223,佛,5,1.個人資料,48,59,107,ㄈㄛˊ,fó
3224,佛教,5,1.個人資料,28,99,127,ㄈㄛˊ ㄐㄧㄠˋ,fó jiào
3225,否定,5,核心詞,29,3,32,ㄈㄡˇ ㄉㄧㄥˋ,fǒu dìng
3226,否認,5,核心詞,33,10,43,ㄈㄡˇ ㄖㄣˋ,fǒu rèn
3227,扶,5,核心詞,29,25,54,ㄈㄨˊ,fú
3228,浮,5,核心詞,9,14,23,ㄈㄨˊ,fú
3229,副,5,核心詞,72,16,88,ㄈㄨˋ,fù
3230,腹,5,7.身體、醫療,18,8,26,ㄈㄨˋ,fù
3231,負,5,核心詞,24,17,41,ㄈㄨˋ,fù
3232,副本,5,11.公共服務,3,1,4,ㄈㄨˋ ㄅㄣˇ,fù běn
3233,服從,5,16.情緒、態度,22,4,26,ㄈㄨˊ ㄘㄨㄥˊ,fú cóng
3234,負擔,5,核心詞,46,68,114,ㄈㄨˋ ㄉㄢ,fù dān
3235,輔導,5,8.教育、學習,28,38,66,ㄈㄨˇ ㄉㄠˇ,fǔ dǎo
3236,符號,5,8.教育、學習,23,8,31,ㄈㄨˊ ㄏㄠˋ,fú hào
3237,符合,5,核心詞,70,55,125,ㄈㄨˊ ㄏㄜˊ,fú hé
3238,負面,5,核心詞,62,28,90,ㄈㄨˋ ㄇㄧㄢˋ,fù miàn
3239,福氣,5,核心詞,9,9,18,ㄈㄨˊ ㄑㄧˋ,fú qì
3240,婦人,5,核心詞,28,4,32,ㄈㄨˋ ㄖㄣˊ,fù rén
3241,夫人,5,核心詞,211,28,239,ㄈㄨ ㄖㄣˊ,fū rén
3242,膚色,5,7.身體、醫療,9,4,13,ㄈㄨ ㄙㄜˋ,fū sè
3243,扶手,5,核心詞,5,1,6,ㄈㄨˊ ㄕㄡˇ,fú shǒu
3244,服務業,5,3.職業,8,8,16,ㄈㄨˊ ㄨˋ ㄧㄝˋ,fú wù yè
3245,富有,5,1.個人資料,26,8,34,ㄈㄨˋ ㄧㄡˇ,fù yǒu
3246,富裕,5,3.職業,29,16,45,ㄈㄨˋ ㄩˋ,fù yù
3247,復原,5,7.身體、醫療,20,12,32,ㄈㄨˋ ㄩㄢˊ,fù yuán
3248,複製,5,17.科技,21,11,32,ㄈㄨˋ ㄓˋ,fù zhì
3249,副總統,5,14.社會,7,6,13,ㄈㄨˋ ㄗㄨㄥˇ ㄊㄨㄥˇ,fù zǒng tǒng
3250,改編,5,4.休閒、娛樂,19,2,21,ㄍㄞˇ ㄅㄧㄢ,gǎi biān
3251,改革,5,14.社會,69,37,106,ㄍㄞˇ ㄍㄜˊ,gǎi gé
3252,改進,5,核心詞,28,12,40,ㄍㄞˇ ㄐㄧㄣˋ,gǎi jìn
3253,概況,5,核心詞,2,1,3,ㄍㄞˋ ㄎㄨㄤˋ,gài kuàng
3254,改造,5,14.社會,26,43,69,ㄍㄞˇ ㄗㄠˋ,gǎi zào
3255,蓋章,5,核心詞,2,2,4,ㄍㄞˋ ㄓㄤ,gài zhāng
3256,幹,5,核心詞,83,24,107,ㄍㄢˋ,gàn
3257,肝,5,7.身體、醫療,25,30,55,ㄍㄢ,gān
3258,幹部,5,3.職業,25,7,32,ㄍㄢˋ ㄅㄨˋ,gàn bù
3259,乾脆,5,核心詞,34,25,59,ㄍㄢ ㄘㄨㄟˋ,gān cuì
3260,感恩,5,核心詞,20,202,222,ㄍㄢˇ ㄣ,gǎn ēn
3261,尷尬,5,16.情緒、態度,30,10,40,ㄍㄢ ㄍㄚˋ  ,gān gà 
3262,感激,5,核心詞,41,12,53,ㄍㄢˇ ㄐㄧ,gǎn jī
3263,趕忙,5,核心詞,14,2,16,ㄍㄢˇ ㄇㄤˊ,gǎn máng
3264,感染,5,7.身體、醫療,44,88,132,ㄍㄢˇ ㄖㄢˇ,gǎn rǎn
3265,干擾,5,核心詞,35,26,61,ㄍㄢ ㄖㄠˇ,gān rǎo
3266,感人,5,16.情緒、態度,10,12,22,ㄍㄢˇ ㄖㄣˊ,gǎn rén
3267,感受,5,核心詞,116,151,267,ㄍㄢˇ ㄕㄡˋ,gǎn shòu
3268,感想,5,8.教育、學習,10,10,20,ㄍㄢˇ ㄒㄧㄤˇ,gǎn xiǎng
3269,港口/港,5,5.交通、旅遊,29,33,62,ㄍㄤˇ ㄎㄡˇ/ㄍㄤˇ,gǎng kǒu/gǎng
3270,告,5,12.安全,29,9,38,ㄍㄠˋ,gào
3271,搞,5,核心詞,95,50,145,ㄍㄠˇ,gǎo
3272,告白,5,6.社交、人際,4,1,5,ㄍㄠˋ ㄅㄞˊ,gào bái
3273,告別,5,6.社交、人際,17,13,30,ㄍㄠˋ ㄅㄧㄝˊ,gào bié
3274,搞不好,5,核心詞,8,18,26,ㄍㄠˇ ㄅㄨˋ ㄏㄠˇ,gǎo bù hǎo
3275,高層,5,3.職業,22,10,32,ㄍㄠ ㄘㄥˊ,gāo céng
3276,高等,5,8.教育、學習,17,10,27,ㄍㄠ ㄉㄥˇ,gāo děng
3277,搞定,5,核心詞,6,3,9,ㄍㄠˇ ㄉㄧㄥˋ,gǎo dìng
3278,高爾夫球,5,4.休閒、娛樂,8,1,9,ㄍㄠ ㄦˇ ㄈㄨ ㄑㄧㄡˊ,gāo ěr fū qiú
3279,高跟鞋,5,9.購物、商店,5,7,12,ㄍㄠ ㄍㄣ ㄒㄧㄝˊ,gāo gēn xié
3280,高貴,5,16.情緒、態度,16,3,19,ㄍㄠ ㄍㄨㄟˋ,gāo guì
3281,高階,5,3.職業,18,7,25,ㄍㄠ ㄐㄧㄝ,gāo jiē
3282,高明,5,核心詞,20,4,24,ㄍㄠ ㄇㄧㄥˊ,gāo míng
3283,高手,5,3.職業,41,10,51,ㄍㄠ ㄕㄡˇ,gāo shǒu
3284,告知,5,核心詞,23,7,30,ㄍㄠˋ ㄓ,gào zhī
3285,格,5,4.休閒、娛樂,20,31,51,ㄍㄜˊ,gé
3286,隔,5,核心詞,42,35,77,ㄍㄜˊ,gé
3287,割,5,10.餐飲、烹飪,18,51,69,ㄍㄜ,gē
3288,個別,5,核心詞,32,7,39,ㄍㄜˋ ㄅㄧㄝˊ,gè bié
3289,各行各業,5,3.職業,5,5,10,ㄍㄜˋ ㄏㄤˊ ㄍㄜˋ ㄧㄝˋ,gè háng gè yè
3290,革命,5,14.社會,81,38,119,ㄍㄜˊ ㄇㄧㄥˋ,gé mìng
3291,歌曲,5,4.休閒、娛樂,20,17,37,ㄍㄜ ㄑㄩˇ,gē qǔ
3292,隔天,5,核心詞,30,26,56,ㄍㄜˊ ㄊㄧㄢ,gé tiān
3293,格外,5,核心詞,19,13,32,ㄍㄜˊ ㄨㄞˋ,gé wài
3294,歌星,5,4.休閒、娛樂,5,2,7,ㄍㄜ ㄒㄧㄥ,gē xīng
3295,跟隨,5,核心詞,27,13,40,ㄍㄣ ㄙㄨㄟˊ,gēn suí
3296,根源,5,核心詞,17,5,22,ㄍㄣ ㄩㄢˊ,gēn yuán
3297,更改,5,核心詞,8,5,13,ㄍㄥ ㄍㄞˇ,gēng gǎi
3298,更換,5,核心詞,12,10,22,ㄍㄥ ㄏㄨㄢˋ,gēng huàn
3299,更加,5,核心詞,103,94,197,ㄍㄥˋ ㄐㄧㄚ,gèng jiā
3300,公布/公佈,5,8.教育、學習,19,37,56,ㄍㄨㄥ ㄅㄨˋ ,gōng bù 
3301,工程,5,3.職業,57,82,139,ㄍㄨㄥ ㄔㄥˊ,gōng chéng
3302,攻打,5,12.安全,26,13,39,ㄍㄨㄥ ㄉㄚˇ,gōng dǎ
3303,工夫,5,核心詞,23,5,28,ㄍㄨㄥ ㄈㄨ/ㄍㄨㄥ ˙ㄈㄨ,gōng fū/gōng fu
3304,公公,5,1.個人資料,9,21,30,ㄍㄨㄥ ˙ㄍㄨㄥ,gōng gong
3305,攻擊,5,12.安全,116,138,254,ㄍㄨㄥ ㄐㄧˊ,gōng jí
3306,供給,5,3.職業,10,8,18,ㄍㄨㄥ ㄐㄧˇ,gōng jǐ
3307,公克,5,核心詞,9,13,22,ㄍㄨㄥ ㄎㄜˋ,gōng kè
3308,功勞,5,14.社會,18,4,22,ㄍㄨㄥ ㄌㄠˊ,gōng láo
3309,公立,5,8.教育、學習,9,7,16,ㄍㄨㄥ ㄌㄧˋ,gōng lì
3310,公民,5,14.社會,20,22,42,ㄍㄨㄥ ㄇㄧㄣˊ,gōng mín
3311,公升,5,核心詞,5,22,27,ㄍㄨㄥ ㄕㄥ,gōng shēng
3312,公事,5,14.社會,10,3,13,ㄍㄨㄥ ㄕˋ,gōng shì
3313,貢獻,5,8.教育、學習,66,49,115,ㄍㄨㄥˋ ㄒㄧㄢˋ,gòng xiàn
3314,功效,5,7.身體、醫療,22,19,41,ㄍㄨㄥ ㄒㄧㄠˋ,gōng xiào
3315,供應,5,3.職業,39,39,78,ㄍㄨㄥ ㄧㄥˋ,gōng yìng
3316,功用,5,核心詞,7,12,19,ㄍㄨㄥ ㄩㄥˋ,gōng yòng
3317,公眾,5,14.社會,17,5,22,ㄍㄨㄥ ㄓㄨㄥˋ,gōng zhòng
3318,公主,5,15.文化,72,7,79,ㄍㄨㄥ ㄓㄨˇ,gōng zhǔ
3319,工資,5,3.職業,13,12,25,ㄍㄨㄥ ㄗ,gōng zī
3320,構成,5,核心詞,44,16,60,ㄍㄡˋ ㄔㄥˊ,gòu chéng
3321,構想,5,核心詞,22,10,32,ㄍㄡˋ ㄒㄧㄤˇ,gòu xiǎng
3322,構造,5,7.身體、醫療,16,21,37,ㄍㄡˋ ㄗㄠˋ,gòu zào
3323,鼓,5,4.休閒、娛樂,13,19,32,ㄍㄨˇ,gǔ
3324,孤單,5,核心詞,16,16,32,ㄍㄨ ㄉㄢ,gū dān
3325,古典,5,4.休閒、娛樂,27,14,41,ㄍㄨˇ ㄉㄧㄢˇ,gǔ diǎn
3326,古典樂,5,4.休閒、娛樂,1,1,2,ㄍㄨˇ ㄉㄧㄢˇ ㄩㄝˋ,gǔ diǎn yuè
3327,孤獨,5,16.情緒、態度,29,16,45,ㄍㄨ ㄉㄨˊ,gū dú
3328,孤兒,5,核心詞,24,14,38,ㄍㄨ ㄦˊ,gū ér
3329,古怪,5,核心詞,20,1,21,ㄍㄨˇ ㄍㄨㄞˋ,gǔ guài
3330,估計,5,5.交通、旅遊,27,45,72,ㄍㄨ ㄐㄧˋ,gū jì
3331,古跡/古蹟,5,5.交通、旅遊,7,26,33,ㄍㄨˇ ㄐㄧ  ,gǔ jī  
3332,古老,5,15.文化,41,37,78,ㄍㄨˇ ㄌㄠˇ,gǔ lǎo
3333,姑娘,5,核心詞,161,6,167,ㄍㄨ ㄋㄧㄤˊ / ㄍㄨ ˙ㄋㄧㄤ,gū niáng / gū niang
3334,股票,5,14.社會,49,7,56,ㄍㄨˇ ㄆㄧㄠˋ,gǔ piào
3335,古人,5,15.文化,27,20,47,ㄍㄨˇ ㄖㄣˊ,gǔ rén
3336,股市,5,14.社會,24,9,33,ㄍㄨˇ ㄕˋ,gǔ shì
3337,骨頭/骨,5,7.身體、醫療,47,62,109,ㄍㄨˊ ˙ㄊㄡ / ㄍㄨˇ,gú tou / gǔ
3338,顧問,5,3.職業,43,5,48,ㄍㄨˋ ㄨㄣˋ,gù wèn
3339,故障,5,11.公共服務,7,6,13,ㄍㄨˋ ㄓㄤˋ,gù zhàng
3340,姑丈,5,1.個人資料,1,1,2,ㄍㄨ ㄓㄤˋ,gū zhàng
3341,刮,5,核心詞,13,13,26,ㄍㄨㄚ,guā
3342,怪獸,5,4.休閒、娛樂,21,1,22,ㄍㄨㄞˋ ㄕㄡˋ,guài shòu
3343,關閉,5,核心詞,14,28,42,ㄍㄨㄢ ㄅㄧˋ,guān bì
3344,觀察,5,核心詞,167,186,353,ㄍㄨㄢ ㄔㄚˊ,guān chá
3345,管道,5,8.教育、學習,31,26,57,ㄍㄨㄢˇ ㄉㄠˋ,guǎn dào
3346,觀點,5,8.教育、學習,124,79,203,ㄍㄨㄢ ㄉㄧㄢˇ,guān diǎn
3347,關懷,5,核心詞,37,149,186,ㄍㄨㄢ ㄏㄨㄞˊ,guān huái
3348,關鍵,5,核心詞,107,70,177,ㄍㄨㄢ ㄐㄧㄢˋ,guān jiàn
3349,冠軍,5,4.休閒、娛樂,18,12,30,ㄍㄨㄢˋ ㄐㄩㄣ,guàn jūn
3350,觀看,5,4.休閒、娛樂,33,4,37,ㄍㄨㄢ ㄎㄢˋ,guān kàn
3351,關聯,5,核心詞,35,11,46,ㄍㄨㄢ ㄌㄧㄢˊ,guān lián
3352,觀賞,5,4.休閒、娛樂,18,19,37,ㄍㄨㄢ ㄕㄤˇ,guān shǎng
3353,罐頭,5,10.餐飲、烹飪,9,4,13,ㄍㄨㄢˋ ˙ㄊㄡ,guàn tou
3354,關注,5,核心詞,37,74,111,ㄍㄨㄢ ㄓㄨˋ,guān zhù
3355,管子,5,2.日常起居,8,10,18,ㄍㄨㄢˇ ˙ㄗ,guǎn zi
3356,廣,5,核心詞,46,27,73,ㄍㄨㄤˇ,guǎng
3357,廣播,5,4.休閒、娛樂,24,22,46,ㄍㄨㄤˇ ㄅㄛˋ,guǎng bò
3358,廣場,5,2.日常起居,27,32,59,ㄍㄨㄤˇ ㄔㄤˇ,guǎng chǎng
3359,廣大,5,核心詞,24,13,37,ㄍㄨㄤˇ ㄉㄚˋ,guǎng dà
3360,廣泛,5,8.教育、學習,38,18,56,ㄍㄨㄤˇ ㄈㄢˋ,guǎng fàn
3361,光臨,5,9.購物、商店,7,5,12,ㄍㄨㄤ ㄌㄧㄣˊ,guāng lín
3362,光芒,5,核心詞,23,9,32,ㄍㄨㄤ ㄇㄤˊ,guāng máng
3363,光明,5,15.文化,30,16,46,ㄍㄨㄤ ㄇㄧㄥˊ,guāng míng
3364,跪,5,核心詞,32,12,44,ㄍㄨㄟˋ,guì
3365,規矩,5,15.文化,31,15,46,ㄍㄨㄟ ㄐㄩˇ,guī jǔ
3366,鬼臉,5,核心詞,3,0,3,ㄍㄨㄟˇ ㄌㄧㄢˇ,guǐ liǎn
3367,規律,5,8.教育、學習,25,11,36,ㄍㄨㄟ ㄌㄩˋ,guī lǜ
3368,貴重,5,核心詞,7,3,10,ㄍㄨㄟˋ ㄓㄨㄥˋ,guì zhòng
3369,貴族,5,15.文化,34,8,42,ㄍㄨㄟˋ ㄗㄨˊ,guì zú
3370,滾,5,核心詞,29,18,47,ㄍㄨㄣˇ,gǔn
3371,棍子/棍,5,12.安全,15,7,22,ㄍㄨㄣˋ ˙ㄗ/ㄍㄨㄣˋ,gùn zi/gùn
3372,過程,5,核心詞,306,462,768,ㄍㄨㄛˋ ㄔㄥˊ,guò chéng
3373,過度,5,7.身體、醫療,78,46,124,ㄍㄨㄛˋ ㄉㄨˋ,guò dù
3374,國會,5,14.社會,22,68,90,ㄍㄨㄛˊ ㄏㄨㄟˋ,guó huì
3375,國籍,5,5.交通、旅遊,4,7,11,ㄍㄨㄛˊ ㄐㄧˊ,guó jí
3376,國立,5,8.教育、學習,15,9,24,ㄍㄨㄛˊ ㄌㄧˋ,guó lì
3377,過量,5,7.身體、醫療,9,6,15,ㄍㄨㄛˋ ㄌㄧㄤˋ,guò liàng
3378,國民,5,1.個人資料,45,31,76,ㄍㄨㄛˊ ㄇㄧㄣˊ,guó mín
3379,國旗,5,14.社會,6,10,16,ㄍㄨㄛˊ ㄑㄧˊ,guó qí
3380,過世,5,1.個人資料,44,39,83,ㄍㄨㄛˋ ㄕˋ,guò shì
3381,過頭,5,核心詞,6,3,9,ㄍㄨㄛˋ ㄊㄡˊ,guò tóu
3382,國王,5,15.文化,80,43,123,ㄍㄨㄛˊ ㄨㄤˊ,guó wáng
3383,過癮,5,核心詞,7,4,11,ㄍㄨㄛˋ ㄧㄣˇ,guò yǐn
3384,國營,5,14.社會,13,7,20,ㄍㄨㄛˊ ㄧㄥˊ,guó yíng
3385,過於,5,核心詞,36,11,47,ㄍㄨㄛˋ ㄩˊ,guò yú
3386,海岸,5,13.自然環境,16,102,118,ㄏㄞˇ ㄢˋ,hǎi àn
3387,害處,5,7.身體、醫療,2,0,2,ㄏㄞˋ ㄔㄨˋ,hài chù
3388,海關,5,5.交通、旅遊,8,5,13,ㄏㄞˇ ㄍㄨㄢ,hǎi guān
3389,海浪,5,13.自然環境,7,18,25,ㄏㄞˇ ㄌㄤˋ,hǎi làng
3390,孩童,5,核心詞,30,17,47,ㄏㄞˊ ㄊㄨㄥˊ,hái tóng
3391,海峽,5,13.自然環境,6,23,29,ㄏㄞˇ ㄒㄧㄚˊ,hǎi xiá
3392,害羞,5,6.社交、人際,28,16,44,ㄏㄞˋ ㄒㄧㄡ,hài xiū
3393,海運,5,5.交通、旅遊,3,3,6,ㄏㄞˇ ㄩㄣˋ,hǎi yùn
3394,含,5,10.餐飲、烹飪,42,38,80,ㄏㄢˊ,hán
3395,罕見,5,核心詞,18,22,40,ㄏㄢˇ ㄐㄧㄢˋ,hǎn jiàn
3396,寒冷,5,5.交通、旅遊,15,27,42,ㄏㄢˊ ㄌㄥˇ,hán lěng
3397,旱災,5,5.交通、旅遊,3,10,13,ㄏㄢˋ ㄗㄞ,hàn zāi
3398,航空,5,5.交通、旅遊,24,25,49,ㄏㄤˊ ㄎㄨㄥ,háng kōng
3399,行業,5,3.職業,34,41,75,ㄏㄤˊ ㄧㄝˋ,háng yè
3400,好比,5,核心詞,21,16,37,ㄏㄠˇ ㄅㄧˇ,hǎo bǐ
3401,好感,5,16.情緒、態度,11,1,12,ㄏㄠˇ ㄍㄢˇ,hǎo gǎn
3402,好客,5,6.社交、人際,3,2,5,ㄏㄠˋ ㄎㄜˋ,hào kè
3403,好奇心,5,核心詞,19,5,24,ㄏㄠˋ ㄑㄧˊ ㄒㄧㄣ,hào qí xīn
3404,好手,5,4.休閒、娛樂,6,8,14,ㄏㄠˇ ㄕㄡˇ,hǎo shǒu
3405,好心,5,核心詞,16,7,23,ㄏㄠˇ ㄒㄧㄣ,hǎo xīn
3406,好意,5,核心詞,9,6,15,ㄏㄠˇ ㄧˋ,hǎo yì
3407,好在,5,核心詞,8,10,18,ㄏㄠˇ ㄗㄞˋ,hǎo zài
3408,好轉,5,7.身體、醫療,14,8,22,ㄏㄠˇ ㄓㄨㄢˇ,hǎo zhuǎn
3409,合,5,核心詞,38,33,71,ㄏㄜˊ,hé
3410,何必,5,核心詞,22,6,28,ㄏㄜˊ ㄅㄧˋ,hé bì
3411,合成,5,10.餐飲、烹飪,16,21,37,ㄏㄜˊ ㄔㄥˊ,hé chéng
3412,合法,5,14.社會,17,18,35,ㄏㄜˊ ㄈㄚˇ,hé fǎ
3413,和好,5,6.社交、人際,4,2,6,ㄏㄜˊ ㄏㄠˇ,hé hǎo
3414,荷花,5,13.自然環境,4,0,4,ㄏㄜˊ ㄏㄨㄚ,hé huā
3415,合計,5,核心詞,5,2,7,ㄏㄜˊ ㄐㄧˋ,hé jì
3416,何況,5,核心詞,34,7,41,ㄏㄜˊ ㄎㄨㄤˋ,hé kuàng
3417,河流,5,5.交通、旅遊,14,42,56,ㄏㄜˊ ㄌㄧㄡˊ,hé liú
3418,核能,5,17.科技,5,45,50,ㄏㄜˊ ㄋㄥˊ,hé néng
3419,和諧,5,核心詞,31,19,50,ㄏㄜˊ ㄒㄧㄝˊ,hé xié
3420,核心,5,核心詞,58,23,81,ㄏㄜˊ ㄒㄧㄣ,hé xīn
3421,嘿,5,核心詞,20,11,31,ㄏㄟ,hēi
3422,黑白,5,核心詞,10,11,21,ㄏㄟ ㄅㄞˊ,hēi bái
3423,黑心,5,12.安全,2,3,5,ㄏㄟ ㄒㄧㄣ,hēi xīn
3424,黑夜,5,核心詞,18,7,25,ㄏㄟ ㄧㄝˋ,hēi yè
3425,痕跡,5,13.自然環境,23,28,51,ㄏㄣˊ ㄐㄧ,hén jī
3426,橫1,5,核心詞,21,11,32,ㄏㄥˊ,héng
3427,哼,5,核心詞,28,7,35,ㄏㄥ,hēng
3428,後代,5,1.個人資料,24,23,47,ㄏㄡˋ ㄉㄞˋ,hòu dài
3429,後悔,5,16.情緒、態度,29,23,52,ㄏㄡˋ ㄏㄨㄟˇ,hòu huǐ
3430,吼叫,5,16.情緒、態度,7,1,8,ㄏㄡˇ ㄐㄧㄠˋ,hǒu jiào
3431,後世,5,8.教育、學習,18,5,23,ㄏㄡˋ ㄕˋ,hòu shì
3432,後退,5,核心詞,8,2,10,ㄏㄡˋ ㄊㄨㄟˋ,hòu tuì
3433,後者,5,核心詞,42,2,44,ㄏㄡˋㄓㄜˇ,hòu zhě
3434,壺,5,10.餐飲、烹飪,21,55,76,ㄏㄨˊ,hú
3435,戶,5,2.日常起居,40,66,106,ㄏㄨˋ,hù
3436,蝴蝶,5,13.自然環境,22,42,64,ㄏㄨˊ ㄉㄧㄝˊ,hú dié
3437,狐狸,5,13.自然環境,22,2,24,ㄏㄨˊ ˙ㄌㄧ,hú li
3438,忽視,5,核心詞,24,11,35,ㄏㄨ ㄕˋ,hū shì
3439,胡說,5,核心詞,7,2,9,ㄏㄨˊ ㄕㄨㄛ,hú shuō
3440,戶頭,5,11.公共服務,3,2,5,ㄏㄨˋ ㄊㄡˊ,hù tóu
3441,互助,5,6.社交、人際,7,13,20,ㄏㄨˋ ㄓㄨˋ,hù zhù
3442,划,5,5.交通、旅遊,10,4,14,ㄏㄨㄚˊ,huá
3443,劃,5,核心詞,9,7,16,ㄏㄨㄚˋ,huà
3444,滑動,5,7.身體、醫療,5,10,15,ㄏㄨㄚˊ ㄉㄨㄥˋ,huá dòng
3445,花朵,5,13.自然環境,29,11,40,ㄏㄨㄚ ㄉㄨㄛˇ,huā duǒ
3446,華僑,5,1.個人資料,6,6,12,ㄏㄨㄚˊ ㄑㄧㄠˊ,huá qiáo
3447,華人,5,1.個人資料,24,28,52,ㄏㄨㄚˊ ㄖㄣˊ,huá rén
3448,滑鼠,5,核心詞,5,3,8,ㄏㄨㄚˊ ㄕㄨˇ,huá shǔ
3449,划算,5,核心詞,3,4,7,ㄏㄨㄚˊ ㄙㄨㄢˋ,huá suàn
3450,花心,5,6.社交、人際,2,1,3,ㄏㄨㄚ ㄒㄧㄣ,huā xīn
3451,化學,5,8.教育、學習,57,164,221,ㄏㄨㄚˋ ㄒㄩㄝˊ,huà xué
3452,華裔,5,1.個人資料,6,2,8,ㄏㄨㄚˊ ㄧˋ,huá yì
3453,懷抱,5,核心詞,18,10,28,ㄏㄨㄞˊ ㄅㄠˋ,huái bào
3454,壞蛋,5,12.安全,10,3,13,ㄏㄨㄞˋ ㄉㄢˋ,huài dàn
3455,懷念,5,16.情緒、態度,19,12,31,ㄏㄨㄞˊ ㄋㄧㄢˋ,huái niàn
3456,懷孕,5,1.個人資料,35,16,51,ㄏㄨㄞˊ ㄩㄣˋ,huái yùn
3457,患病,5,7.身體、醫療,5,2,7,ㄏㄨㄢˋ ㄅㄧㄥˋ,huàn bìng
3458,歡樂,5,核心詞,27,11,38,ㄏㄨㄢ ㄌㄜˋ,huān lè
3459,緩慢,5,核心詞,27,15,42,ㄏㄨㄢˇ ㄇㄢˋ,huǎn màn
3460,歡喜,5,核心詞,24,35,59,ㄏㄨㄢ ㄒㄧˇ,huān xǐ
3461,幻想,5,核心詞,37,5,42,ㄏㄨㄢˋ ㄒㄧㄤˇ,huàn xiǎng
3462,歡笑,5,核心詞,9,5,14,ㄏㄨㄢ ㄒㄧㄠˋ,huān xiào
3463,患者/病患,5,7.身體、醫療,189,106,295,ㄏㄨㄢˋ ㄓㄜˇ/ㄅㄧㄥˋ ㄏㄨㄢˋ,huàn zhě/bìng huàn
3464,皇帝,5,15.文化,362,15,377,ㄏㄨㄤˊ ㄉㄧˋ,huáng dì
3465,皇后,5,15.文化,90,5,95,ㄏㄨㄤˊ ㄏㄡˋ,huáng hòu
3466,謊話,5,核心詞,5,1,6,ㄏㄨㄤˇ ㄏㄨㄚˋ,huǎng huà
3467,黃昏,5,核心詞,17,6,23,ㄏㄨㄤˊ ㄏㄨㄣ,huáng hūn
3468,黃金,5,11.公共服務,44,37,81,ㄏㄨㄤˊ ㄐㄧㄣ,huáng jīn
3469,揮,5,核心詞,22,7,29,ㄏㄨㄟ,huī
3470,灰,5,核心詞,31,17,48,ㄏㄨㄟ,huī
3471,回復/回覆,5,核心詞,20,7,27,ㄏㄨㄟˊ ㄈㄨˋ,huí fù
3472,繪畫,5,4.休閒、娛樂,24,15,39,ㄏㄨㄟˋ ㄏㄨㄚˋ,huì huà
3473,匯款,5,11.公共服務,1,1,2,ㄏㄨㄟˋ ㄎㄨㄢˇ,huì kuǎn
3474,回味,5,15.文化,6,4,10,ㄏㄨㄟˊ ㄨㄟˋ,huí wèi
3475,回憶,5,15.文化,78,42,120,ㄏㄨㄟˊ ㄧˋ,huí yì
3476,回應,5,核心詞,72,33,105,ㄏㄨㄟˊ ㄧㄥˋ,huí yìng
3477,混,5,10.餐飲、烹飪,28,17,45,ㄏㄨㄣˋ,hùn
3478,昏,5,7.身體、醫療,7,2,9,ㄏㄨㄣ,hūn
3479,葷,5,10.餐飲、烹飪,3,15,18,ㄏㄨㄣ,hūn
3480,昏倒,5,7.身體、醫療,7,9,16,ㄏㄨㄣ ㄉㄠˇ,hūn dǎo
3481,混合,5,10.餐飲、烹飪,22,17,39,ㄏㄨㄣˋ ㄏㄜˊ,hùn hé
3482,混亂,5,核心詞,44,18,62,ㄏㄨㄣˋ ㄌㄨㄢˋ,hùn luàn
3483,昏迷,5,7.身體、醫療,11,3,14,ㄏㄨㄣ ㄇㄧˊ,hūn mí
3484,婚事,5,1.個人資料,7,1,8,ㄏㄨㄣ ㄕˋ,hūn shì
3485,夥伴/伙伴,5,核心詞,49,47,96,ㄏㄨㄛˇ ㄅㄢˋ ,huǒ bàn 
3486,貨車,5,5.交通、旅遊,10,11,21,ㄏㄨㄛˋ ㄔㄜ,huò chē
3487,獲得/獲,5,8.教育、學習,225,120,345,ㄏㄨㄛˋ ㄉㄜˊ / ㄏㄨㄛˋ,huò dé / huò
3488,活該,5,核心詞,4,1,5,ㄏㄨㄛˊ ㄍㄞ,huó gāi
3489,火光,5,核心詞,11,2,13,ㄏㄨㄛˇ ㄍㄨㄤ,huǒ guāng
3490,獲利,5,9.購物、商店,24,5,29,ㄏㄨㄛˋ ㄌㄧˋ,huò lì
3491,火山,5,13.自然環境,7,62,69,ㄏㄨㄛˇ ㄕㄢ,huǒ shān
3492,獲勝,5,4.休閒、娛樂,10,6,16,ㄏㄨㄛˋ ㄕㄥˋ,huò shèng
3493,活躍,5,1.個人資料,23,15,38,ㄏㄨㄛˊ ㄩㄝˋ,huó yuè
3494,火災,5,12.安全,9,24,33,ㄏㄨㄛˇ ㄗㄞ,huǒ zāi
3495,計,5,核心詞,48,25,73,ㄐㄧˋ,jì
3496,繫,5,5.交通、旅遊,20,5,25,ㄐㄧˋ / ㄒㄧˋ,jì / xì
3497,擊敗,5,4.休閒、娛樂,18,6,24,ㄐㄧˊ ㄅㄞˋ,jí bài
3498,祭拜,5,15.文化,6,6,12,ㄐㄧˋ ㄅㄞˋ,jì bài
3499,基本,5,核心詞,193,282,475,ㄐㄧ ㄅㄣˇ,jī běn
3500,疾病,5,7.身體、醫療,122,111,233,ㄐㄧˊ ㄅㄧㄥˋ,jí bìng
3501,繼承,5,1.個人資料,49,12,61,ㄐㄧˋ ㄔㄥˊ,jì chéng
3502,基地,5,核心詞,23,27,50,ㄐㄧ ㄉㄧˋ,jī dì
3503,激動,5,核心詞,42,12,54,ㄐㄧ ㄉㄨㄥˋ,jī dòng
3504,基督教,5,1.個人資料,24,14,38,ㄐㄧ ㄉㄨ ㄐㄧㄠˋ,jī dū jiào
3505,嫉妒/忌妒,5,16.情緒、態度,31,8,39,ㄐㄧˊ ㄉㄨˋ/ㄐㄧˋ ㄉㄨˋ,jí dù/jì dù
3506,飢餓/饑餓,5,7.身體、醫療,18,20,38,ㄐㄧ ㄜˋ,jī è
3507,機構,5,3.職業,75,52,127,ㄐㄧ ㄍㄡˋ,jī gòu
3508,記號,5,8.教育、學習,10,9,19,ㄐㄧˋ ㄏㄠˋ,jì hào
3509,集合,5,核心詞,16,25,41,ㄐㄧˊ ㄏㄜˊ,jí hé
3510,基金,5,11.公共服務,27,18,45,ㄐㄧ ㄐㄧㄣ,jī jīn
3511,急救,5,7.身體、醫療,7,13,20,ㄐㄧˊ ㄐㄧㄡˋ,jí jiù
3512,機率,5,核心詞,59,32,91,ㄐㄧ ㄌㄩˋ,jī lǜ
3513,寂寞,5,核心詞,39,10,49,ㄐㄧˊ ㄇㄛˋ,jí mò
3514,技能,5,3.職業,29,13,42,ㄐㄧˋ ㄋㄥˊ,jì néng
3515,紀念品,5,9.購物、商店,7,8,15,ㄐㄧˋ ㄋㄧㄢˋ ㄆㄧㄣˇ,jì niàn pǐn
3516,肌肉,5,7.身體、醫療,78,34,112,ㄐㄧ ㄖㄡˋ,jī ròu
3517,集體,5,8.教育、學習,30,14,44,ㄐㄧˊ ㄊㄧˇ,jí tǐ
3518,集團,5,3.職業,77,18,95,ㄐㄧˊ ㄊㄨㄢˊ,jí tuán
3519,績效,5,3.職業,24,2,26,ㄐㄧ ㄒㄧㄠˋ,jī xiào
3520,基因,5,核心詞,77,62,139,ㄐㄧ ㄧㄣ,jī yīn
3521,既有,5,核心詞,22,4,26,ㄐㄧˋ ㄧㄡˇ,jì yǒu
3522,記載,5,8.教育、學習,69,44,113,ㄐㄧˋ ㄗㄞˋ,jì zài
3523,夾,5,核心詞,37,22,59,ㄐㄧㄚˊ,jiá
3524,佳,5,核心詞,33,22,55,ㄐㄧㄚ,jiā
3525,加倍,5,核心詞,9,7,16,ㄐㄧㄚ ㄅㄟˋ,jiā bèi
3526,加工,5,3.職業,19,34,53,ㄐㄧㄚ ㄍㄨㄥ,jiā gōng
3527,架構,5,8.教育、學習,35,10,45,ㄐㄧㄚˋ ㄍㄡˋ,jià gòu
3528,傢伙,5,6.社交、人際,70,3,73,ㄐㄧㄚ ˙ㄏㄨㄛ,jiā huo
3529,家家戶戶,5,15.文化,5,11,16,ㄐㄧㄚ ㄐㄧㄚ ㄏㄨˋ ㄏㄨˋ,jiā jiā hù hù
3530,佳節,5,15.文化,2,1,3,ㄐㄧㄚ ㄐㄧㄝˊ,jiā jié
3531,家境,5,1.個人資料,7,9,16,ㄐㄧㄚ ㄐㄧㄥˋ,jiā jìng
3532,假使,5,核心詞,11,9,20,ㄐㄧㄚˇ ㄕˇ,jiǎ shǐ
3533,駕駛/駕,5,5.交通、旅遊,45,23,68,ㄐㄧㄚˋ ㄕˇ/ㄐㄧㄚˋ,jià shǐ/jià
3534,家屬,5,7.身體、醫療,21,48,69,ㄐㄧㄚ ㄕㄨˇ,jiā shǔ
3535,加速,5,核心詞,29,21,50,ㄐㄧㄚ ㄙㄨˋ,jiā sù
3536,家園,5,5.交通、旅遊,12,40,52,ㄐㄧㄚ ㄩㄢˊ,jiā yuán
3537,價值觀,5,1.個人資料,29,21,50,ㄐㄧㄚˋ ㄓˊ ㄍㄨㄢ,jià zhí guān
3538,家族,5,1.個人資料,92,42,134,ㄐㄧㄚ ㄗㄨˊ,jiā zú
3539,劍,5,15.文化,52,10,62,ㄐㄧㄢˋ,jiàn
3540,箭,5,15.文化,48,7,55,ㄐㄧㄢˋ,jiàn
3541,撿,5,核心詞,18,60,78,ㄐㄧㄢˇ,jiǎn
3542,肩膀/肩,5,7.身體、醫療,100,28,128,ㄐㄧㄢ ㄅㄤˇ/ㄐㄧㄢ,jiān bǎng/jiān
3543,簡便,5,核心詞,4,1,5,ㄐㄧㄢˇ ㄅㄧㄢˋ,jiǎn biàn
3544,簡稱,5,核心詞,12,8,20,ㄐㄧㄢˇ ㄔㄥ,jiǎn chēng
3545,堅持,5,核心詞,119,132,251,ㄐㄧㄢ ㄔˊ,jiān chí
3546,減低,5,核心詞,16,8,24,ㄐㄧㄢˇ ㄉㄧ,jiǎn dī
3547,堅定,5,1.個人資料,37,28,65,ㄐㄧㄢ ㄉㄧㄥˋ,jiān dìng
3548,監督,5,3.職業,21,11,32,ㄐㄧㄢ ㄉㄨ,jiān dū
3549,簡短,5,核心詞,15,3,18,ㄐㄧㄢˇ ㄉㄨㄢˇ,jiǎn duǎn
3550,堅固,5,核心詞,12,16,28,ㄐㄧㄢ ㄍㄨˋ,jiān gù
3551,尖叫,5,核心詞,23,2,25,ㄐㄧㄢ ㄐㄧㄠˋ,jiān jiào
3552,見解,5,8.教育、學習,22,5,27,ㄐㄧㄢˋ ㄐㄧㄝˇ,jiàn jiě
3553,間接,5,核心詞,18,13,31,ㄐㄧㄢˋ ㄐㄧㄝ,jiàn jiē
3554,簡介,5,8.教育、學習,17,3,20,ㄐㄧㄢˇ ㄐㄧㄝˋ,jiǎn jiè
3555,堅決,5,16.情緒、態度,26,6,32,ㄐㄧㄢ ㄐㄩㄝˊ,jiān jué
3556,建立,5,3.職業,217,82,299,ㄐㄧㄢˋ ㄌㄧˋ,jiàn lì
3557,艱難,5,核心詞,22,18,40,ㄐㄧㄢ ㄋㄢˊ,jiān nán
3558,鍵盤,5,核心詞,15,4,19,ㄐㄧㄢˋ ㄆㄢˊ,jiàn pán
3559,堅強,5,16.情緒、態度,27,28,55,ㄐㄧㄢ ㄑㄧㄤˊ,jiān qiáng
3560,減輕,5,核心詞,29,21,50,ㄐㄧㄢˇ ㄑㄧㄥ,jiǎn qīng
3561,健全,5,7.身體、醫療,20,13,33,ㄐㄧㄢˋ ㄑㄩㄢˊ,jiàn quán
3562,建設,5,3.職業,36,41,77,ㄐㄧㄢˋ ㄕㄜˋ,jiàn shè
3563,見識,5,核心詞,17,3,20,ㄐㄧㄢˋ ㄕˋ,jiàn shì
3564,監視,5,12.安全,17,6,23,ㄐㄧㄢ ㄕˋ,jiān shì
3565,檢討,5,核心詞,27,14,41,ㄐㄧㄢˇ ㄊㄠˇ,jiǎn tǎo
3566,箭頭,5,核心詞,5,2,7,ㄐㄧㄢˋ ㄊㄡˊ,jiàn tóu
3567,檢驗,5,核心詞,32,22,54,ㄐㄧㄢˇ ㄧㄢˋ,jiǎn yàn
3568,建造,5,核心詞,30,33,63,ㄐㄧㄢˋ ㄗㄠˋ,jiàn zào
3569,兼職,5,3.職業,4,3,7,ㄐㄧㄢ ㄓˊ,jiān zhí
3570,降1,5,核心詞,37,52,89,ㄐㄧㄤˋ,jiàng
3571,薑,5,10.餐飲、烹飪,8,18,26,ㄐㄧㄤ,jiāng
3572,降價,5,9.購物、商店,4,1,5,ㄐㄧㄤˋ ㄐㄧㄚˋ,jiàng jià
3573,講解,5,8.教育、學習,6,8,14,ㄐㄧㄤˇ ㄐㄧㄝˇ,jiǎng jiě
3574,獎金,5,3.職業,13,8,21,ㄐㄧㄤˇ ㄐㄧㄣ,jiǎng jīn
3575,講究,5,核心詞,21,19,40,ㄐㄧㄤˇ ㄐㄧㄡˋ,jiǎng jiù
3576,獎勵,5,3.職業,23,9,32,ㄐㄧㄤˇ ㄌㄧˋ,jiǎng lì
3577,降落,5,5.交通、旅遊,10,8,18,ㄐㄧㄤˋ ㄌㄨㄛˋ,jiàng luò
3578,講台/講臺,5,8.教育、學習,7,3,10,ㄐㄧㄤˇ ㄊㄞˊ ,jiǎng tái  
3579,講義,5,8.教育、學習,5,6,11,ㄐㄧㄤˇ ㄧˋ,jiǎng yì
3580,將,5,核心詞,1518,718,2236,ㄐㄧㄤ/ㄐㄧㄤˋ/ㄑㄧㄤ,jiāng/jiàng/qiāng
3581,攪,5,10.餐飲、烹飪,6,11,17,ㄐㄧㄠˇ,jiǎo
3582,角,5,核心詞,40,37,77,ㄐㄧㄠˇ / ㄐㄩㄝˊ,jiǎo / jué
3583,驕傲,5,16.情緒、態度,33,32,65,ㄐㄧㄠ ㄠˋ,jiāo ào
3584,教材,5,8.教育、學習,14,12,26,ㄐㄧㄠˋ ㄘㄞˊ,jiào cái
3585,交代,5,核心詞,24,21,45,ㄐㄧㄠ ㄉㄞˋ,jiāo dài
3586,教導,5,核心詞,73,46,119,ㄐㄧㄠˋ ㄉㄠˇ,jiào dǎo
3587,焦點,5,8.教育、學習,38,38,76,ㄐㄧㄠ ㄉㄧㄢˇ,jiāo diǎn
3588,角度,5,8.教育、學習,94,120,214,ㄐㄧㄠˇ ㄉㄨˋ,jiǎo dù
3589,教會,5,15.文化,39,32,71,ㄐㄧㄠˋ ㄏㄨㄟˋ,jiào huì
3590,腳尖,5,7.身體、醫療,7,1,8,ㄐㄧㄠˇㄐㄧㄢ,jiǎo jiān
3591,教練,5,4.休閒、娛樂,46,38,84,ㄐㄧㄠˋ ㄌㄧㄢˋ,jiào liàn
3592,焦慮,5,核心詞,72,14,86,ㄐㄧㄠ ㄌㄩˋ,jiāo lǜ
3593,角落,5,核心詞,44,40,84,ㄐㄧㄠˇ ㄌㄨㄛˋ,jiǎo luò
3594,交談,5,核心詞,40,6,46,ㄐㄧㄠ ㄊㄢˊ,jiāo tán
3595,教徒,5,15.文化,8,11,19,ㄐㄧㄠˋ ㄊㄨˊ,jiào tú
3596,交往,5,6.社交、人際,28,9,37,ㄐㄧㄠ ㄨㄤˇ,jiāo wǎng
3597,教訓,5,核心詞,36,12,48,ㄐㄧㄠˋ ㄒㄩㄣˋ,jiào xùn
3598,交易,5,3.職業,38,15,53,ㄐㄧㄠ ㄧˋ,jiāo yì
3599,腳印,5,核心詞,10,11,21,ㄐㄧㄠˇ ㄧㄣˋ,jiǎo yìn
3600,交友,5,1.個人資料,4,3,7,ㄐㄧㄠ ㄧㄡˇ,jiāo yǒu
3601,教育部,5,14.社會,12,8,20,ㄐㄧㄠˋ ㄩˋ ㄅㄨˋ,jiào yù bù
3602,結,5,核心詞,32,39,71,ㄐㄧㄝˊ,jié
3603,屆,5,核心詞,26,27,53,ㄐㄧㄝˋ,jiè
3604,戒,5,12.安全,16,19,35,ㄐㄧㄝˋ,jiè
3605,皆,5,核心詞,151,17,168,ㄐㄧㄝ,jiē
3606,傑出,5,核心詞,32,10,42,ㄐㄧㄝˊ ㄔㄨ,jié chū
3607,解除,5,12.安全,26,22,48,ㄐㄧㄝˇ ㄔㄨˊ,jiě chú
3608,解答,5,8.教育、學習,20,16,36,ㄐㄧㄝˇ ㄉㄚˊ,jiě dá
3609,接待,5,10.餐飲、烹飪,18,8,26,ㄐㄧㄝ ㄉㄞˋ,jiē dài
3610,結構,5,8.教育、學習,152,85,237,ㄐㄧㄝˊ ㄍㄡˋ,jié gòu
3611,階級,5,14.社會,59,9,68,ㄐㄧㄝ ㄐㄧˊ,jiē jí
3612,結局,5,4.休閒、娛樂,27,6,33,ㄐㄧㄝˊ ㄐㄩˊ,jié jú
3613,解開,5,2.日常起居,25,25,50,ㄐㄧㄝˇ ㄎㄞ,jiě kāi
3614,解渴,5,核心詞,3,8,11,ㄐㄧㄝˇ ㄎㄜˇ,jiě kě
3615,藉口,5,核心詞,32,10,42,ㄐㄧㄝˋ ㄎㄡˇ,jiè kǒu
3616,節能,5,3.職業,1,43,44,ㄐㄧㄝˊ ㄋㄥˊ,jié néng
3617,節省,5,核心詞,16,34,50,ㄐㄧㄝˊ ㄕㄥˇ,jié shěng
3618,接收,5,核心詞,19,8,27,ㄐㄧㄝ ㄕㄡ,jiē shōu
3619,解說,5,8.教育、學習,17,23,40,ㄐㄧㄝˇ ㄕㄨㄛ,jiě shuō
3620,街頭,5,9.購物、商店,26,49,75,ㄐㄧㄝ ㄊㄡˊ,jiē tóu
3621,結尾,5,4.休閒、娛樂,13,2,15,ㄐㄧㄝˊ ㄨㄟˇ,jié wěi
3622,借用,5,核心詞,12,3,15,ㄐㄧㄝˋ ㄩㄥˋ,jiè yòng
3623,截止,5,核心詞,3,1,4,ㄐㄧㄝˊ ㄓˇ,jié zhǐ
3624,戒指,5,9.購物、商店,13,4,17,ㄐㄧㄝˋ ㄓˇ,jiè zhǐ
3625,節奏,5,核心詞,28,15,43,ㄐㄧㄝˊ ㄗㄡˋ,jié zòu
3626,禁不住,5,核心詞,6,0,6,ㄐㄧㄣ ㄅㄨˊ ㄓㄨˋ,jīn bú zhù
3627,近代,5,8.教育、學習,23,10,33,ㄐㄧㄣˋ ㄉㄞˋ,jìn dài
3628,進度,5,8.教育、學習,14,16,30,ㄐㄧㄣˋ ㄉㄨˋ,jìn dù
3629,進攻,5,4.休閒、娛樂,34,5,39,ㄐㄧㄣˋ ㄍㄨㄥ,jìn gōng
3630,儘管,5,核心詞,145,53,198,ㄐㄧㄣˇ ㄍㄨㄢˇ,jǐn guǎn
3631,緊急,5,7.身體、醫療,34,57,91,ㄐㄧㄣˇ ㄐㄧˊ,jǐn jí
3632,僅僅/僅,5,核心詞,131,32,163,ㄐㄧㄣˇ ㄐㄧㄣˇ / ㄐㄧㄣˇ,jǐn jǐn / jǐn
3633,盡快/儘快,5,核心詞,19,25,44,ㄐㄧㄣˋ ㄎㄨㄞˋ/ㄐㄧㄣˇ ㄎㄨㄞˋ,jìn kuài/jǐn kuài
3634,近來,5,核心詞,11,4,15,ㄐㄧㄣˋ ㄌㄞˊ,jìn lái
3635,盡力,5,核心詞,25,21,46,ㄐㄧㄣˋ ㄌㄧˋ,jìn lì
3636,盡量/儘量,5,核心詞,76,117,193,ㄐㄧㄣˋ ㄌㄧㄤˋ/ㄐㄧㄣˇ ㄌㄧㄤˋ,jìn liàng/jǐn liàng
3637,緊密,5,核心詞,21,16,37,ㄐㄧㄣˇ ㄇㄧˋ,jǐn mì
3638,金牌,5,4.休閒、娛樂,5,3,8,ㄐㄧㄣ ㄆㄞˊ,jīn pái
3639,金融,5,14.社會,32,43,75,ㄐㄧㄣ ㄖㄨㄥˊ,jīn róng
3640,謹慎,5,核心詞,37,16,53,ㄐㄧㄣˇ ㄕㄣˋ,jǐn shèn
3641,近視,5,7.身體、醫療,4,2,6,ㄐㄧㄣˋ ㄕˋ,jìn shì
3642,金屬,5,13.自然環境,21,20,41,ㄐㄧㄣ ㄕㄨˇ,jīn shǔ
3643,進行,5,核心詞,343,288,631,ㄐㄧㄣˋ ㄒㄧㄥˊ,jìn xíng
3644,進展,5,3.職業,37,12,49,ㄐㄧㄣˋ ㄓㄢˇ,jìn zhǎn
3645,禁止,5,核心詞,32,38,70,ㄐㄧㄣˋ ㄓˇ,jìn zhǐ
3646,金子,5,13.自然環境,13,1,14,ㄐㄧㄣ ˙ㄗ,jīn zi
3647,盡/儘,5,核心詞,88,62,150,ㄐㄧㄣˋ/ㄐㄧㄣˇ,jìn/jǐn
3648,井,5,核心詞,38,21,59,ㄐㄧㄥˇ,jǐng
3649,精彩/精采,5,4.休閒、娛樂,42,51,93,ㄐㄧㄥ ㄘㄞˇ,jīng cǎi
3650,警察局,5,12.安全,9,6,15,ㄐㄧㄥˇ ㄔㄚˊ ㄐㄩˊ,jǐng chá jú
3651,景點,5,5.交通、旅遊,6,19,25,ㄐㄧㄥˇ ㄉㄧㄢˇ,jǐng diǎn
3652,經費,5,3.職業,29,33,62,ㄐㄧㄥ ㄈㄟˋ,jīng fèi
3653,警告,5,核心詞,43,28,71,ㄐㄧㄥˇ ㄍㄠˋ,jǐng gào
3654,經濟學,5,8.教育、學習,16,7,23,ㄐㄧㄥ ㄐㄧˋ ㄒㄩㄝˊ,jīng jì xué
3655,敬酒,5,6.社交、人際,4,1,5,ㄐㄧㄥˋ ㄐㄧㄡˇ,jìng jiǔ
3656,精力,5,7.身體、醫療,39,9,48,ㄐㄧㄥ ㄌㄧˋ,jīng lì
3657,經歷,5,核心詞,98,68,166,ㄐㄧㄥ ㄌㄧˋ,jīng lì
3658,景氣,5,14.社會,8,9,17,ㄐㄧㄥˇ ㄑㄧˋ,jǐng qì
3659,驚奇,5,核心詞,24,5,29,ㄐㄧㄥ ㄑㄧˊ,jīng qí
3660,精確,5,核心詞,25,10,35,ㄐㄧㄥ ㄑㄩㄝˋ,jīng què
3661,驚人,5,核心詞,44,37,81,ㄐㄧㄥ ㄖㄣˊ,jīng rén
3662,競賽,5,4.休閒、娛樂,18,10,28,ㄐㄧㄥˋ ㄙㄞˋ,jìng sài
3663,鏡頭,5,4.休閒、娛樂,28,32,60,ㄐㄧㄥˋ ㄊㄡˊ,jìng tóu
3664,警衛,5,12.安全,11,2,13,ㄐㄧㄥˇ ㄨㄟˋ,jǐng wèi
3665,驚喜,5,核心詞,19,19,38,ㄐㄧㄥ ㄒㄧˇ,jīng xǐ
3666,景象,5,5.交通、旅遊,33,28,61,ㄐㄧㄥˇ ㄒㄧㄤˋ,jǐng xiàng
3667,精心,5,16.情緒、態度,18,6,24,ㄐㄧㄥ ㄒㄧㄣ,jīng xīn
3668,競選,5,14.社會,9,6,15,ㄐㄧㄥˋ ㄒㄩㄢˇ,jìng xuǎn
3669,經營,5,3.職業,160,93,253,ㄐㄧㄥ ㄧㄥˊ,jīng yíng
3670,經由,5,核心詞,47,28,75,ㄐㄧㄥ ㄧㄡˊ,jīng yóu
3671,酒店,5,5.交通、旅遊,13,4,17,ㄐㄧㄡˇ ㄉㄧㄢˋ,jiǔ diàn
3672,就讀,5,8.教育、學習,19,23,42,ㄐㄧㄡˋ ㄉㄨˊ,jiù dú
3673,糾紛,5,12.安全,11,4,15,ㄐㄧㄡ ㄈㄣ,jiū fēn
3674,究竟,5,核心詞,104,50,154,ㄐㄧㄡˋ ㄐㄧㄥˋ,jiù jìng
3675,救命,5,7.身體、醫療,10,13,23,ㄐㄧㄡˋ ㄇㄧㄥˋ,jiù mìng
3676,就學,5,3.職業,5,7,12,ㄐㄧㄡˋ ㄒㄩㄝˊ,jiù xué
3677,就業,5,3.職業,14,41,55,ㄐㄧㄡˋ ㄧㄝˋ,jiù yè
3678,局,5,核心詞,27,18,45,ㄐㄩˊ,jú
3679,具備,5,核心詞,49,22,71,ㄐㄩˋ ㄅㄟˋ,jù bèi
3680,劇本,5,4.休閒、娛樂,39,9,48,ㄐㄩˋ ㄅㄣˇ,jù běn
3681,巨大/巨,5,核心詞,89,45,134,ㄐㄩˋ ㄉㄚˋ/ㄐㄩˋ,jù dà/jù
3682,舉動,5,核心詞,24,11,35,ㄐㄩˇ ㄉㄨㄥˋ,jǔ dòng
3683,聚會,5,6.社交、人際,28,11,39,ㄐㄩˋ ㄏㄨㄟˋ,jù huì
3684,聚集,5,核心詞,33,42,75,ㄐㄩˋ ㄐㄧˊ,jù jí
3685,俱樂部,5,6.社交、人際,28,5,33,ㄐㄩˋ ㄌㄜˋ ㄅㄨˋ,jù lè bù
3686,劇烈,5,7.身體、醫療,18,21,39,ㄐㄩˋ ㄌㄧㄝˋ,jù liè
3687,劇情,5,4.休閒、娛樂,13,4,17,ㄐㄩˋ ㄑㄧㄥˊ,jù qíng
3688,居住,5,2.日常起居,45,58,103,ㄐㄩ ㄓㄨˋ,jū zhù
3689,捲,5,核心詞,19,15,34,ㄐㄩㄢˇ,juǎn
3690,捐,5,核心詞,13,34,47,ㄐㄩㄢ,juān
3691,捐款,5,14.社會,8,16,24,ㄐㄩㄢ ㄎㄨㄢˇ,juān kuǎn
3692,卷,5,核心詞,82,9,91,ㄐㄩㄢˇ/ㄐㄩㄢˋ,juǎn/juàn
3693,決策,5,3.職業,74,9,83,ㄐㄩㄝˊ ㄘㄜˋ,jué cè
3694,決賽,5,4.休閒、娛樂,3,1,4,ㄐㄩㄝˊ ㄙㄞˋ,jué sài
3695,絕望,5,16.情緒、態度,37,10,47,ㄐㄩㄝˊ ㄨㄤˋ,jué wàng
3696,軍,5,核心詞,64,56,120,ㄐㄩㄣ,jūn
3697,軍人,5,3.職業,33,25,58,ㄐㄩㄣ ㄖㄣˊ,jūn rén
3698,軍事,5,14.社會,73,91,164,ㄐㄩㄣ ㄕˋ,jūn shì
3699,卡,5,11.公共服務,16,42,58,ㄎㄚˇ,kǎ
3700,開除,5,3.職業,12,5,17,ㄎㄞ ㄔㄨˊ,kāi chú
3701,開創,5,核心詞,19,10,29,ㄎㄞ ㄔㄨㄤˋ,kāi chuàng
3702,開刀,5,7.身體、醫療,15,39,54,ㄎㄞ ㄉㄠ,kāi dāo
3703,開發,5,3.職業,76,103,179,ㄎㄞ ㄈㄚ,kāi fā
3704,開關,5,核心詞,22,12,34,ㄎㄞ ㄍㄨㄢ,kāi guān
3705,開戶,5,11.公共服務,1,1,2,ㄎㄞ ㄏㄨˋ,kāi hù
3706,開幕式,5,4.休閒、娛樂,2,1,3,ㄎㄞ ㄇㄨˋ ㄕˋ,kāi mù shì
3707,開頭,5,核心詞,18,4,22,ㄎㄞ ㄊㄡˊ,kāi tóu
3708,看2,5,核心詞,1808,3076,4884,ㄎㄢ,kān
3709,刊登,5,8.教育、學習,17,3,20,ㄎㄢ ㄉㄥ,kān dēng
3710,看診,5,7.身體、醫療,6,10,16,ㄎㄢˋ ㄓㄣˇ,kàn zhěn
3711,抗拒,5,核心詞,27,7,34,ㄎㄤˋ ㄐㄩˋ,kàng jù
3712,抗議,5,14.社會,29,70,99,ㄎㄤˋ ㄧˋ,kàng yì
3713,考量,5,核心詞,34,31,65,ㄎㄠˇ ㄌㄧㄤˊ,kǎo liáng
3714,考取,5,8.教育、學習,4,4,8,ㄎㄠˇ ㄑㄩˇ,kǎo qǔ
3715,烤箱,5,10.餐飲、烹飪,4,5,9,ㄎㄠˇ ㄒㄧㄤ,kǎo xiāng
3716,考驗,5,核心詞,26,56,82,ㄎㄠˇ ㄧㄢˋ,kǎo yàn
3717,刻,5,核心詞,67,40,107,ㄎㄜˋ,kè
3718,客,5,9.購物、商店,10,15,25,ㄎㄜˋ,kè
3719,科,5,8.教育、學習,18,25,43,ㄎㄜ,kē
3720,克服,5,核心詞,50,53,103,ㄎㄜˋ ㄈㄨˊ,kè fú
3721,客觀,5,16.情緒、態度,37,10,47,ㄎㄜˋ ㄍㄨㄢ,kè guān
3722,可見,5,核心詞,15,16,31,ㄎㄜˇ ㄐㄧㄢˋ,kě jiàn
3723,可口,5,10.餐飲、烹飪,10,6,16,ㄎㄜˇ ㄎㄡˇ,kě kǒu
3724,可惡,5,核心詞,10,4,14,ㄎㄜˇ ㄨˋ,kě wù
3725,可信,5,核心詞,8,2,10,ㄎㄜˇ ㄒㄧㄣˋ,kě xìn
3726,課業,5,8.教育、學習,11,12,23,ㄎㄜˋ ㄧㄝˋ,kè yè
3727,空白,5,4.休閒、娛樂,14,9,23,ㄎㄨㄥˋ ㄅㄞˊ,kòng bái
3728,空地,5,2.日常起居,12,6,18,ㄎㄨㄥˋ ㄉㄧˋ,kòng dì
3729,恐懼,5,16.情緒、態度,108,33,141,ㄎㄨㄥˇ ㄐㄩˋ,kǒng jù
3730,空難,5,12.安全,4,3,7,ㄎㄨㄥ ㄋㄢˋ,kōng nàn
3731,空手,5,核心詞,3,1,4,ㄎㄨㄥ ㄕㄡˇ,kōng shǒu
3732,空閒,5,3.職業,6,6,12,ㄎㄨㄥˋ ㄒㄧㄢˊ,kòng xián
3733,空運,5,11.公共服務,2,3,5,ㄎㄨㄥ ㄩㄣˋ,kōng yùn
3734,控制,5,核心詞,176,122,298,ㄎㄨㄥˋ ㄓˋ,kòng zhì
3735,口才,5,6.社交、人際,4,3,7,ㄎㄡˇ ㄘㄞˊ,kǒu cái
3736,口號,5,14.社會,18,14,32,ㄎㄡˇ ㄏㄠˋ,kǒu hào
3737,口氣,5,核心詞,25,4,29,ㄎㄡˇ ㄑㄧˋ,kǒu qì
3738,口頭,5,核心詞,11,4,15,ㄎㄡˇ ㄊㄡˊ,kǒu tóu
3739,口語,5,1.個人資料,11,3,14,ㄎㄡˇ ㄩˇ,kǒu yǔ
3740,苦惱,5,16.情緒、態度,15,5,20,ㄎㄨˇ ㄋㄠˇ,kǔ nǎo
3741,哭泣,5,核心詞,26,4,30,ㄎㄨ ㄑㄧˋ,kū qì
3742,跨,5,核心詞,29,20,49,ㄎㄨㄚˋ,kuà
3743,垮,5,核心詞,7,7,14,ㄎㄨㄚˇ,kuǎ
3744,跨國,5,3.職業,11,5,16,ㄎㄨㄚˋ ㄍㄨㄛˊ,kuà guó
3745,誇獎/誇,5,6.社交、人際,15,7,22,ㄎㄨㄚ ㄐㄧㄤˇ/ㄎㄨㄚ,kuā jiǎng/kuā
3746,誇張,5,4.休閒、娛樂,27,19,46,ㄎㄨㄚ ㄓㄤ,kuā zhāng
3747,快遞,5,11.公共服務,5,2,7,ㄎㄨㄞˋ ㄉㄧˋ,kuài dì
3748,寬廣,5,核心詞,13,10,23,ㄎㄨㄢ ㄍㄨㄤˇ,kuān guǎng
3749,狂,5,16.情緒、態度,21,7,28,ㄎㄨㄤˊ,kuáng
3750,困,5,核心詞,14,25,39,ㄎㄨㄣˋ,kùn
3751,困境,5,核心詞,45,38,83,ㄎㄨㄣˋ ㄐㄧㄥˋ,kùn jìng
3752,困擾,5,核心詞,55,31,86,ㄎㄨㄣˋ ㄖㄠˇ,kùn rǎo
3753,擴大,5,3.職業,46,53,99,ㄎㄨㄛˋ ㄉㄚˋ,kuò dà
3754,擴張,5,3.職業,22,14,36,ㄎㄨㄛˋ ㄓㄤ,kuò zhāng
3755,喇叭,5,17.科技,8,8,16,ㄌㄚˇ ㄅㄚ,lǎ bā
3756,蠟燭,5,核心詞,17,12,29,ㄌㄚˋ ㄓㄨˊ,là zhú
3757,來電,5,核心詞,7,2,9,ㄌㄞˊ ㄉㄧㄢˋ,lái diàn
3758,來臨,5,核心詞,27,22,49,ㄌㄞˊ ㄌㄧㄣˊ,lái lín
3759,攔,5,核心詞,5,6,11,ㄌㄢˊ,lán
3760,爛,5,10.餐飲、烹飪,33,27,60,ㄌㄢˋ,làn
3761,懶惰,5,核心詞,9,10,19,ㄌㄢˇ ㄉㄨㄛˋ,lǎn duò
3762,狼,5,13.自然環境,50,13,63,ㄌㄤˊ,láng
3763,老大,5,核心詞,31,26,57,ㄌㄠˇ ㄉㄚˋ,lǎo dà
3764,嘮叨,5,核心詞,7,3,10,ㄌㄠˊ ㄉㄠ,láo dāo
3765,勞動,5,3.職業,36,19,55,ㄌㄠˊ ㄉㄨㄥˋ,láo dòng
3766,勞工,5,3.職業,14,31,45,ㄌㄠˊ ㄍㄨㄥ,láo gōng
3767,老家,5,2.日常起居,15,25,40,ㄌㄠˇ ㄐㄧㄚ,lǎo jiā
3768,老舊,5,2.日常起居,11,12,23,ㄌㄠˇ ㄐㄧㄡˋ,lǎo jiù
3769,老人家,5,核心詞,36,77,113,ㄌㄠˇ ㄖㄣˊ ˙ㄐㄧㄚ,lǎo rén jia
3770,老實,5,16.情緒、態度,18,17,35,ㄌㄠˇ ㄕˊ,lǎo shí
3771,老天,5,核心詞,18,17,35,ㄌㄠˇ ㄊㄧㄢ,lǎo tiān
3772,老天爺,5,核心詞,10,25,35,ㄌㄠˇ ㄊㄧㄢ ㄧㄝˊ,lǎo tiān yé
3773,老頭/老頭子/老頭兒,5,核心詞,54,2,56,ㄌㄠˇ ㄊㄡˊ/ㄌㄠˇ ㄊㄡˊ ˙ㄗ/ㄌㄠˇ ㄊㄡˊㄦ,lǎo tóu/lǎo tóu zi/lǎo tóur
3774,老鷹/鷹,5,13.自然環境,27,22,49,ㄌㄠˇ ㄧㄥ/ㄧㄥ,lǎo yīng/yīng
3775,樂意,5,核心詞,18,11,29,ㄌㄜˋ ㄧˋ,lè yì
3776,樂園,5,4.休閒、娛樂,8,2,10,ㄌㄜˋ ㄩㄢˊ,lè yuán
3777,雷,5,13.自然環境,13,18,31,ㄌㄟˊ,léi
3778,類別,5,8.教育、學習,32,3,35,ㄌㄟˋ ㄅㄧㄝˊ,lèi bié
3779,累積,5,核心詞,58,75,133,ㄌㄟˇ ㄐㄧ,lěi jī
3780,淚水,5,7.身體、醫療,24,6,30,ㄌㄟˋ ㄕㄨㄟˇ,lèi shuǐ
3781,類似,5,核心詞,111,94,205,ㄌㄟˋ ㄙˋ,lèi sì
3782,冷冰冰,5,16.情緒、態度,4,3,7,ㄌㄥˇ ㄅㄧㄥ ㄅㄧㄥ,lěng bīng bīng
3783,冷淡,5,6.社交、人際,10,2,12,ㄌㄥˇ ㄉㄢˋ,lěng dàn
3784,冷凍,5,10.餐飲、烹飪,8,9,17,ㄌㄥˇ ㄉㄨㄥˋ,lěng dòng
3785,冷靜,5,1.個人資料,37,21,58,ㄌㄥˇ ㄐㄧㄥˋ,lěng jìng
3786,冷漠,5,6.社交、人際,18,5,23,ㄌㄥˇ ㄇㄛˋ,lěng mò
3787,梨,5,10.餐飲、烹飪,8,8,16,ㄌㄧˊ,lí
3788,利,5,核心詞,35,26,61,ㄌㄧˋ,lì
3789,粒,5,核心詞,20,34,54,ㄌㄧˋ,lì
3790,立場,5,核心詞,54,51,105,ㄌㄧˋ ㄔㄤˊ,lì cháng
3791,禮服,5,9.購物、商店,10,4,14,ㄌㄧˇ ㄈㄨˊ,lǐ fú
3792,立即,5,核心詞,109,20,129,ㄌㄧˋ ㄐㄧˊ,lì jí
3793,理解,5,核心詞,147,50,197,ㄌㄧˇ ㄐㄧㄝˇ,lǐ jiě
3794,力量,5,核心詞,208,227,435,ㄌㄧˋ ㄌㄧㄤˋ,lì liàng
3795,理論,5,8.教育、學習,229,35,264,ㄌㄧˇ ㄌㄨㄣˋ,lǐ lùn
3796,利潤,5,9.購物、商店,26,16,42,ㄌㄧˋ ㄖㄨㄣˋ,lì rùn
3797,理所當然,5,16.情緒、態度,23,8,31,ㄌㄧˇ ㄙㄨㄛˇ ㄉㄤ ㄖㄢˊ,lǐ suǒ dāng rán
3798,利息,5,11.公共服務,9,11,20,ㄌㄧˋ ㄒㄧˊ,lì xí
3799,理性,5,16.情緒、態度,61,14,75,ㄌㄧˇ ㄒㄧㄥˋ,lǐ xìng
3800,利益,5,14.社會,71,38,109,ㄌㄧˋ ㄧˋ,lì yì
3801,禮儀,5,15.文化,19,14,33,ㄌㄧˇ ㄧˊ,lǐ yí
3802,離職,5,3.職業,8,2,10,ㄌㄧˊ ㄓˊ,lí zhí
3803,理智,5,16.情緒、態度,21,3,24,ㄌㄧˇ ㄓˋ,lǐ zhì
3804,哩,5,核心詞,53,8,61,ㄌㄧ/ㄌㄧˇ/˙ㄌㄧ,lī/lǐ/li
3805,聯合,5,14.社會,40,38,78,ㄌㄧㄢˊ ㄏㄜˊ,lián hé
3806,聯合國,5,14.社會,10,170,180,ㄌㄧㄢˊ ㄏㄜˊ ㄍㄨㄛˊ,lián hé guó
3807,臉頰,5,7.身體、醫療,17,2,19,ㄌㄧㄢˇ ㄐㄧㄚˊ,liǎn jiá
3808,連接,5,17.科技,30,14,44,ㄌㄧㄢˊ ㄐㄧㄝ,lián jiē
3809,聯考,5,8.教育、學習,9,5,14,ㄌㄧㄢˊ ㄎㄠˇ,lián kǎo
3810,臉孔,5,7.身體、醫療,14,5,19,ㄌㄧㄢˇ ㄎㄨㄥˇ,liǎn kǒng
3811,連忙,5,核心詞,34,1,35,ㄌㄧㄢˊ ㄇㄤˊ,lián máng
3812,聯盟,5,14.社會,31,64,95,ㄌㄧㄢˊ ㄇㄥˊ,lián méng
3813,聯繫/連繫,5,6.社交、人際,45,18,63,ㄌㄧㄢˊ ㄒㄧˋ ,lián xì 
3814,連線,5,17.科技,6,5,11,ㄌㄧㄢˊ ㄒㄧㄢˋ,lián xiàn
3815,聯想,5,15.文化,22,6,28,ㄌㄧㄢˊ ㄒㄧㄤˇ,lián xiǎng
3816,連續劇,5,4.休閒、娛樂,5,3,8,ㄌㄧㄢˊ ㄒㄩˋ ㄐㄩˋ,lián xù jù
3817,量2,5,核心詞,34,167,201,ㄌㄧㄤˊ,liáng
3818,糧食,5,10.餐飲、烹飪,29,100,129,ㄌㄧㄤˊ ㄕˊ,liáng shí
3819,涼爽,5,5.交通、旅遊,6,8,14,ㄌㄧㄤˊ ㄕㄨㄤˇ,liáng shuǎng
3820,良心,5,12.安全,17,13,30,ㄌㄧㄤˊ ㄒㄧㄣ,liáng xīn
3821,料理,5,10.餐飲、烹飪,21,55,76,ㄌㄧㄠˋ ㄌㄧˇ,liào lǐ
3822,裂,5,核心詞,7,13,20,ㄌㄧㄝˋ,liè
3823,淋,5,10.餐飲、烹飪,10,13,23,ㄌㄧㄣˊ,lín
3824,臨時,5,核心詞,30,47,77,ㄌㄧㄣˊ ㄕˊ,lín shí
3825,令,5,核心詞,497,115,612,ㄌㄧㄥˋ,lìng
3826,領帶,5,9.購物、商店,10,1,11,ㄌㄧㄥˇ ㄉㄞˋ,lǐng dài
3827,領導,5,3.職業,82,36,118,ㄌㄧㄥˇ ㄉㄠˇ,lǐng dǎo
3828,靈感,5,4.休閒、娛樂,19,20,39,ㄌㄧㄥˊ ㄍㄢˇ,líng gǎn
3829,靈活,5,7.身體、醫療,19,11,30,ㄌㄧㄥˊ ㄏㄨㄛˊ,líng huó
3830,零件,5,11.公共服務,27,12,39,ㄌㄧㄥˊ ㄐㄧㄢˋ,líng jiàn
3831,領先,5,4.休閒、娛樂,19,4,23,ㄌㄧㄥˇ ㄒㄧㄢ,lǐng xiān
3832,領袖,5,14.社會,58,42,100,ㄌㄧㄥˇ ㄒㄧㄡˋ,lǐng xiù
3833,領子,5,9.購物、商店,3,2,5,ㄌㄧㄥˇ ˙ㄗ,lǐng zi
3834,流程,5,3.職業,25,18,43,ㄌㄧㄡˊ ㄔㄥˊ,liú chéng
3835,流傳,5,核心詞,28,19,47,ㄌㄧㄡˊ ㄔㄨㄢˊ,liú chuán
3836,流動,5,13.自然環境,26,29,55,ㄌㄧㄡˊ ㄉㄨㄥˋ,liú dòng
3837,流浪,5,5.交通、旅遊,17,27,44,ㄌㄧㄡˊ ㄌㄤˋ,liú làng
3838,流淚,5,核心詞,12,5,17,ㄌㄧㄡˊ ㄌㄟˋ,liú lèi
3839,流露,5,16.情緒、態度,11,3,14,ㄌㄧㄡˊ ㄌㄨˋ,liú lù
3840,流血,5,核心詞,13,13,26,ㄌㄧㄡˊ ㄒㄧㄝˇ,liú xiě
3841,留意,5,核心詞,26,10,36,ㄌㄧㄡˊ ㄧˋ,liú yì
3842,籠,5,10.餐飲、烹飪,9,8,17,ㄌㄨㄥˊ,lóng
3843,露,5,核心詞,40,21,61,ㄌㄡˋ,lòu
3844,露出,5,核心詞,62,11,73,ㄌㄡˋ ㄔㄨ,lòu chū
3845,錄,5,核心詞,12,15,27,ㄌㄨˋ,lù
3846,鹿,5,13.自然環境,28,6,34,ㄌㄨˋ,lù
3847,滷,5,10.餐飲、烹飪,4,3,7,ㄌㄨˇ,lǔ
3848,旅程,5,5.交通、旅遊,27,21,48,ㄌㄩˇ ㄔㄥˊ,lǚ chéng
3849,陸地,5,5.交通、旅遊,10,43,53,ㄌㄨˋ ㄉㄧˋ,lù dì
3850,路段,5,5.交通、旅遊,4,6,10,ㄌㄨˋ ㄉㄨㄢˋ,lù duàn
3851,路過,5,核心詞,13,4,17,ㄌㄨˋ ㄍㄨㄛˋ,lù guò
3852,錄取,5,3.職業,6,2,8,ㄌㄨˋ ㄑㄩˇ,lù qǔ
3853,旅途,5,5.交通、旅遊,13,7,20,ㄌㄩˇ ㄊㄨˊ,lǚ tú
3854,旅行社,5,5.交通、旅遊,3,2,5,ㄌㄩˇ ㄒㄧㄥˊ ㄕㄜˋ,lǚ xíng shè
3855,陸續,5,核心詞,27,34,61,ㄌㄨˋ ㄒㄩˋ,lù xù
3856,錄音,5,17.科技,13,9,22,ㄌㄨˋ ㄧㄣ,lù yīn
3857,錄音帶,5,17.科技,9,2,11,ㄌㄨˋ ㄧㄣ ㄉㄞˋ,lù yīn dài
3858,錄影,5,17.科技,7,9,16,ㄌㄨˋ ㄧㄥˇ,lù yǐng
3859,錄影帶,5,17.科技,11,3,14,ㄌㄨˋ ㄧㄥˇ ㄉㄞˋ,lù yǐng dài
3860,亂七八糟,5,核心詞,11,8,19,ㄌㄨㄢˋ ㄑㄧ ㄅㄚ ㄗㄠ,luàn qī bā zāo
3861,輪,5,核心詞,27,35,62,ㄌㄨㄣˊ,lún
3862,輪流,5,核心詞,19,15,34,ㄌㄨㄣˊ ㄌㄧㄡˊ,lún liú
3863,輪胎,5,11.公共服務,10,13,23,ㄌㄨㄣˊ ㄊㄞ,lún tāi
3864,輪椅,5,核心詞,11,22,33,ㄌㄨㄣˊ ㄧˇ,lún yǐ
3865,輪子,5,11.公共服務,6,9,15,ㄌㄨㄣˊ ˙ㄗ,lún zi
3866,落,5,核心詞,28,27,55,ㄌㄨㄛˋ,luò
3867,落後,5,核心詞,24,20,44,ㄌㄨㄛˋ ㄏㄡˋ,luò hòu
3868,邏輯,5,8.教育、學習,56,14,70,ㄌㄨㄛˊ ㄐㄧˊ,luó jí
3869,囉嗦,5,核心詞,3,4,7,ㄌㄨㄛ ˙ㄙㄨㄛ,luō suo
3870,落伍,5,核心詞,7,4,11,ㄌㄨㄛˋ ㄨˇ,luò wǔ
3871,馬鈴薯,5,10.餐飲、烹飪,14,28,42,ㄇㄚˇ ㄌㄧㄥˊ ㄕㄨˇ,mǎ líng shǔ
3872,馬馬虎虎,5,16.情緒、態度,2,2,4,ㄇㄚˇ ㄇㄚˇ ㄏㄨ ㄏㄨ,mǎ mǎ hū hū
3873,馬桶,5,2.日常起居,10,25,35,ㄇㄚˇ ㄊㄨㄥˇ,mǎ tǒng
3874,螞蟻,5,13.自然環境,14,23,37,ㄇㄚˇ ㄧˇ,mǎ yǐ
3875,埋,5,核心詞,30,19,49,ㄇㄞˊ,mái
3876,麥克風,5,17.科技,8,7,15,ㄇㄞˋ ㄎㄜˋ ㄈㄥ,mài kè fēng
3877,賣力,5,核心詞,7,4,11,ㄇㄞˋ ㄌㄧˋ,mài lì
3878,漫畫,5,4.休閒、娛樂,16,14,30,ㄇㄢˋ ㄏㄨㄚˋ,màn huà
3879,慢吞吞,5,16.情緒、態度,5,2,7,ㄇㄢˋ ㄊㄨㄣ ㄊㄨㄣ,màn tūn tūn
3880,忙碌,5,核心詞,30,41,71,ㄇㄤˊ ㄌㄨˋ,máng lù
3881,冒,5,核心詞,39,18,57,ㄇㄠˋ,mào
3882,矛盾,5,核心詞,59,15,74,ㄇㄠˊ ㄉㄨㄣˋ,máo dùn
3883,毛髮,5,7.身體、醫療,7,2,9,ㄇㄠˊ ㄈㄚˇ,máo fǎ
3884,毛毛雨,5,13.自然環境,1,1,2,ㄇㄠˊ ˙ㄇㄠ ㄩˇ,máo mao yǔ
3885,冒險,5,16.情緒、態度,43,13,56,ㄇㄠˋ ㄒㄧㄢˇ,mào xiǎn
3886,梅,5,10.餐飲、烹飪,43,14,57,ㄇㄟˊ,méi
3887,每當,5,核心詞,34,11,45,ㄇㄟˇ ㄉㄤ,měi dāng
3888,美感,5,4.休閒、娛樂,12,13,25,ㄇㄟˇ ㄍㄢˇ,měi gǎn
3889,玫瑰,5,13.自然環境,20,6,26,ㄇㄟˊ ㄍㄨㄟ,méi guī
3890,美景,5,5.交通、旅遊,8,11,19,ㄇㄟˇ ㄐㄧㄥˇ,měi jǐng
3891,魅力,5,1.個人資料,33,10,43,ㄇㄟˋ ㄌㄧˋ,mèi lì
3892,美滿,5,16.情緒、態度,12,7,19,ㄇㄟˇ ㄇㄢˇ,měi mǎn
3893,眉毛/眉,5,7.身體、醫療,33,9,42,ㄇㄟˊ ㄇㄠˊ/ㄇㄟˊ,méi máo/méi
3894,美妙,5,核心詞,19,6,25,ㄇㄟˇ ㄇㄧㄠˋ,měi miào
3895,美容,5,7.身體、醫療,6,8,14,ㄇㄟˇ ㄖㄨㄥˊ,měi róng
3896,眉頭,5,核心詞,18,3,21,ㄇㄟˊ ㄊㄡˊ,méi tóu
3897,悶1,5,5.交通、旅遊,17,11,28,ㄇㄣ,mēn
3898,門鈴,5,2.日常起居,6,1,7,ㄇㄣˊ ㄌㄧㄥˊ,mén líng
3899,門診,5,7.身體、醫療,11,10,21,ㄇㄣˊ ㄓㄣˇ,mén zhěn
3900,猛,5,核心詞,58,8,66,ㄇㄥˇ,měng
3901,猛然,5,核心詞,17,2,19,ㄇㄥˇ ㄖㄢˊ,měng rán
3902,謎,5,核心詞,18,8,26,ㄇㄧˊ,mí
3903,蜜蜂/蜂,5,13.自然環境,19,39,58,ㄇㄧˋ ㄈㄥ/ㄈㄥ,mì fēng/fēng
3904,迷糊,5,16.情緒、態度,3,2,5,ㄇㄧˊ ㄏㄨˊ,mí hú
3905,祕密/秘密,5,核心詞,91,48,139,ㄇㄧˋ ㄇㄧˋ,mì mì
3906,迷你,5,核心詞,6,8,14,ㄇㄧˊ ㄋㄧˇ,mí nǐ
3907,密切,5,核心詞,36,36,72,ㄇㄧˋ ㄑㄧㄝˋ,mì qiè
3908,祕書/秘書,5,3.職業,34,5,39,ㄇㄧˋ ㄕㄨ,mì shū
3909,迷信,5,16.情緒、態度,19,7,26,ㄇㄧˊ ㄒㄧㄣˋ,mí xìn
3910,蜜月,5,5.交通、旅遊,4,2,6,ㄇㄧˋ ㄩㄝˋ,mì yuè
3911,免,5,12.安全,24,28,52,ㄇㄧㄢˇ,miǎn
3912,免得,5,核心詞,18,6,24,ㄇㄧㄢˇ ˙ㄉㄜ,miǎn de
3913,棉花,5,13.自然環境,6,31,37,ㄇㄧㄢˊ ㄏㄨㄚ,mián huā
3914,面積,5,5.交通、旅遊,22,109,131,ㄇㄧㄢˋ ㄐㄧ,miàn jī
3915,面具,5,9.購物、商店,12,13,25,ㄇㄧㄢˋ ㄐㄩˋ,miàn jù
3916,面臨,5,12.安全,62,108,170,ㄇㄧㄢˋ ㄌㄧㄣˊ,miàn lín
3917,面貌,5,核心詞,17,18,35,ㄇㄧㄢˋ ㄇㄠˋ,miàn mào
3918,勉強,5,核心詞,42,22,64,ㄇㄧㄢˇ ㄑㄧㄤˇ,miǎn qiǎng
3919,面向,5,核心詞,26,13,39,ㄇㄧㄢˋㄒㄧㄤˋ,miàn xiàng
3920,面子,5,核心詞,18,11,29,ㄇㄧㄢˋ ˙ㄗ,miàn zi
3921,妙,5,核心詞,30,40,70,ㄇㄧㄠˋ,miào
3922,廟,5,15.文化,41,25,66,ㄇㄧㄠˋ,miào
3923,描繪,5,4.休閒、娛樂,26,8,34,ㄇㄧㄠˊ ㄏㄨㄟˋ,miáo huì
3924,描述,5,核心詞,124,33,157,ㄇㄧㄠˊ ㄕㄨˋ,miáo shù
3925,苗條,5,7.身體、醫療,5,2,7,ㄇㄧㄠˊ ㄊㄧㄠˊ,miáo tiáo
3926,描寫,5,4.休閒、娛樂,29,8,37,ㄇㄧㄠˊ ㄒㄧㄝˇ,miáo xiě
3927,滅亡,5,核心詞,19,7,26,ㄇㄧㄝˋ ㄨㄤˊ,miè wáng
3928,民調,5,14.社會,2,8,10,ㄇㄧㄣˊ ㄉㄧㄠˋ,mín diào
3929,敏感,5,核心詞,71,24,95,ㄇㄧㄣˇ ㄍㄢˇ,mǐn gǎn
3930,敏銳,5,1.個人資料,23,5,28,ㄇㄧㄣˇ ㄖㄨㄟˋ,mǐn ruì
3931,民營,5,14.社會,13,3,16,ㄇㄧㄣˊ ㄧㄥˊ,mín yíng
3932,名單,5,8.教育、學習,24,10,34,ㄇㄧㄥˊ ㄉㄢ,míng dān
3933,名貴,5,核心詞,4,2,6,ㄇㄧㄥˊ ㄍㄨㄟˋ,míng guì
3934,明亮,5,5.交通、旅遊,23,9,32,ㄇㄧㄥˊ ㄌㄧㄤˋ,míng liàng
3935,明明,5,核心詞,30,34,64,ㄇㄧㄥˊ ㄇㄧㄥˊ,míng míng
3936,命名,5,核心詞,16,10,26,ㄇㄧㄥˋ ㄇㄧㄥˊ,mìng míng
3937,明確,5,核心詞,58,22,80,ㄇㄧㄥˊ ㄑㄩㄝˋ,míng què
3938,明日,5,核心詞,13,13,26,ㄇㄧㄥˊ ㄖˋ,míng rì
3939,名聲,5,14.社會,18,5,23,ㄇㄧㄥˊ ㄕㄥ,míng shēng
3940,明顯,5,核心詞,128,118,246,ㄇㄧㄥˊ ㄒㄧㄢˇ,míng xiǎn
3941,墨,5,15.文化,17,8,25,ㄇㄛˋ,mò
3942,抹,5,核心詞,26,14,40,ㄇㄛˇ,mǒ
3943,磨,5,核心詞,17,22,39,ㄇㄛˊ / ㄇㄛˋ,mó / mò
3944,抹布,5,9.購物、商店,3,6,9,ㄇㄛˇ ㄅㄨˋ,mǒ bù
3945,模仿,5,核心詞,44,20,64,ㄇㄛˊ ㄈㄤˇ,mó fǎng
3946,魔鬼,5,15.文化,24,3,27,ㄇㄛˊ ㄍㄨㄟˇ,mó guǐ
3947,模糊,5,核心詞,39,10,49,ㄇㄛˊ ㄏㄨˊ,mó hú
3948,默默/默,5,核心詞,35,37,72,ㄇㄛˋ ㄇㄛˋ/ㄇㄛˋ,mò mò/mò
3949,陌生,5,16.情緒、態度,31,21,52,ㄇㄛˋ ㄕㄥ,mò shēng
3950,魔術,5,4.休閒、娛樂,10,10,20,ㄇㄛˊ ㄕㄨˋ,mó shù
3951,模特兒,5,9.購物、商店,10,4,14,ㄇㄛˊ ㄊㄜˋㄦ,mó tèr
3952,模型,5,3.職業,40,26,66,ㄇㄛˊ ㄒㄧㄥˊ,mó xíng
3953,模樣,5,核心詞,56,16,72,ㄇㄛˊ ㄧㄤˋ,mó yàng
3954,某,5,核心詞,463,111,574,ㄇㄡˇ,mǒu
3955,木柴/柴,5,核心詞,33,16,49,ㄇㄨˋ ㄔㄞˊ / ㄔㄞˊ,mù chái / chái
3956,目光,5,6.社交、人際,51,11,62,ㄇㄨˋ ㄍㄨㄤ,mù guāng
3957,納入,5,核心詞,19,7,26,ㄋㄚˋ ㄖㄨˋ,nà rù
3958,耐,5,核心詞,11,24,35,ㄋㄞˋ,nài
3959,耐性,5,3.職業,12,6,18,ㄋㄞˋ ㄒㄧㄥˋ,nài xìng
3960,南極,5,13.自然環境,4,17,21,ㄋㄢˊ ㄐㄧˊ,nán jí
3961,難免,5,核心詞,27,22,49,ㄋㄢˊ ㄇㄧㄢˇ,nán miǎn
3962,難受,5,核心詞,15,6,21,ㄋㄢˊ ㄕㄡˋ,nán shòu
3963,難說,5,核心詞,8,2,10,ㄋㄢˊ ㄕㄨㄛ,nán shuō
3964,難題,5,核心詞,29,14,43,ㄋㄢˊ ㄊㄧˊ,nán tí
3965,難為情,5,16.情緒、態度,5,1,6,ㄋㄢˊ ㄨㄟˊ ㄑㄧㄥˊ,nán wéi qíng
3966,難以,5,核心詞,113,63,176,ㄋㄢˊㄧˇ,nán yǐ
3967,鬧,5,核心詞,37,17,54,ㄋㄠˋ,nào
3968,腦筋,5,核心詞,18,14,32,ㄋㄠˇ ㄐㄧㄣ,nǎo jīn
3969,內行,5,核心詞,3,5,8,ㄋㄟˋ ㄏㄤˊ,nèi háng
3970,內外,5,核心詞,19,5,24,ㄋㄟˋ ㄨㄞˋ,nèi wài
3971,內向,5,1.個人資料,6,4,10,ㄋㄟˋ ㄒㄧㄤˋ,nèi xiàng
3972,內在,5,16.情緒、態度,81,18,99,ㄋㄟˋ ㄗㄞˋ,nèi zài
3973,能幹,5,核心詞,19,2,21,ㄋㄥˊ ㄍㄢˋ,néng gàn
3974,能量,5,7.身體、醫療,125,73,198,ㄋㄥˊ ㄌㄧㄤˋ,néng liàng
3975,能源,5,17.科技,18,122,140,ㄋㄥˊ ㄩㄢˊ,néng yuán
3976,泥巴,5,13.自然環境,7,9,16,ㄋㄧˊ ㄅㄚ,ní bā
3977,泥土,5,13.自然環境,18,39,57,ㄋㄧˊ ㄊㄨˇ,ní tǔ
3978,黏,5,10.餐飲、烹飪,20,33,53,ㄋㄧㄢˊ,nián
3979,年節,5,15.文化,3,4,7,ㄋㄧㄢˊ ㄐㄧㄝˊ,nián jié
3980,年幼,5,核心詞,13,4,17,ㄋㄧㄢˊ ㄧㄡˋ,nián yòu
3981,年長,5,1.個人資料,19,9,28,ㄋㄧㄢˊ ㄓㄤˇ,nián zhǎng
3982,娘家,5,1.個人資料,17,11,28,ㄋㄧㄤˊ ㄐㄧㄚ,niáng jiā
3983,尿,5,7.身體、醫療,28,9,37,ㄋㄧㄠˋ,niào
3984,寧靜,5,5.交通、旅遊,22,14,36,ㄋㄧㄥˊ ㄐㄧㄥˋ,níng jìng
3985,農場,5,2.日常起居,21,124,145,ㄋㄨㄥˊ ㄔㄤˊ,nóng cháng
3986,農村,5,2.日常起居,28,68,96,ㄋㄨㄥˊ ㄘㄨㄣ,nóng cūn
3987,農夫,5,3.職業,17,176,193,ㄋㄨㄥˊ ㄈㄨ,nóng fū
3988,農家,5,2.日常起居,8,24,32,ㄋㄨㄥˊ ㄐㄧㄚ,nóng jiā
3989,農民,5,3.職業,97,161,258,ㄋㄨㄥˊ ㄇㄧㄣˊ,nóng mín
3990,女婿,5,1.個人資料,20,4,24,ㄋㄩˇ ㄒㄩˋ,nǚ xù
3991,虐待,5,12.安全,17,8,25,ㄋㄩㄝˋ ㄉㄞˋ,nüè dài
3992,偶然,5,核心詞,29,10,39,ㄡˇ ㄖㄢˊ,ǒu rán
3993,偶像,5,4.休閒、娛樂,11,15,26,ㄡˇ ㄒㄧㄤˋ,ǒu xiàng
3994,趴,5,核心詞,18,11,29,ㄆㄚ,pā
3995,排斥,5,核心詞,22,12,34,ㄆㄞˊ ㄔˋ,pái chì
3996,排除,5,核心詞,29,16,45,ㄆㄞˊ ㄔㄨˊ,pái chú
3997,排行榜,5,4.休閒、娛樂,7,5,12,ㄆㄞˊ ㄏㄤˊ ㄅㄤˇ,pái háng bǎng
3998,排列,5,核心詞,24,9,33,ㄆㄞˊ ㄌㄧㄝˋ,pái liè
3999,派遣,5,3.職業,18,12,30,ㄆㄞˋ ㄑㄧㄢˇ,pài qiǎn
4000,拍攝,5,4.休閒、娛樂,25,35,60,ㄆㄞ ㄕㄜˋ,pāi shè
4001,判斷,5,核心詞,95,36,131,ㄆㄢˋ ㄉㄨㄢˋ,pàn duàn
4002,拚命,5,核心詞,39,4,43,ㄆㄢˋ ㄇㄧㄥˋ,pàn mìng
4003,盼望,5,核心詞,18,8,26,ㄆㄢˋ ㄨㄤˋ,pàn wàng
4004,跑道,5,5.交通、旅遊,11,7,18,ㄆㄠˇ ㄉㄠˋ,pǎo dào
4005,拋棄,5,核心詞,20,8,28,ㄆㄠ ㄑㄧˋ,pāo qì
4006,賠,5,核心詞,9,7,16,ㄆㄟˊ,péi
4007,配,5,核心詞,25,32,57,ㄆㄟˋ,pèi
4008,陪伴,5,核心詞,27,100,127,ㄆㄟˊ ㄅㄢˋ,péi bàn
4009,佩服,5,核心詞,22,23,45,ㄆㄟˋ ㄈㄨˊ,pèi fú
4010,配角,5,4.休閒、娛樂,14,3,17,ㄆㄟˋ ㄐㄧㄠˇ / ㄆㄟˋ ㄐㄩㄝˊ ,pèi jiǎo / pèi jué
4011,配偶,5,1.個人資料,22,8,30,ㄆㄟˋ ㄡˇ,pèi ǒu
4012,陪同,5,核心詞,9,5,14,ㄆㄟˊ ㄊㄨㄥˊ,péi tóng
4013,培養,5,核心詞,86,61,147,ㄆㄟˊ ㄧㄤˇ,péi yǎng
4014,盆,5,10.餐飲、烹飪,19,22,41,ㄆㄣˊ,pén
4015,噴,5,核心詞,15,106,121,ㄆㄣ,pēn
4016,碰巧,5,核心詞,7,1,8,ㄆㄥˋ ㄑㄧㄠˇ,pèng qiǎo
4017,屁,5,7.身體、醫療,7,2,9,ㄆㄧˋ,pì
4018,批,5,核心詞,83,73,156,ㄆㄧ,pī
4019,披,5,核心詞,14,13,27,ㄆㄧ,pī
4020,屁股,5,7.身體、醫療,34,13,47,ㄆㄧˋ ˙ㄍㄨ,pì gu
4021,疲倦,5,7.身體、醫療,17,4,21,ㄆㄧˊ ㄐㄩㄢˋ,pí juàn
4022,疲勞,5,7.身體、醫療,18,7,25,ㄆㄧˊ ㄌㄠˊ,pí láo
4023,譬如說/譬如,5,核心詞,48,168,216,ㄆㄧˋ ㄖㄨˊㄕㄨㄛ/ㄆㄧˋ ㄖㄨˊ,pì rúshuō/ pì rú
4024,披薩,5,10.餐飲、烹飪,6,11,17,ㄆㄧ ㄙㄚˋ,pī sà
4025,偏,5,核心詞,28,46,74,ㄆㄧㄢ,piān
4026,偏見,5,核心詞,21,4,25,ㄆㄧㄢ ㄐㄧㄢˋ,piān jiàn
4027,片刻,5,核心詞,29,4,33,ㄆㄧㄢˋ ㄎㄜˋ,piàn kè
4028,飄,5,13.自然環境,17,12,29,ㄆㄧㄠ,piāo
4029,漂白,5,核心詞,2,12,14,ㄆㄧㄠˇ ㄅㄞˊ,piǎo bái
4030,品嚐/品嘗,5,10.餐飲、烹飪,12,16,28,ㄆㄧㄣˇ ㄔㄤˊ,pǐn cháng
4031,頻繁,5,核心詞,17,28,45,ㄆㄧㄣˊ ㄈㄢˊ,pín fán
4032,頻率,5,核心詞,23,21,44,ㄆㄧㄣˊ ㄌㄩˋ,pín lǜ
4033,拼命,5,核心詞,6,15,21,ㄆㄧㄣ ㄇㄧㄥˋ,pīn mìng
4034,貧窮/貧,5,14.社會,40,111,151,ㄆㄧㄣˊ ㄑㄩㄥˊ/ㄆㄧㄣˊ,pín qióng/pín
4035,拼圖,5,4.休閒、娛樂,6,10,16,ㄆㄧㄣ ㄊㄨˊ,pīn tú
4036,品味,5,4.休閒、娛樂,18,9,27,ㄆㄧㄣˇ ㄨㄟˋ,pǐn wèi
4037,品種,5,10.餐飲、烹飪,14,75,89,ㄆㄧㄣˇ ㄓㄨㄥˇ,pǐn zhǒng
4038,坪,5,2.日常起居,11,17,28,ㄆㄧㄥˊ,píng
4039,憑,5,核心詞,55,18,73,ㄆㄧㄥˊ,píng
4040,平凡,5,核心詞,20,19,39,ㄆㄧㄥˊ ㄈㄢˊ,píng fán
4041,評估,5,核心詞,74,33,107,ㄆㄧㄥˊ ㄍㄨ,píng gū
4042,平衡,5,7.身體、醫療,76,62,138,ㄆㄧㄥˊ ㄏㄥˊ,píng héng
4043,平價,5,9.購物、商店,2,4,6,ㄆㄧㄥˊ ㄐㄧㄚˋ,píng jià
4044,評價,5,核心詞,34,9,43,ㄆㄧㄥˊ ㄐㄧㄚˋ,píng jià
4045,評量,5,8.教育、學習,20,4,24,ㄆㄧㄥˊ ㄌㄧㄤˊ,píng liáng
4046,評論,5,8.教育、學習,42,4,46,ㄆㄧㄥˊ ㄌㄨㄣˋ,píng lùn
4047,評審,5,3.職業,8,6,14,ㄆㄧㄥˊ ㄕㄣˇ,píng shěn
4048,平原,5,5.交通、旅遊,16,50,66,ㄆㄧㄥˊ ㄩㄢˊ,píng yuán
4049,潑,5,10.餐飲、烹飪,7,5,12,ㄆㄛ,pō
4050,破產,5,3.職業,12,10,22,ㄆㄛˋ ㄔㄢˇ,pò chǎn
4051,婆家,5,1.個人資料,3,3,6,ㄆㄛˊ ㄐㄧㄚ,pó jiā
4052,破舊,5,2.日常起居,9,3,12,ㄆㄛˋ ㄐㄧㄡˋ,pò jiù
4053,破損,5,7.身體、醫療,5,3,8,ㄆㄛˋ ㄙㄨㄣˇ,pò sǔn
4054,瀑布,5,13.自然環境,10,7,17,ㄆㄨˋ ㄅㄨˋ,pù bù
4055,暴露,5,12.安全,17,7,24,ㄆㄨˋ ㄌㄨˋ,pù lù
4056,棋,5,4.休閒、娛樂,16,9,25,ㄑㄧˊ,qí
4057,起初,5,核心詞,26,5,31,ㄑㄧˇ ㄔㄨ,qǐ chū
4058,其次,5,核心詞,36,14,50,ㄑㄧˊ ㄘˋ,qí cì
4059,起點,5,5.交通、旅遊,15,15,30,ㄑㄧˇ ㄉㄧㄢˇ,qǐ diǎn
4060,啟動,5,核心詞,25,32,57,ㄑㄧˇ ㄉㄨㄥˋ,qǐ dòng
4061,欺負,5,12.安全,16,14,30,ㄑㄧ ㄈㄨˋ,qī fù
4062,器官,5,7.身體、醫療,25,16,41,ㄑㄧˋ ㄍㄨㄢ,qì guān
4063,奇蹟,5,核心詞,31,24,55,ㄑㄧˊ ㄐㄧ,qí jī
4064,器具,5,2.日常起居,7,9,16,ㄑㄧˋ ㄐㄩˋ,qì jù
4065,期刊,5,8.教育、學習,19,7,26,ㄑㄧˊ ㄎㄢ,qí kān
4066,起碼,5,核心詞,24,20,44,ㄑㄧˇ ㄇㄚˇ,qǐ mǎ
4067,奇妙,5,16.情緒、態度,20,16,36,ㄑㄧˊ ㄇㄧㄠˋ,qí miào
4068,欺騙,5,12.安全,20,6,26,ㄑㄧ ㄆㄧㄢˋ,qī piàn
4069,起身,5,核心詞,38,4,42,ㄑㄧˇ ㄕㄣ,qǐ shēn
4070,歧視,5,14.社會,16,18,34,ㄑㄧˊ ㄕˋ,qí shì
4071,奇特,5,16.情緒、態度,21,10,31,ㄑㄧˊ ㄊㄜˋ,qí tè
4072,氣味,5,10.餐飲、烹飪,23,9,32,ㄑㄧˋ ㄨㄟˋ,qì wèi
4073,期限,5,核心詞,13,10,23,ㄑㄧˊ ㄒㄧㄢˋ,qí xiàn
4074,企業界,5,3.職業,13,6,19,ㄑㄧˋ ㄧㄝˋ ㄐㄧㄝˋ,qì yè jiè
4075,奇異,5,16.情緒、態度,18,8,26,ㄑㄧˊ ㄧˋ,qí yì
4076,汽油,5,11.公共服務,6,13,19,ㄑㄧˋ ㄧㄡˊ,qì yóu
4077,其餘,5,核心詞,29,6,35,ㄑㄧˊ ㄩˊ,qí yú
4078,氣質,5,1.個人資料,28,9,37,ㄑㄧˋ ㄓˊ,qì zhí
4079,恰當,5,核心詞,21,4,25,ㄑㄧㄚˋ ㄉㄤˋ,qià dàng
4080,欠,5,核心詞,18,15,33,ㄑㄧㄢˋ,qiàn
4081,牽,5,核心詞,32,28,60,ㄑㄧㄢ,qiān
4082,前輩,5,8.教育、學習,10,10,20,ㄑㄧㄢˊ ㄅㄟˋ,qián bèi
4083,錢財,5,9.購物、商店,9,3,12,ㄑㄧㄢˊ ㄘㄞˊ,qián cái
4084,前後,5,核心詞,47,16,63,ㄑㄧㄢˊ ㄏㄡˋ,qián hòu
4085,潛力,5,核心詞,20,18,38,ㄑㄧㄢˊ ㄌㄧˋ,qián lì
4086,前途,5,核心詞,31,9,40,ㄑㄧㄢˊ ㄊㄨˊ,qián tú
4087,前往,5,5.交通、旅遊,91,58,149,ㄑㄧㄢˊ ㄨㄤˇ,qián wǎng
4088,謙虛,5,6.社交、人際,12,9,21,ㄑㄧㄢ ㄒㄩ,qiān xū
4089,遷移,5,核心詞,10,11,21,ㄑㄧㄢ ㄧˊ,qiān yí
4090,簽約,5,3.職業,5,4,9,ㄑㄧㄢ ㄩㄝ,qiān yuē
4091,簽字,5,14.社會,6,0,6,ㄑㄧㄢ ㄗˋ,qiān zì
4092,牆壁/牆,5,2.日常起居,118,88,206,ㄑㄧㄤˊ ㄅㄧˋ/ㄑㄧㄤˊ,qiáng bì/qiáng
4093,強盜,5,12.安全,13,2,15,ㄑㄧㄤˊ ㄉㄠˋ,qiáng dào
4094,強調,5,核心詞,121,74,195,ㄑㄧㄤˊ ㄉㄧㄠˋ,qiáng diào
4095,搶奪,5,12.安全,5,3,8,ㄑㄧㄤˇ ㄉㄨㄛˊ,qiǎng duó
4096,強化,5,核心詞,44,13,57,ㄑㄧㄤˊ ㄏㄨㄚˋ,qiáng huà
4097,強烈,5,核心詞,103,59,162,ㄑㄧㄤˊ ㄌㄧㄝˋ,qiáng liè
4098,強迫,5,核心詞,36,10,46,ㄑㄧㄤˇ ㄆㄛˋ,qiǎng pò
4099,強權,5,14.社會,4,5,9,ㄑㄧㄤˊ ㄑㄩㄢˊ,qiáng quán
4100,強人,5,14.社會,4,4,8,ㄑㄧㄤˊ ㄖㄣˊ,qiáng rén
4101,強壯,5,7.身體、醫療,16,12,28,ㄑㄧㄤˊ ㄓㄨㄤˋ,qiáng zhuàng
4102,瞧,5,核心詞,51,10,61,ㄑㄧㄠˊ,qiáo
4103,巧,5,核心詞,23,93,116,ㄑㄧㄠˇ,qiǎo
4104,巧妙,5,16.情緒、態度,20,8,28,ㄑㄧㄠˇ ㄇㄧㄠˋ,qiǎo miào
4105,悄悄/悄,5,核心詞,40,8,48,ㄑㄧㄠˇ ㄑㄧㄠˇ/ㄑㄧㄠˇ,qiǎo qiǎo/qiǎo
4106,琴,5,4.休閒、娛樂,33,24,57,ㄑㄧㄣˊ,qín
4107,親,5,1.個人資料,63,40,103,ㄑㄧㄣ,qīn
4108,親近,5,6.社交、人際,31,25,56,ㄑㄧㄣ ㄐㄧㄣˋ,qīn jìn
4109,親口,5,核心詞,5,1,6,ㄑㄧㄣ ㄎㄡˇ,qīn kǒu
4110,親情,5,6.社交、人際,10,13,23,ㄑㄧㄣ ㄑㄧㄥˊ,qīn qíng
4111,親熱,5,核心詞,6,1,7,ㄑㄧㄣ ㄖㄜˋ,qīn rè
4112,親身,5,核心詞,17,24,41,ㄑㄧㄣ ㄕㄣ,qīn shēn
4113,親手,5,核心詞,14,29,43,ㄑㄧㄣ ㄕㄡˇ,qīn shǒu
4114,親眼,5,核心詞,20,12,32,ㄑㄧㄣ ㄧㄢˇ,qīn yǎn
4115,親友,5,1.個人資料,21,15,36,ㄑㄧㄣ ㄧㄡˇ,qīn yǒu
4116,親自,5,核心詞,79,46,125,ㄑㄧㄣ ㄗˋ,qīn zì
4117,親子,5,核心詞,31,26,57,ㄑㄧㄣ ㄗˇ,qīn zǐ
4118,情報,5,核心詞,28,16,44,ㄑㄧㄥˊ ㄅㄠˋ,qíng bào
4119,清晨,5,核心詞,27,30,57,ㄑㄧㄥ ㄔㄣˊ,qīng chén
4120,青春,5,核心詞,27,15,42,ㄑㄧㄥ ㄔㄨㄣ,qīng chūn
4121,清淡,5,10.餐飲、烹飪,4,8,12,ㄑㄧㄥ ㄉㄢˋ,qīng dàn
4122,情感,5,16.情緒、態度,76,37,113,ㄑㄧㄥˊ ㄍㄢˇ,qíng gǎn
4123,情節,5,4.休閒、娛樂,57,7,64,ㄑㄧㄥˊ ㄐㄧㄝˊ,qíng jié
4124,清潔,5,2.日常起居,14,39,53,ㄑㄧㄥ ㄐㄧㄝˊ,qīng jié
4125,清潔工,5,3.職業,2,1,3,ㄑㄧㄥ ㄐㄧㄝˊ ㄍㄨㄥ,qīng jié gōng
4126,情景,5,16.情緒、態度,25,4,29,ㄑㄧㄥˊ ㄐㄧㄥˇ,qíng jǐng
4127,晴朗,5,5.交通、旅遊,7,6,13,ㄑㄧㄥˊ ㄌㄤˇ,qíng lǎng
4128,清理,5,2.日常起居,17,27,44,ㄑㄧㄥ ㄌㄧˇ,qīng lǐ
4129,清涼,5,5.交通、旅遊,6,7,13,ㄑㄧㄥ ㄌㄧㄤˊ,qīng liáng
4130,情侶,5,6.社交、人際,7,2,9,ㄑㄧㄥˊ ㄌㄩˇ,qíng lǚ
4131,請求,5,核心詞,45,9,54,ㄑㄧㄥˇ ㄑㄧㄡˊ,qǐng qiú
4132,情人,5,6.社交、人際,24,3,27,ㄑㄧㄥˊ ㄖㄣˊ,qíng rén
4133,輕聲,5,核心詞,23,4,27,ㄑㄧㄥ ㄕㄥ,qīng shēng
4134,情勢,5,核心詞,26,27,53,ㄑㄧㄥˊ ㄕˋ,qíng shì
4135,青蛙,5,13.自然環境,24,31,55,ㄑㄧㄥ ㄨㄚ,qīng wā
4136,輕微,5,7.身體、醫療,19,12,31,ㄑㄧㄥ ㄨㄟˊ,qīng wéi
4137,清洗,5,核心詞,12,25,37,ㄑㄧㄥ ㄒㄧˇ,qīng xǐ
4138,清醒,5,2.日常起居,39,5,44,ㄑㄧㄥ ㄒㄧㄥˇ,qīng xǐng
4139,情緒,5,16.情緒、態度,307,94,401,ㄑㄧㄥˊ ㄒㄩˋ,qíng xù
4140,求婚,5,6.社交、人際,10,2,12,ㄑㄧㄡˊ ㄏㄨㄣ,qiú hūn
4141,球迷,5,4.休閒、娛樂,8,1,9,ㄑㄧㄡˊ ㄇㄧˊ,qiú mí
4142,球鞋,5,9.購物、商店,3,4,7,ㄑㄧㄡˊ ㄒㄧㄝˊ,qiú xié
4143,求學,5,8.教育、學習,11,18,29,ㄑㄧㄡˊ ㄒㄩㄝˊ,qiú xué
4144,娶,5,1.個人資料,42,20,62,ㄑㄩˇ,qǔ
4145,曲1,5,核心詞,21,10,31,ㄑㄩˇ,qǔ
4146,區別,5,核心詞,20,4,24,ㄑㄩ ㄅㄧㄝˊ,qū bié
4147,取代,5,核心詞,51,49,100,ㄑㄩˇ ㄉㄞˋ,qǔ dài
4148,取得,5,核心詞,91,58,149,ㄑㄩˇ ㄉㄜˊ,qǔ dé
4149,區分,5,核心詞,18,6,24,ㄑㄩ ㄈㄣ,qū fēn
4150,去世,5,1.個人資料,42,9,51,ㄑㄩˋ ㄕˋ,qù shì
4151,取消,5,3.職業,21,20,41,ㄑㄩˇ ㄒㄧㄠ,qǔ xiāo
4152,曲子,5,4.休閒、娛樂,15,5,20,ㄑㄩˇ ˙ㄗ,qǔ zi
4153,拳,5,核心詞,22,3,25,ㄑㄩㄢˊ,quán
4154,圈1,5,核心詞,51,56,107,ㄑㄩㄢ,quān
4155,勸告,5,16.情緒、態度,7,2,9,ㄑㄩㄢˋ ㄍㄠˋ,quàn gào
4156,權力,5,14.社會,105,23,128,ㄑㄩㄢˊ ㄌㄧˋ,quán lì
4157,全面,5,核心詞,33,27,60,ㄑㄩㄢˊ ㄇㄧㄢˋ,quán miàn
4158,全然,5,核心詞,29,9,38,ㄑㄩㄢˊ ㄖㄢˊ,quán rán
4159,權勢,5,14.社會,22,1,23,ㄑㄩㄢˊ ㄕˋ,quán shì
4160,全體,5,核心詞,25,11,36,ㄑㄩㄢˊ ㄊㄧˇ,quán tǐ
4161,拳頭,5,7.身體、醫療,14,7,21,ㄑㄩㄢˊ ˙ㄊㄡ,quán tou
4162,全職,5,3.職業,6,6,12,ㄑㄩㄢˊ ㄓˊ,quán zhí
4163,確保,5,12.安全,30,28,58,ㄑㄩㄝˋ ㄅㄠˇ,què bǎo
4164,缺乏,5,核心詞,117,59,176,ㄑㄩㄝ ㄈㄚˊ,quē fá
4165,確立,5,8.教育、學習,18,2,20,ㄑㄩㄝˋ ㄌㄧˋ,què lì
4166,確認,5,核心詞,41,29,70,ㄑㄩㄝˋ ㄖㄣˋ,què rèn
4167,缺少/缺,5,核心詞,62,95,157,ㄑㄩㄝ ㄕㄠˇ/ㄑㄩㄝ,quē shǎo/quē
4168,確實,5,核心詞,150,96,246,ㄑㄩㄝˋ ㄕˊ,què shí
4169,缺失,5,核心詞,17,4,21,ㄑㄩㄝ ㄕ,quē shī
4170,缺席,5,核心詞,6,12,18,ㄑㄩㄝ ㄒㄧˊ,quē xí
4171,缺陷,5,核心詞,24,10,34,ㄑㄩㄝ ㄒㄧㄢˋ,quē xiàn
4172,確信,5,核心詞,18,1,19,ㄑㄩㄝˋ ㄒㄧㄣˋ,què xìn
4173,群體,5,14.社會,18,7,25,ㄑㄩㄣˊ ㄊㄧˇ,qún tǐ
4174,群眾,5,14.社會,35,26,61,ㄑㄩㄣˊ ㄓㄨㄥˋ,qún zhòng
4175,染,5,核心詞,11,19,30,ㄖㄢˇ,rǎn
4176,然而,5,核心詞,355,95,450,ㄖㄢˊ ㄦˊ,rán ér
4177,燃燒,5,核心詞,24,28,52,ㄖㄢˊ ㄕㄠ,rán shāo
4178,繞,5,核心詞,41,27,68,ㄖㄠˋ,rào
4179,熱愛,5,核心詞,27,21,48,ㄖㄜˋ ㄞˋ,rè ài
4180,熱帶,5,13.自然環境,8,55,63,ㄖㄜˋ ㄉㄞˋ,rè dài
4181,熱烈,5,6.社交、人際,21,17,38,ㄖㄜˋ ㄌㄧㄝˋ,rè liè
4182,任,5,核心詞,113,70,183,ㄖㄣˋ,rèn
4183,人潮,5,9.購物、商店,11,22,33,ㄖㄣˊ ㄔㄠˊ,rén cháo
4184,認錯,5,6.社交、人際,8,5,13,ㄖㄣˋ ㄘㄨㄛˋ,rèn cuò
4185,認定,5,核心詞,36,13,49,ㄖㄣˋ ㄉㄧㄥˋ,rèn dìng
4186,人格,5,16.情緒、態度,69,12,81,ㄖㄣˊ ㄍㄜˊ,rén gé
4187,人工,5,3.職業,26,69,95,ㄖㄣˊ ㄍㄨㄥ,rén gōng
4188,人際,5,6.社交、人際,80,17,97,ㄖㄣˊ ㄐㄧˋ,rén jì
4189,人家2,5,核心詞,110,436,546,ㄖㄣˊ ˙ㄐㄧㄚ,rén jia
4190,人間,5,15.文化,50,41,91,ㄖㄣˊ ㄐㄧㄢ,rén jiān
4191,人民幣,5,11.公共服務,11,15,26,ㄖㄣˊ ㄇㄧㄣˊ ㄅㄧˋ,rén mín bì
4192,忍耐,5,16.情緒、態度,15,19,34,ㄖㄣˇ ㄋㄞˋ,rěn nài
4193,人氣,5,核心詞,7,6,13,ㄖㄣˊ ㄑㄧˋ,rén qì
4194,人情味,5,6.社交、人際,4,8,12,ㄖㄣˊ ㄑㄧㄥˊ ㄨㄟˋ,rén qíng wèi
4195,人權,5,14.社會,14,28,42,ㄖㄣˊ ㄑㄩㄢˊ,rén quán
4196,人山人海,5,4.休閒、娛樂,3,1,4,ㄖㄣˊ ㄕㄢ ㄖㄣˊ ㄏㄞˇ,rén shān rén hǎi
4197,人事,5,3.職業,22,9,31,ㄖㄣˊ ㄕˋ,rén shì
4198,人士,5,8.教育、學習,80,50,130,ㄖㄣˊ ㄕˋ,rén shì
4199,忍受,5,核心詞,46,15,61,ㄖㄣˇ ㄕㄡˋ,rěn shòu
4200,人體,5,7.身體、醫療,41,81,122,ㄖㄣˊ ㄊㄧˇ,rén tǐ
4201,認同,5,核心詞,70,41,111,ㄖㄣˋ ㄊㄨㄥˊ,rèn tóng
4202,人心,5,14.社會,41,32,73,ㄖㄣˊ ㄒㄧㄣ,rén xīn
4203,人性,5,8.教育、學習,50,19,69,ㄖㄣˊ ㄒㄧㄥˋ,rén xìng
4204,人選,5,核心詞,21,8,29,ㄖㄣˊ ㄒㄩㄢˇ,rén xuǎn
4205,人員,5,3.職業,186,175,361,ㄖㄣˊ ㄩㄢˊ,rén yuán
4206,人緣,5,6.社交、人際,5,4,9,ㄖㄣˊ ㄩㄢˊ,rén yuán
4207,仍舊,5,核心詞,20,6,26,ㄖㄥˊ ㄐㄧㄡˋ,réng jiù
4208,日落,5,核心詞,8,5,13,ㄖˋ ㄌㄨㄛˋ,rì luò
4209,日夜,5,核心詞,19,12,31,ㄖˋ ㄧㄝˋ,rì yè
4210,日益,5,核心詞,19,11,30,ㄖˋ ㄧˋ,rì yì
4211,融合,5,核心詞,24,28,52,ㄖㄨㄥˊ ㄏㄜˊ,róng hé
4212,融化,5,10.餐飲、烹飪,9,21,30,ㄖㄨㄥˊ ㄏㄨㄚˋ,róng huà
4213,融入,5,核心詞,22,35,57,ㄖㄨㄥˊ ㄖㄨˋ,róng rù
4214,揉,5,7.身體、醫療,16,11,27,ㄖㄡˊ,róu
4215,肉麻,5,核心詞,2,2,4,ㄖㄡˋ ㄇㄚˊ,ròu má
4216,柔軟,5,核心詞,20,24,44,ㄖㄡˊ ㄖㄨㄢˇ,róu ruǎn
4217,肉體,5,7.身體、醫療,17,2,19,ㄖㄡˋ ㄊㄧˇ,ròu tǐ
4218,如此,5,核心詞,511,85,596,ㄖㄨˊ ㄘˇ,rú cǐ
4219,如何,5,核心詞,606,336,942,ㄖㄨˊ ㄏㄜˊ,rú hé
4220,如同,5,核心詞,82,26,108,ㄖㄨˊ ㄊㄨㄥˊ,rú tóng
4221,入學,5,8.教育、學習,15,5,20,ㄖㄨˋ ㄒㄩㄝˊ,rù xué
4222,如意,5,核心詞,16,9,25,ㄖㄨˊ ㄧˋ,rú yì
4223,軟弱,5,16.情緒、態度,14,4,18,ㄖㄨㄢˇ ㄖㄨㄛˋ,ruǎn ruò
4224,軟體,5,3.職業,45,16,61,ㄖㄨㄢˇ ㄊㄧˇ,ruǎn tǐ
4225,弱點,5,核心詞,25,3,28,ㄖㄨㄛˋ ㄉㄧㄢˇ,ruò diǎn
4226,塞,5,核心詞,23,14,37,ㄙㄞ,sāi
4227,散1,5,核心詞,29,20,49,ㄙㄢˋ,sàn
4228,散發,5,5.交通、旅遊,15,8,23,ㄙㄢˋ ㄈㄚ,sàn fā
4229,艘,5,5.交通、旅遊,42,22,64,ㄙㄠ,sāo
4230,掃除,5,12.安全,4,1,5,ㄙㄠˇ ㄔㄨˊ,sǎo chú
4231,色情,5,4.休閒、娛樂,8,1,9,ㄙㄜˋ ㄑㄧㄥˊ,sè qíng
4232,傻,5,核心詞,28,16,44,ㄕㄚˇ,shǎ
4233,傻瓜,5,核心詞,14,6,20,ㄕㄚˇ ㄍㄨㄚ,shǎ guā
4234,殺害,5,12.安全,25,10,35,ㄕㄚ ㄏㄞˋ,shā hài
4235,殺價,5,9.購物、商店,2,2,4,ㄕㄚ ㄐㄧㄚˋ,shā jià
4236,沙漠,5,5.交通、旅遊,22,51,73,ㄕㄚ ㄇㄛˋ,shā mò
4237,傻事,5,核心詞,3,1,4,ㄕㄚˇ ㄕˋ,shǎ shì
4238,晒/曬,5,2.日常起居,12,43,55,ㄕㄞˋ  ,shài  
4239,閃,5,核心詞,27,13,40,ㄕㄢˇ,shǎn
4240,扇,5,2.日常起居,38,11,49,ㄕㄢ / ㄕㄢˋ,shān / shàn
4241,山谷,5,5.交通、旅遊,21,11,32,ㄕㄢ ㄍㄨˇ,shān gǔ
4242,山腳,5,核心詞,12,11,23,ㄕㄢ ㄐㄧㄠˇ,shān jiǎo
4243,善良,5,16.情緒、態度,32,16,48,ㄕㄢˋ ㄌㄧㄤˊ,shàn liáng
4244,山坡,5,核心詞,22,10,32,ㄕㄢ ㄆㄛ,shān pō
4245,賞,5,核心詞,34,26,60,ㄕㄤˇ,shǎng
4246,上當,5,12.安全,6,1,7,ㄕㄤˋ ㄉㄤˋ,shàng dàng
4247,傷口,5,7.身體、醫療,29,16,45,ㄕㄤ ㄎㄡˇ,shāng kǒu
4248,傷腦筋,5,核心詞,6,7,13,ㄕㄤ ㄋㄠˇ ㄐㄧㄣ,shāng nǎo jīn
4249,上升,5,核心詞,34,92,126,ㄕㄤˋ ㄕㄥ,shàng shēng
4250,上市,5,14.社會,30,7,37,ㄕㄤˋ ㄕˋ,shàng shì
4251,上述,5,核心詞,63,1,64,ㄕㄤˋ ㄕㄨˋ,shàng shù
4252,上司,5,3.職業,28,1,29,ㄕㄤˋ ㄙ,shàng sī
4253,上鎖,5,2.日常起居,4,1,5,ㄕㄤˋ ㄙㄨㄛˇ,shàng suǒ
4254,上台/上臺,5,8.教育、學習,14,19,33,ㄕㄤˋ ㄊㄞˊ,shàng tái
4255,上下,5,核心詞,48,22,70,ㄕㄤˋ ㄒㄧㄚˋ,shàng xià
4256,上演,5,4.休閒、娛樂,14,5,19,ㄕㄤˋ ㄧㄢˇ,shàng yǎn
4257,上癮,5,7.身體、醫療,9,4,13,ㄕㄤˋ ㄧㄣˇ,shàng yǐn
4258,稍微/稍,5,核心詞,98,140,238,ㄕㄠ ㄨㄟˊ / ㄕㄠ,shāo wéi / shāo
4259,燒香,5,15.文化,5,2,7,ㄕㄠ ㄒㄧㄤ,shāo xiāng
4260,蛇,5,1.個人資料,64,26,90,ㄕㄜˊ,shé
4261,射,5,核心詞,28,11,39,ㄕㄜˋ,shè
4262,捨不得,5,核心詞,13,34,47,ㄕㄜˇ ㄅㄨˋ ˙ㄉㄜ,shě bù de
4263,捨得,5,核心詞,4,6,10,ㄕㄜˇ ˙ㄉㄜ,shě de
4264,設定,5,核心詞,38,18,56,ㄕㄜˋ ㄉㄧㄥˋ,shè dìng
4265,設法,5,核心詞,45,6,51,ㄕㄜˋ ㄈㄚˇ,shè fǎ
4266,社工,5,3.職業,4,8,12,ㄕㄜˋ ㄍㄨㄥ,shè gōng
4267,社交,5,6.社交、人際,33,7,40,ㄕㄜˋ ㄐㄧㄠ,shè jiāo
4268,設立,5,8.教育、學習,43,36,79,ㄕㄜˋ ㄌㄧˋ,shè lì
4269,社群,5,核心詞,24,9,33,ㄕㄜˋ ㄑㄩㄣˊ,shè qún
4270,攝氏,5,5.交通、旅遊,8,19,27,ㄕㄜˋ ㄕˋ,shè shì
4271,舌頭/舌,5,7.身體、醫療,38,12,50,ㄕㄜˊ ˙ㄊㄡ/ㄕㄜˊ,shé tou/shé
4272,社團,5,8.教育、學習,12,16,28,ㄕㄜˋ ㄊㄨㄢˊ,shè tuán
4273,攝影,5,4.休閒、娛樂,29,60,89,ㄕㄜˋ ㄧㄥˇ,shè yǐng
4274,神話,5,15.文化,32,14,46,ㄕㄣˊ ㄏㄨㄚˋ,shén huà
4275,神經,5,7.身體、醫療,193,66,259,ㄕㄣˊ ㄐㄧㄥ,shén jīng
4276,神祕/神秘,5,15.文化,53,25,78,ㄕㄣˊ ㄇㄧˋ,shén mì
4277,身旁,5,核心詞,33,5,38,ㄕㄣ ㄆㄤˊ,shēn páng
4278,神奇,5,4.休閒、娛樂,33,42,75,ㄕㄣˊ ㄑㄧˊ,shén qí
4279,深入,5,核心詞,67,44,111,ㄕㄣ ㄖㄨˋ,shēn rù
4280,神聖,5,15.文化,27,11,38,ㄕㄣˊ ㄕㄥˋ,shén shèng
4281,神仙,5,15.文化,21,2,23,ㄕㄣˊ ㄒㄧㄢ,shén xiān
4282,身心,5,7.身體、醫療,46,27,73,ㄕㄣ ㄒㄧㄣ,shēn xīn
4283,身影,5,5.交通、旅遊,23,26,49,ㄕㄣ ㄧㄥˇ,shēn yǐng
4284,深遠,5,核心詞,17,13,30,ㄕㄣ ㄩㄢˇ,shēn yuǎn
4285,腎臟/腎,5,7.身體、醫療,33,27,60,ㄕㄣˋ ㄗㄤˋ/ㄕㄣˋ,shèn zàng/shèn
4286,升,5,核心詞,27,40,67,ㄕㄥ,shēng
4287,生存,5,核心詞,65,95,160,ㄕㄥ ㄘㄨㄣˊ,shēng cún
4288,生動,5,4.休閒、娛樂,19,9,28,ㄕㄥ ㄉㄨㄥˋ,shēng dòng
4289,生火,5,核心詞,4,4,8,ㄕㄥ ㄏㄨㄛˇ,shēng huǒ
4290,生理,5,7.身體、醫療,55,18,73,ㄕㄥ ㄌㄧˇ,shēng lǐ
4291,生態,5,13.自然環境,40,221,261,ㄕㄥ ㄊㄞˋ,shēng tài
4292,聲響,5,2.日常起居,21,4,25,ㄕㄥ ㄒㄧㄤˇ,shēng xiǎng
4293,升學,5,8.教育、學習,12,11,23,ㄕㄥ ㄒㄩㄝˊ,shēng xué
4294,剩餘,5,核心詞,7,7,14,ㄕㄥˋ ㄩˊ,shèng yú
4295,繩子/繩,5,2.日常起居,37,17,54,ㄕㄥˊ ˙ㄗ/ㄕㄥˊ,shéng zi/shéng
4296,使,5,核心詞,758,122,880,ㄕˇ,shǐ
4297,詩,5,核心詞,99,23,122,ㄕ,shī
4298,士兵,5,3.職業,63,10,73,ㄕˋ ㄅㄧㄥ,shì bīng
4299,食材,5,10.餐飲、烹飪,14,25,39,ㄕˊ ㄘㄞˊ,shí cái
4300,世代,5,核心詞,27,31,58,ㄕˋ ㄉㄞˋ,shì dài
4301,使得,5,核心詞,117,127,244,ㄕˇ ˙ㄉㄜ,shǐ de
4302,示範,5,8.教育、學習,22,43,65,ㄕˋ ㄈㄢˋ,shì fàn
4303,是非,5,16.情緒、態度,19,5,24,ㄕˋ ㄈㄟ,shì fēi
4304,是否,5,核心詞,299,80,379,ㄕˋ ㄈㄡˇ,shì fǒu
4305,師父,5,15.文化,35,33,68,ㄕ ˙ㄈㄨ,shī fu
4306,師傅,5,15.文化,31,32,63,ㄕ ㄈㄨˋ,shī fù
4307,事故,5,12.安全,18,13,31,ㄕˋ ㄍㄨˋ,shì gù
4308,時光,5,15.文化,40,24,64,ㄕˊ ㄍㄨㄤ,shí guāng
4309,實話,5,核心詞,19,10,29,ㄕˊ ㄏㄨㄚˋ,shí huà
4310,時機,5,核心詞,42,14,56,ㄕˊ ㄐㄧ,shí jī
4311,實踐,5,8.教育、學習,70,45,115,ㄕˊ ㄐㄧㄢˋ,shí jiàn
4312,事件,5,12.安全,214,144,358,ㄕˋ ㄐㄧㄢˋ,shì jiàn
4313,視覺,5,核心詞,58,19,77,ㄕˋ ㄐㄩㄝˊ,shì jué
4314,時刻,5,核心詞,71,52,123,ㄕˊ ㄎㄜˋ,shí kè
4315,時空,5,13.自然環境,25,12,37,ㄕˊ ㄎㄨㄥ,shí kōng
4316,實力,5,3.職業,37,17,54,ㄕˊ ㄌㄧˋ,shí lì
4317,勢力,5,14.社會,57,46,103,ㄕˋ ㄌㄧˋ,shì lì
4318,市民,5,14.社會,16,14,30,ㄕˋ ㄇㄧㄣˊ,shì mín
4319,失去,5,核心詞,158,82,240,ㄕ ㄑㄩˋ,shī qù
4320,十全十美,5,核心詞,5,1,6,ㄕˊ ㄑㄩㄢˊ ㄕˊ ㄇㄟˇ,shí quán shí měi
4321,詩人,5,8.教育、學習,42,8,50,ㄕ ㄖㄣˊ,shī rén
4322,事實上,5,核心詞,0,0,0,ㄕˋ ㄕˊ ㄕㄤˋ,shì shí shàng
4323,時速,5,核心詞,10,5,15,ㄕˊ ㄙㄨˋ,shí sù
4324,視為,5,核心詞,85,28,113,ㄕˋ ㄨㄟˊ,shì wéi
4325,事務,5,3.職業,39,14,53,ㄕˋ ㄨˋ,shì wù
4326,實習,5,3.職業,12,19,31,ㄕˊ ㄒㄧˊ,shí xí
4327,視線,5,2.日常起居,23,6,29,ㄕˋ ㄒㄧㄢˋ,shì xiàn
4328,事先,5,核心詞,39,17,56,ㄕˋ ㄒㄧㄢ,shì xiān
4329,事項,5,核心詞,19,5,24,ㄕˋ ㄒㄧㄤˋ,shì xiàng
4330,實驗,5,8.教育、學習,197,151,348,ㄕˊ ㄧㄢˋ,shí yàn
4331,試驗,5,7.身體、醫療,19,29,48,ㄕˋ ㄧㄢˋ,shì yàn
4332,式樣,5,9.購物、商店,4,1,5,ㄕˋ ㄧㄤˋ,shì yàng
4333,視野,5,2.日常起居,31,152,183,ㄕˋ ㄧㄝˇ,shì yě
4334,失業,5,3.職業,15,54,69,ㄕ ㄧㄝˋ,shī yè
4335,適用,5,核心詞,33,6,39,ㄕˋ ㄩㄥˋ,shì yòng
4336,石油,5,13.自然環境,18,54,72,ㄕˊ ㄧㄡˊ,shí yóu
4337,實在,5,核心詞,218,137,355,ㄕˊ ㄗㄞˋ,shí zài 
4338,師長,5,8.教育、學習,14,9,23,ㄕ ㄓㄤˇ,shī zhǎng
4339,始終,5,核心詞,73,30,103,ㄕˇ ㄓㄨㄥ,shǐ zhōng
4340,石子,5,13.自然環境,7,1,8,ㄕˊ ˙ㄗ,shí zi
4341,獅子/獅,5,13.自然環境,22,24,46,ㄕ ˙ㄗ/ㄕ,shī zi/shī
4342,失蹤,5,12.安全,20,11,31,ㄕ ㄗㄨㄥ,shī zōng
4343,十足,5,核心詞,27,16,43,ㄕˊ ㄗㄨˊ,shí zú
4344,售,5,9.購物、商店,4,2,6,ㄕㄡˋ,shòu
4345,手背,5,7.身體、醫療,4,1,5,ㄕㄡˇ ㄅㄟˋ,shǒu bèi
4346,手臂,5,7.身體、醫療,64,11,75,ㄕㄡˇ ㄅㄧˋ,shǒu bì
4347,收藏,5,4.休閒、娛樂,26,13,39,ㄕㄡ ㄘㄤˊ,shōu cáng
4348,手冊,5,核心詞,17,5,22,ㄕㄡˇ ㄘㄜˋ,shǒu cè
4349,手電筒,5,2.日常起居,9,10,19,ㄕㄡˇ ㄉㄧㄢˋ ㄊㄨㄥˇ,shǒu diàn tǒng
4350,手段,5,8.教育、學習,59,21,80,ㄕㄡˇ ㄉㄨㄢˋ,shǒu duàn
4351,手工,5,9.購物、商店,10,56,66,ㄕㄡˇ ㄍㄨㄥ,shǒu gōng
4352,受害,5,12.安全,23,15,38,ㄕㄡˋ ㄏㄞˋ,shòu hài
4353,守護,5,12.安全,19,46,65,ㄕㄡˇ ㄏㄨˋ,shǒu hù
4354,收穫,5,核心詞,22,40,62,ㄕㄡ ㄏㄨㄛˋ,shōu huò
4355,受苦,5,核心詞,17,11,28,ㄕㄡˋ ㄎㄨˇ,shòu kǔ
4356,手忙腳亂,5,核心詞,4,1,5,ㄕㄡˇ ㄇㄤˊ ㄐㄧㄠˇ ㄌㄨㄢˋ,shǒu máng jiǎo luàn
4357,壽命,5,7.身體、醫療,18,16,34,ㄕㄡˋ ㄇㄧㄥˋ,shòu mìng
4358,手勢,5,核心詞,19,13,32,ㄕㄡˇ ㄕˋ,shǒu shì
4359,收拾,5,2.日常起居,26,9,35,ㄕㄡ ㄕˊ,shōu shí
4360,手腕,5,7.身體、醫療,19,5,24,ㄕㄡˇ ㄨㄢˋ,shǒu wàn
4361,手下,5,3.職業,25,2,27,ㄕㄡˇ ㄒㄧㄚˋ,shǒu xià
4362,手心,5,7.身體、醫療,7,7,14,ㄕㄡˇ ㄒㄧㄣ,shǒu xīn
4363,手續,5,核心詞,10,5,15,ㄕㄡˇ ㄒㄩˋ,shǒu xù
4364,手掌,5,7.身體、醫療,19,4,23,ㄕㄡˇ ㄓㄤˇ,shǒu zhǎng
4365,束,5,核心詞,11,6,17,ㄕㄨˋ,shù
4366,屬,5,核心詞,81,21,102,ㄕㄨˇ,shǔ
4367,梳,5,2.日常起居,10,2,12,ㄕㄨ,shū
4368,書本,5,8.教育、學習,16,15,31,ㄕㄨ ㄅㄣˇ,shū běn
4369,書籍,5,8.教育、學習,49,16,65,ㄕㄨ ㄐㄧˊ,shū jí
4370,數據,5,17.科技,36,42,78,ㄕㄨˋ ㄐㄩˋ,shù jù
4371,樹林,5,5.交通、旅遊,27,11,38,ㄕㄨˋ ㄌㄧㄣˊ,shù lín
4372,書面,5,8.教育、學習,8,1,9,ㄕㄨ ㄇㄧㄢˋ,shū miàn
4373,數目,5,9.購物、商店,26,11,37,ㄕㄨˋ ㄇㄨˋ,shù mù
4374,暑期,5,8.教育、學習,3,3,6,ㄕㄨˇ ㄑㄧˊ,shǔ qí
4375,舒適,5,核心詞,30,30,60,ㄕㄨ ㄕˋ,shū shì
4376,數位,5,17.科技,20,11,31,ㄕㄨˋ ㄨㄟˋ,shù wèi
4377,書寫,5,8.教育、學習,34,12,46,ㄕㄨ ㄒㄧㄝˇ,shū xiě
4378,書信,5,11.公共服務,11,3,14,ㄕㄨ ㄒㄧㄣˋ,shū xìn
4379,樹葉,5,13.自然環境,14,18,32,ㄕㄨˋ ㄧㄝˋ,shù yè
4380,屬於,5,核心詞,141,157,298,ㄕㄨˇ ㄩˊ,shǔ yú
4381,樹枝,5,核心詞,26,13,39,ㄕㄨˋ ㄓ,shù zhī
4382,摔,5,核心詞,22,14,36,ㄕㄨㄞ,shuāi
4383,摔跤,5,7.身體、醫療,4,2,6,ㄕㄨㄞ ㄐㄧㄠ,shuāi jiāo
4384,率領,5,核心詞,51,7,58,ㄕㄨㄞˋ ㄌㄧㄥˇ,shuài lǐng
4385,雙胞胎,5,核心詞,13,7,20,ㄕㄨㄤ ㄅㄠ ㄊㄞ,shuāng bāo tāi
4386,雙親,5,核心詞,12,2,14,ㄕㄨㄤ ㄑㄧㄣ,shuāng qīn
4387,稅,5,9.購物、商店,10,14,24,ㄕㄨㄟˋ,shuì
4388,水分/水份,5,7.身體、醫療,24,45,69,ㄕㄨㄟˇ ㄈㄣˋ ,shuǐ fèn 
4389,說服,5,核心詞,49,21,70,ㄕㄨㄟˋ ㄈㄨˊ,shuì fú
4390,水溝,5,2.日常起居,7,10,17,ㄕㄨㄟˇ ㄍㄡ,shuǐ gōu
4391,水管,5,2.日常起居,7,19,26,ㄕㄨㄟˇ ㄍㄨㄢˇ,shuǐ guǎn
4392,水平,5,4.休閒、娛樂,18,13,31,ㄕㄨㄟˇ ㄆㄧㄥˊ,shuǐ píng
4393,水災,5,12.安全,5,48,53,ㄕㄨㄟˇ ㄗㄞ,shuǐ zāi
4394,稅制,5,14.社會,2,1,3,ㄕㄨㄟˋ ㄓˋ,shuì zhì
4395,順,5,核心詞,50,64,114,ㄕㄨㄣˋ,shùn
4396,順道,5,核心詞,5,2,7,ㄕㄨㄣˋ ㄉㄠˋ,shùn dào
4397,順序,5,核心詞,31,7,38,ㄕㄨㄣˋ ㄒㄩˋ,shùn xù
4398,順眼,5,核心詞,6,3,9,ㄕㄨㄣˋ ㄧㄢˇ,shùn yǎn
4399,說謊,5,12.安全,21,16,37,ㄕㄨㄛ ㄏㄨㄤˇ,shuō huǎng
4400,碩士,5,8.教育、學習,16,13,29,ㄕㄨㄛˋ ㄕˋ,shuò shì
4401,寺,5,15.文化,17,10,27,ㄙˋ,sì
4402,私底下/私下,5,核心詞,23,10,33,ㄙ ㄉㄧˇ ㄒㄧㄚˋ/ㄙ ㄒㄧㄚˋ,sī dǐ xià/sī xià
4403,四方,5,核心詞,10,4,14,ㄙˋ ㄈㄤ,sì fāng
4404,似乎/似,5,核心詞,382,90,472,ㄙˋ ㄏㄨ/ㄙˋ,sì hū/sì
4405,私立,5,8.教育、學習,10,7,17,ㄙ ㄌㄧˋ,sī lì
4406,寺廟,5,15.文化,10,12,22,ㄙˋ ㄇㄧㄠˋ,sì miào
4407,思念,5,16.情緒、態度,14,13,27,ㄙ ㄋㄧㄢˋ,sī niàn
4408,私人,5,1.個人資料,42,13,55,ㄙ ㄖㄣˊ,sī rén
4409,私事,5,核心詞,4,1,5,ㄙ ㄕˋ,sī shì
4410,思想,5,8.教育、學習,154,32,186,ㄙ ㄒㄧㄤˇ,sī xiǎng
4411,蒐集,5,核心詞,30,19,49,ㄙㄡ ㄐㄧˊ,sōu jí
4412,搜尋,5,17.科技,36,16,52,ㄙㄡ ㄒㄩㄣˊ,sōu xún
4413,俗話,5,15.文化,4,3,7,ㄙㄨˊ ㄏㄨㄚˋ,sú huà
4414,訴苦,5,核心詞,5,1,6,ㄙㄨˋ ㄎㄨˇ,sù kǔ
4415,俗氣,5,核心詞,3,1,4,ㄙㄨˊ ㄑㄧˋ,sú qì
4416,宿醉,5,7.身體、醫療,2,0,2,ㄙㄨˋ ㄗㄨㄟˋ,sù zuì
4417,算命,5,15.文化,8,4,12,ㄙㄨㄢˋ ㄇㄧㄥˋ,suàn mìng
4418,痠痛,5,7.身體、醫療,8,5,13,ㄙㄨㄢ ㄊㄨㄥˋ,suān tòng
4419,算帳,5,核心詞,3,1,4,ㄙㄨㄢˋ ㄓㄤˋ,suàn zhàng
4420,碎,5,核心詞,20,22,42,ㄙㄨㄟˋ,suì
4421,隨地,5,核心詞,9,8,17,ㄙㄨㄟˊ ㄉㄧˋ,suí dì
4422,隨機,5,核心詞,19,4,23,ㄙㄨㄟˊ ㄐㄧ,suí jī
4423,隨口,5,核心詞,7,1,8,ㄙㄨㄟˊ ㄎㄡˇ,suí kǒu
4424,隨身,5,核心詞,15,15,30,ㄙㄨㄟˊ ㄕㄣ,suí shēn
4425,隨手,5,核心詞,13,15,28,ㄙㄨㄟˊ ㄕㄡˇ,suí shǒu
4426,歲數,5,1.個人資料,4,2,6,ㄙㄨㄟˋ ㄕㄨˋ,suì shù
4427,隨意,5,核心詞,24,9,33,ㄙㄨㄟˊ ㄧˋ,suí yì
4428,歲月,5,核心詞,35,32,67,ㄙㄨㄟˋ ㄩㄝˋ,suì yuè
4429,隨著,5,核心詞,126,134,260,ㄙㄨㄟˊ ˙ㄓㄜ,suí zhe
4430,損壞,5,7.身體、醫療,6,7,13,ㄙㄨㄣˇ ㄏㄨㄞˋ,sǔn huài
4431,損失,5,核心詞,40,62,102,ㄙㄨㄣˇ ㄕ,sǔn shī
4432,所謂,5,核心詞,211,306,517,ㄙㄨㄛˇ ㄨㄟˋ,suǒ wèi
4433,縮小,5,核心詞,14,18,32,ㄙㄨㄛ ㄒㄧㄠˇ,suō xiǎo
4434,踏,5,核心詞,15,9,24,ㄊㄚˋ,tà
4435,塔,5,5.交通、旅遊,24,47,71,ㄊㄚˇ,tǎ
4436,塌,5,13.自然環境,4,6,10,ㄊㄚ,tā
4437,他人,5,核心詞,105,13,118,ㄊㄚ ㄖㄣˊ,tā rén
4438,太空,5,17.科技,17,28,45,ㄊㄞˋ ㄎㄨㄥ,tài kōng
4439,太空人,5,17.科技,4,5,9,ㄊㄞˋ ㄎㄨㄥ ㄖㄣˊ,tài kōng rén
4440,太平洋,5,13.自然環境,16,47,63,ㄊㄞˋ ㄆㄧㄥˊ ㄧㄤˊ,tài píng yáng
4441,抬頭,5,核心詞,40,12,52,ㄊㄞˊ ㄊㄡˊ,tái tóu
4442,嘆/歎,5,核心詞,44,1,45,ㄊㄢˋ,tàn
4443,炭,5,核心詞,5,16,21,ㄊㄢˋ,tàn
4444,貪,5,14.社會,20,28,48,ㄊㄢ,tān
4445,坦白,5,核心詞,20,17,37,ㄊㄢˇ ㄅㄞˊ,tǎn bái
4446,談話,5,核心詞,73,10,83,ㄊㄢˊ ㄏㄨㄚˋ,tán huà
4447,談論,5,核心詞,35,7,42,ㄊㄢˊ ㄌㄨㄣˋ,tán lùn
4448,嘆氣,5,核心詞,5,3,8,ㄊㄢˋ ㄑㄧˋ,tàn qì
4449,探討,5,8.教育、學習,55,34,89,ㄊㄢˋ ㄊㄠˇ,tàn tǎo
4450,貪心,5,核心詞,5,6,11,ㄊㄢ ㄒㄧㄣ,tān xīn
4451,彈性,5,2.日常起居,42,19,61,ㄊㄢˊ ㄒㄧㄥˋ,tán xìng
4452,毯子,5,5.交通、旅遊,9,6,15,ㄊㄢˇ ˙ㄗ,tǎn zi
4453,堂,5,8.教育、學習,33,34,67,ㄊㄤˊ,táng
4454,討,5,12.安全,21,10,31,ㄊㄠˇ,tǎo
4455,逃避,5,12.安全,41,12,53,ㄊㄠˊ ㄅㄧˋ,táo bì
4456,套房,5,2.日常起居,4,4,8,ㄊㄠˋ ㄈㄤˊ,tào fáng
4457,逃跑,5,12.安全,16,2,18,ㄊㄠˊ ㄆㄠˇ,táo pǎo
4458,逃生,5,12.安全,6,9,15,ㄊㄠˊ ㄕㄥ,táo shēng
4459,桃子,5,10.餐飲、烹飪,5,3,8,ㄊㄠˊ ˙ㄗ,táo zi
4460,特產,5,10.餐飲、烹飪,4,6,10,ㄊㄜˋ ㄔㄢˇ,tè chǎn
4461,特地,5,核心詞,20,28,48,ㄊㄜˋ ㄉㄧˋ,tè dì
4462,特定,5,核心詞,72,18,90,ㄊㄜˋ ㄉㄧㄥˋ,tè dìng
4463,特殊,5,核心詞,103,117,220,ㄊㄜˋ ㄕㄨ,tè shū
4464,特有,5,核心詞,18,18,36,ㄊㄜˋ ㄧㄡˇ,tè yǒu
4465,特徵,5,核心詞,45,25,70,ㄊㄜˋ ㄓㄥ,tè zhēng
4466,特質,5,1.個人資料,95,30,125,ㄊㄜˋ ㄓˊ,tè zhí
4467,疼愛,5,核心詞,12,10,22,ㄊㄥˊ ㄞˋ,téng ài
4468,替代,5,核心詞,21,15,36,ㄊㄧˋ ㄉㄞˋ,tì dài
4469,體會,5,核心詞,41,68,109,ㄊㄧˇ ㄏㄨㄟˋ,tǐ huì
4470,提及,5,核心詞,23,3,26,ㄊㄧˊ ㄐㄧˊ,tí jí
4471,提前,5,核心詞,12,10,22,ㄊㄧˊ ㄑㄧㄢˊ,tí qián
4472,體貼,5,核心詞,17,12,29,ㄊㄧˇ ㄊㄧㄝ,tǐ tiē
4473,提問,5,8.教育、學習,13,1,14,ㄊㄧˊ ㄨㄣˋ,tí wèn
4474,體溫,5,7.身體、醫療,13,9,22,ㄊㄧˇ ㄨㄣ,tǐ wēn
4475,體型,5,7.身體、醫療,12,7,19,ㄊㄧˇ ㄒㄧㄥˊ,tǐ xíng
4476,體驗,5,核心詞,59,110,169,ㄊㄧˇ ㄧㄢˋ,tǐ yàn
4477,體育,5,8.教育、學習,12,15,27,ㄊㄧˇ ㄩˋ,tǐ yù
4478,提早,5,3.職業,17,28,45,ㄊㄧˊ ㄗㄠˇ,tí zǎo
4479,添,5,核心詞,17,12,29,ㄊㄧㄢ,tiān
4480,天才,5,8.教育、學習,28,6,34,ㄊㄧㄢ ㄘㄞˊ,tiān cái
4481,田地,5,2.日常起居,14,22,36,ㄊㄧㄢˊ ㄉㄧˋ,tián dì
4482,天賦,5,核心詞,20,7,27,ㄊㄧㄢ ㄈㄨˋ,tiān fù
4483,天黑,5,核心詞,11,6,17,ㄊㄧㄢ ㄏㄟ,tiān hēi
4484,天亮,5,核心詞,11,5,16,ㄊㄧㄢ ㄌㄧㄤˋ,tiān liàng
4485,甜美,5,10.餐飲、烹飪,13,7,20,ㄊㄧㄢˊ ㄇㄟˇ,tián měi
4486,甜蜜,5,核心詞,14,9,23,ㄊㄧㄢˊ ㄇㄧˋ,tián mì
4487,天然,5,10.餐飲、烹飪,21,118,139,ㄊㄧㄢ ㄖㄢˊ,tiān rán
4488,天使,5,15.文化,35,14,49,ㄊㄧㄢ ㄕˇ,tiān shǐ
4489,天堂,5,15.文化,27,22,49,ㄊㄧㄢ ㄊㄤˊ,tiān táng
4490,天下,5,14.社會,166,42,208,ㄊㄧㄢ ㄒㄧㄚˋ,tiān xià
4491,天性,5,1.個人資料,18,6,24,ㄊㄧㄢ ㄒㄧㄥˋ,tiān xìng
4492,田野,5,5.交通、旅遊,21,12,33,ㄊㄧㄢˊ ㄧㄝˇ,tián yě
4493,天災,5,5.交通、旅遊,5,46,51,ㄊㄧㄢ ㄗㄞ,tiān zāi
4494,天真,5,核心詞,23,10,33,ㄊㄧㄢ ㄓㄣ,tiān zhēn
4495,天主教,5,1.個人資料,13,28,41,ㄊㄧㄢ ㄓㄨˇ ㄐㄧㄠˋ,tiān zhǔ jiào
4496,調1,5,10.餐飲、烹飪,23,35,58,ㄊㄧㄠˊ,tiáo
4497,挑剔,5,核心詞,12,3,15,ㄊㄧㄠ ㄊㄧ,tiāo tī
4498,調味,5,10.餐飲、烹飪,5,6,11,ㄊㄧㄠˊ ㄨㄟˋ,tiáo wèi
4499,挑選,5,核心詞,28,20,48,ㄊㄧㄠ ㄒㄩㄢˇ,tiāo xuǎn
4500,鐵馬,5,5.交通、旅遊,1,1,2,ㄊㄧㄝˇ ㄇㄚˇ,tiě mǎ
4501,挺,5,核心詞,48,33,81,ㄊㄧㄥˇ,tǐng
4502,聽從,5,核心詞,16,3,19,ㄊㄧㄥ ㄘㄨㄥˊ,tīng cóng
4503,停頓,5,16.情緒、態度,21,3,24,ㄊㄧㄥˊ ㄉㄨㄣˋ,tíng dùn
4504,聽覺,5,7.身體、醫療,17,10,27,ㄊㄧㄥ ㄐㄩㄝˊ,tīng jué
4505,停留,5,核心詞,28,23,51,ㄊㄧㄥˊ ㄌㄧㄡˊ,tíng liú
4506,庭園,5,2.日常起居,4,3,7,ㄊㄧㄥˊ ㄩㄢˊ,tíng yuán
4507,庭院,5,2.日常起居,12,6,18,ㄊㄧㄥˊ ㄩㄢˋ,tíng yuàn
4508,聽眾,5,8.教育、學習,26,6,32,ㄊㄧㄥ ㄓㄨㄥˋ,tīng zhòng
4509,銅,5,核心詞,19,12,31,ㄊㄨㄥˊ,tóng
4510,桶,5,10.餐飲、烹飪,18,42,60,ㄊㄨㄥˇ,tǒng
4511,同伴,5,核心詞,20,9,29,ㄊㄨㄥˊ ㄅㄢˋ,tóng bàn
4512,通風,5,2.日常起居,6,19,25,ㄊㄨㄥ ㄈㄥ,tōng fēng
4513,同行1,5,3.職業,18,3,21,ㄊㄨㄥˊ ㄏㄤˊ,tóng háng
4514,痛恨,5,16.情緒、態度,16,1,17,ㄊㄨㄥˋ ㄏㄣˋ,tòng hèn
4515,統計,5,8.教育、學習,42,91,133,ㄊㄨㄥˇ ㄐㄧˋ,tǒng jì
4516,痛哭,5,核心詞,11,1,12,ㄊㄨㄥˋ ㄎㄨ,tòng kū
4517,痛快,5,核心詞,10,1,11,ㄊㄨㄥˋ ㄎㄨㄞˋ,tòng kuài
4518,同理,5,核心詞,9,3,12,ㄊㄨㄥˊ ㄌㄧˇ,tóng lǐ
4519,痛罵,5,16.情緒、態度,4,0,4,ㄊㄨㄥˋ ㄇㄚˋ,tòng mà
4520,同年,5,核心詞,20,6,26,ㄊㄨㄥˊ ㄋㄧㄢˊ,tóng nián
4521,通俗,5,8.教育、學習,17,3,20,ㄊㄨㄥ ㄙㄨˊ,tōng sú
4522,通通,5,核心詞,8,54,62,ㄊㄨㄥ ㄊㄨㄥ,tōng tōng
4523,通往,5,5.交通、旅遊,26,10,36,ㄊㄨㄥ ㄨㄤˇ,tōng wǎng
4524,同鄉,5,1.個人資料,7,2,9,ㄊㄨㄥˊ ㄒㄧㄤ,tóng xiāng
4525,同行2,5,核心詞,18,3,21,ㄊㄨㄥˊ ㄒㄧㄥˊ,tóng xíng
4526,同性戀,5,14.社會,17,2,19,ㄊㄨㄥˊ ㄒㄧㄥˋ ㄌㄧㄢˋ,tóng xìng liàn
4527,通訊,5,17.科技,22,8,30,ㄊㄨㄥ ㄒㄩㄣˋ,tōng xùn
4528,通用,5,3.職業,18,3,21,ㄊㄨㄥ ㄩㄥˋ,tōng yòng
4529,同志,5,14.社會,22,1,23,ㄊㄨㄥˊ ㄓˋ,tóng zhì
4530,統治,5,14.社會,79,34,113,ㄊㄨㄥˇ ㄓˋ,tǒng zhì
4531,透,5,核心詞,25,22,47,ㄊㄡˋ,tòu
4532,透過,5,核心詞,238,337,575,ㄊㄡˋ ㄍㄨㄛˋ,tòu guò
4533,偷看,5,核心詞,7,6,13,ㄊㄡ ㄎㄢˋ,tōu kàn
4534,偷懶,5,核心詞,5,12,17,ㄊㄡ ㄌㄢˇ,tōu lǎn
4535,透露,5,核心詞,24,11,35,ㄊㄡˋ ㄌㄨˋ,tòu lù
4536,透明,5,核心詞,19,20,39,ㄊㄡˋ ㄇㄧㄥˊ,tòu míng
4537,頭腦,5,1.個人資料,36,23,59,ㄊㄡˊ ㄋㄠˇ,tóu nǎo
4538,頭皮,5,7.身體、醫療,6,1,7,ㄊㄡˊ ㄆㄧˊ,tóu pí
4539,投票,5,14.社會,14,34,48,ㄊㄡˊ ㄆㄧㄠˋ,tóu piào
4540,投手,5,4.休閒、娛樂,10,1,11,ㄊㄡˊ ㄕㄡˇ,tóu shǒu
4541,頭條,5,4.休閒、娛樂,5,2,7,ㄊㄡˊ ㄊㄧㄠˊ,tóu tiáo
4542,偷聽,5,核心詞,5,4,9,ㄊㄡ ㄊㄧㄥ,tōu tīng
4543,偷偷,5,核心詞,34,16,50,ㄊㄡ ㄊㄡ,tōu tōu
4544,投降,5,12.安全,41,5,46,ㄊㄡˊ ㄒㄧㄤˊ,tóu xiáng
4545,塗,5,核心詞,16,13,29,ㄊㄨˊ,tú
4546,圖案,5,核心詞,21,21,42,ㄊㄨˊ ㄢˋ,tú àn
4547,突出,5,核心詞,27,8,35,ㄊㄨˊ ㄔㄨ,tú chū
4548,突破,5,3.職業,43,38,81,ㄊㄨˊ ㄆㄛˋ,tú pò
4549,圖像,5,4.休閒、娛樂,18,9,27,ㄊㄨˊ ㄒㄧㄤˋ,tú xiàng
4550,團結,5,14.社會,21,24,45,ㄊㄨㄢˊ ㄐㄧㄝˊ,tuán jié
4551,團聚,5,6.社交、人際,5,9,14,ㄊㄨㄢˊ ㄐㄩˋ,tuán jù
4552,團圓,5,15.文化,5,8,13,ㄊㄨㄢˊ ㄩㄢˊ,tuán yuán
4553,推測,5,核心詞,19,10,29,ㄊㄨㄟ ㄘㄜˋ,tuī cè
4554,退出,5,3.職業,19,14,33,ㄊㄨㄟˋ ㄔㄨ,tuì chū
4555,推出,5,3.職業,48,26,74,ㄊㄨㄟ ㄔㄨ,tuī chū
4556,推翻,5,8.教育、學習,18,18,36,ㄊㄨㄟ ㄈㄢ,tuī fān
4557,推廣,5,8.教育、學習,41,91,132,ㄊㄨㄟ ㄍㄨㄤˇ,tuī guǎng
4558,推理,5,8.教育、學習,27,1,28,ㄊㄨㄟ ㄌㄧˇ,tuī lǐ
4559,推銷,5,9.購物、商店,26,8,34,ㄊㄨㄟ ㄒㄧㄠ,tuī xiāo
4560,吞,5,10.餐飲、烹飪,14,7,21,ㄊㄨㄣ,tūn
4561,拖,5,核心詞,44,25,69,ㄊㄨㄛ,tuō
4562,脫離,5,核心詞,34,31,65,ㄊㄨㄛ ㄌㄧˊ,tuō lí
4563,拖延,5,核心詞,17,2,19,ㄊㄨㄛ ㄧㄢˊ,tuō yán
4564,外出,5,核心詞,21,13,34,ㄨㄞˋ ㄔㄨ,wài chū
4565,外地,5,2.日常起居,10,21,31,ㄨㄞˋ ㄉㄧˋ,wài dì
4566,外行,5,核心詞,3,2,5,ㄨㄞˋ ㄏㄤˊ,wài háng
4567,外交,5,14.社會,25,43,68,ㄨㄞˋ ㄐㄧㄠ,wài jiāo
4568,外界,5,核心詞,35,56,91,ㄨㄞˋ ㄐㄧㄝˋ,wài jiè
4569,外來,5,核心詞,17,34,51,ㄨㄞˋ ㄌㄞˊ,wài lái
4570,外貌,5,核心詞,7,3,10,ㄨㄞˋ ㄇㄠˋ,wài mào
4571,外人,5,6.社交、人際,18,9,27,ㄨㄞˋ ㄖㄣˊ,wài rén
4572,外向,5,1.個人資料,5,2,7,ㄨㄞˋ ㄒㄧㄤˋ,wài xiàng
4573,外銷,5,5.交通、旅遊,7,14,21,ㄨㄞˋ ㄒㄧㄠ,wài xiāo
4574,外型,5,9.購物、商店,7,11,18,ㄨㄞˋ ㄒㄧㄥˊ,wài xíng
4575,外形,5,9.購物、商店,7,4,11,ㄨㄞˋ ㄒㄧㄥˊ,wài xíng
4576,外遇,5,6.社交、人際,9,4,13,ㄨㄞˋ ㄩˋ,wài yù
4577,外在,5,7.身體、醫療,43,12,55,ㄨㄞˋ ㄗㄞˋ,wài zài
4578,彎,5,核心詞,33,14,47,ㄨㄢ,wān
4579,晚輩,5,1.個人資料,4,4,8,ㄨㄢˇ ㄅㄟˋ,wǎn bèi
4580,完蛋,5,核心詞,6,10,16,ㄨㄢˊ ㄉㄢˋ,wán dàn
4581,萬分,5,核心詞,19,4,23,ㄨㄢˋ ㄈㄣ,wàn fēn
4582,玩樂,5,4.休閒、娛樂,7,6,13,ㄨㄢˊ ㄌㄜˋ,wán lè
4583,晚年,5,14.社會,21,6,27,ㄨㄢˇ ㄋㄧㄢˊ,wǎn nián
4584,彎曲,5,7.身體、醫療,18,7,25,ㄨㄢ ㄑㄩ,wān qū
4585,萬事如意,5,核心詞,0,0,0,ㄨㄢˋ ㄕˋ ㄖㄨˊ ㄧˋ,wàn shì rú yì
4586,玩耍,5,核心詞,19,10,29,ㄨㄢˊ ㄕㄨㄚˇ,wán shuǎ
4587,萬一,5,核心詞,42,41,83,ㄨㄢˋ ㄧ,wàn yī
4588,往常,5,核心詞,16,6,22,ㄨㄤˇ ㄔㄤˊ,wǎng cháng
4589,王國,5,15.文化,37,18,55,ㄨㄤˊ ㄍㄨㄛˊ,wáng guó
4590,往後,5,核心詞,27,14,41,ㄨㄤˇ ㄏㄡˋ,wǎng hòu
4591,往來,5,6.社交、人際,25,15,40,ㄨㄤˇ ㄌㄞˊ,wǎng lái
4592,網絡,5,核心詞,27,5,32,ㄨㄤˇ ㄌㄨㄛˋ,wǎng luò
4593,往事,5,15.文化,23,5,28,ㄨㄤˇ ㄕˋ,wǎng shì
4594,王子,5,15.文化,33,41,74,ㄨㄤˊ ㄗˇ,wáng zǐ
4595,圍,5,核心詞,35,22,57,ㄨㄟˊ,wéi
4596,未,5,核心詞,349,53,402,ㄨㄟˋ,wèi
4597,胃,5,7.身體、醫療,23,22,45,ㄨㄟˋ,wèi
4598,尾巴/尾,5,13.自然環境,60,33,93,ㄨㄟˇ ˙ㄅㄚ/ㄨㄟˇ,wěi ba/wěi
4599,未必,5,核心詞,31,10,41,ㄨㄟˋ ㄅㄧˋ,wèi bì
4600,維持,5,核心詞,124,98,222,ㄨㄟˊ ㄔˊ,wéi chí
4601,微風,5,13.自然環境,9,5,14,ㄨㄟˊ ㄈㄥ,wéi fēng
4602,為何,5,核心詞,90,10,100,ㄨㄟˋ ㄏㄜˊ,wèi hé
4603,維護,5,14.社會,32,40,72,ㄨㄟˊ ㄏㄨˋ,wéi hù
4604,未婚,5,1.個人資料,6,2,8,ㄨㄟˋ ㄏㄨㄣ,wèi hūn
4605,危急,5,12.安全,9,7,16,ㄨㄟˊ ㄐㄧˊ,wéi jí
4606,圍巾,5,9.購物、商店,7,7,14,ㄨㄟˊ ㄐㄧㄣ,wéi jīn
4607,味精,5,10.餐飲、烹飪,1,1,2,ㄨㄟˋ ㄐㄧㄥ,wèi jīng
4608,味覺,5,10.餐飲、烹飪,6,6,12,ㄨㄟˋ ㄐㄩㄝˊ,wèi jué
4609,胃口,5,10.餐飲、烹飪,12,4,16,ㄨㄟˋ ㄎㄡˇ,wèi kǒu
4610,威力,5,12.安全,17,25,42,ㄨㄟ ㄌㄧˋ,wēi lì
4611,微妙,5,核心詞,17,5,22,ㄨㄟˊ ㄇㄧㄠˋ,wéi miào
4612,圍裙,5,9.購物、商店,5,1,6,ㄨㄟˊ ㄑㄩㄣˊ,wéi qún
4613,圍繞,5,核心詞,19,9,28,ㄨㄟˊ ㄖㄠˋ,wéi rào
4614,偉人,5,15.文化,5,6,11,ㄨㄟˇ ㄖㄣˊ,wěi rén
4615,衛生,5,12.安全,28,79,107,ㄨㄟˋ ㄕㄥ,wèi shēng
4616,威脅,5,12.安全,68,96,164,ㄨㄟ ㄒㄧㄝˊ,wēi xié
4617,唯一,5,核心詞,155,94,249,ㄨㄟˊ ㄧ,wéi yī
4618,委員,5,3.職業,47,23,70,ㄨㄟˇ ㄩㄢˊ,wěi yuán
4619,為止,5,核心詞,68,55,123,ㄨㄟˊ ㄓˇ,wéi zhǐ
4620,吻,5,6.社交、人際,21,4,25,ㄨㄣˇ,wěn
4621,穩,5,核心詞,21,21,42,ㄨㄣˇ,wěn
4622,溫帶,5,13.自然環境,2,13,15,ㄨㄣ ㄉㄞˋ,wēn dài
4623,溫和,5,6.社交、人際,29,13,42,ㄨㄣ ㄏㄜˊ,wēn hé
4624,問候,5,6.社交、人際,11,10,21,ㄨㄣˋ ㄏㄡˋ,wèn hòu
4625,文明,5,核心詞,68,40,108,ㄨㄣˊ ㄇㄧㄥˊ,wén míng
4626,文憑,5,8.教育、學習,5,2,7,ㄨㄣˊ ㄆㄧㄥˊ,wén píng
4627,文人,5,8.教育、學習,21,12,33,ㄨㄣˊ ㄖㄣˊ,wén rén
4628,溫柔,5,核心詞,41,21,62,ㄨㄣ ㄖㄡˊ,wēn róu
4629,窩,5,核心詞,17,7,24,ㄨㄛ,wō
4630,無,5,核心詞,524,298,822,ㄨˊ,wú
4631,勿,5,核心詞,22,13,35,ㄨˋ,wù
4632,霧,5,13.自然環境,21,25,46,ㄨˋ,wù
4633,舞蹈,5,4.休閒、娛樂,23,38,61,ㄨˇ ㄉㄠˋ,wǔ dào
4634,無法,5,核心詞,593,190,783,ㄨˊ ㄈㄚˇ,wú fǎ
4635,武功,5,15.文化,31,3,34,ㄨˇ ㄍㄨㄥ,wǔ gōng
4636,無關,5,核心詞,36,7,43,ㄨˊ ㄍㄨㄢ,wú guān
4637,五花八門,5,核心詞,5,3,8,ㄨˇ ㄏㄨㄚ ㄅㄚ ㄇㄣˊ,wǔ huā bā mén
4638,誤會,5,核心詞,17,13,30,ㄨˋ ㄏㄨㄟˋ,wù huì
4639,物價,5,14.社會,7,14,21,ㄨˋ ㄐㄧㄚˋ,wù jià
4640,誤解,5,核心詞,23,9,32,ㄨˋ ㄐㄧㄝˇ,wù jiě
4641,物理,5,8.教育、學習,45,15,60,ㄨˋ ㄌㄧˇ,wù lǐ
4642,無論如何,5,核心詞,37,7,44,ㄨˊ ㄌㄨㄣˋ ㄖㄨˊ ㄏㄜˊ,wú lùn rú hé
4643,武器,5,12.安全,44,140,184,ㄨˇ ㄑㄧˋ,wǔ qì
4644,無情,5,16.情緒、態度,24,13,37,ㄨˊ ㄑㄧㄥˊ,wú qíng
4645,無窮,5,核心詞,23,8,31,ㄨˊ ㄑㄩㄥˊ,wú qióng
4646,無趣,5,4.休閒、娛樂,9,1,10,ㄨˊ ㄑㄩˋ,wú qù
4647,無數,5,核心詞,46,30,76,ㄨˊ ㄕㄨˋ,wú shù
4648,無所謂,5,核心詞,16,11,27,ㄨˊ ㄙㄨㄛˇ ㄨㄟˋ,wú suǒ wèi
4649,舞台劇,5,4.休閒、娛樂,5,5,10,ㄨˇㄊㄞˊㄐㄩˋ,wǔ tái jù
4650,物體,5,2.日常起居,34,13,47,ㄨˋ ㄊㄧˇ,wù tǐ
4651,無限,5,13.自然環境,36,31,67,ㄨˊ ㄒㄧㄢˋ,wú xiàn
4652,無形,5,13.自然環境,23,27,50,ㄨˊ ㄒㄧㄥˊ,wú xíng
4653,五顏六色,5,13.自然環境,4,4,8,ㄨˇ ㄧㄢˊ ㄌㄧㄡˋ ㄙㄜˋ,wǔ yán liù sè
4654,午夜,5,核心詞,10,2,12,ㄨˇ ㄧㄝˋ,wǔ yè
4655,無疑,5,核心詞,32,4,36,ㄨˊ ㄧˊ,wú yí
4656,無意,5,核心詞,26,9,35,ㄨˊ ㄧˋ,wú yì
4657,無知,5,16.情緒、態度,26,6,32,ㄨˊ ㄓ,wú zhī
4658,物質,5,13.自然環境,88,110,198,ㄨˋ ㄓˊ,wù zhí
4659,無助,5,16.情緒、態度,25,10,35,ㄨˊ ㄓㄨˋ,wú zhù
4660,溪,5,核心詞,23,34,57,ㄒㄧ,xī
4661,攜帶,5,核心詞,19,22,41,ㄒㄧ ㄉㄞˋ,xī dài
4662,吸毒,5,12.安全,8,8,16,ㄒㄧ ㄉㄨˊ,xī dú
4663,媳婦,5,1.個人資料,41,30,71,ㄒㄧˊ ㄈㄨˋ,xí fù
4664,膝蓋,5,7.身體、醫療,35,13,48,ㄒㄧ ㄍㄞˋ,xī gài
4665,喜好,5,核心詞,15,8,23,ㄒㄧˇ ㄏㄠˋ,xǐ hào
4666,戲劇,5,4.休閒、娛樂,34,19,53,ㄒㄧˋ ㄐㄩˋ,xì jù
4667,喜劇,5,4.休閒、娛樂,19,4,23,ㄒㄧˇ ㄐㄩˋ,xǐ jù
4668,細菌,5,13.自然環境,33,45,78,ㄒㄧˋ ㄐㄩㄣˋ,xì jùn
4669,習俗,5,15.文化,17,18,35,ㄒㄧˊ ㄙㄨˊ,xí sú
4670,系統,5,3.職業,279,193,472,ㄒㄧˋ ㄊㄨㄥˇ,xì tǒng
4671,細心,5,核心詞,18,27,45,ㄒㄧˋ ㄒㄧㄣ,xì xīn
4672,夕陽,5,核心詞,11,5,16,ㄒㄧˋ ㄧㄤˊ,xì yáng
4673,西洋,5,核心詞,20,3,23,ㄒㄧ ㄧㄤˊ,xī yáng
4674,西醫,5,7.身體、醫療,8,4,12,ㄒㄧ ㄧ,xī yī
4675,細雨,5,13.自然環境,4,5,9,ㄒㄧˋ ㄩˇ,xì yǔ
4676,戲院,5,4.休閒、娛樂,9,2,11,ㄒㄧˋ ㄩㄢˋ,xì yuàn
4677,喜悅,5,核心詞,48,23,71,ㄒㄧˇ ㄩㄝˋ,xǐ yuè
4678,下巴,5,7.身體、醫療,20,4,24,ㄒㄧㄚˋ ˙ㄅㄚ,xià ba
4679,下場,5,核心詞,17,2,19,ㄒㄧㄚˋ ㄔㄤˇ,xià chǎng
4680,下跌,5,14.社會,9,3,12,ㄒㄧㄚˋ ㄉㄧㄝˊ,xià dié
4681,下降,5,核心詞,33,54,87,ㄒㄧㄚˋ ㄐㄧㄤˋ,xià jiàng
4682,下列,5,核心詞,27,1,28,ㄒㄧㄚˋ ㄌㄧㄝˋ,xià liè
4683,下令,5,12.安全,48,13,61,ㄒㄧㄚˋ ㄌㄧㄥˋ,xià lìng
4684,夏令營,5,6.社交、人際,3,3,6,ㄒㄧㄚˋ ㄌㄧㄥˋ ㄧㄥˊ,xià lìng yíng
4685,嚇人,5,核心詞,11,10,21,ㄒㄧㄚˋ ㄖㄣˊ,xià rén
4686,夏日,5,核心詞,11,5,16,ㄒㄧㄚˋ ㄖˋ,xià rì
4687,下台,5,14.社會,6,16,22,ㄒㄧㄚˋ ㄊㄞˊ,xià tái
4688,瞎子,5,7.身體、醫療,6,1,7,ㄒㄧㄚ ˙ㄗ,xiā zi
4689,嫌,5,核心詞,34,21,55,ㄒㄧㄢˊ,xián
4690,閒,5,4.休閒、娛樂,14,10,24,ㄒㄧㄢˊ,xián
4691,縣,5,2.日常起居,30,31,61,ㄒㄧㄢˋ,xiàn
4692,現成,5,核心詞,10,6,16,ㄒㄧㄢˋ ㄔㄥˊ,xiàn chéng
4693,現代化,5,14.社會,20,17,37,ㄒㄧㄢˋ ㄉㄞˋ ㄏㄨㄚˋ,xiàn dài huà
4694,顯得,5,核心詞,82,30,112,ㄒㄧㄢˇ ˙ㄉㄜ,xiǎn de
4695,閒逛,5,4.休閒、娛樂,5,1,6,ㄒㄧㄢˊ ㄍㄨㄤˋ,xián guàng
4696,先後,5,核心詞,30,8,38,ㄒㄧㄢ ㄏㄡˋ,xiān hòu
4697,鮮花,5,13.自然環境,13,4,17,ㄒㄧㄢ ㄏㄨㄚ,xiān huā
4698,現今,5,核心詞,23,18,41,ㄒㄧㄢˋ ㄐㄧㄣ,xiàn jīn
4699,先進,5,3.職業,27,25,52,ㄒㄧㄢ ㄐㄧㄣˋ,xiān jìn
4700,陷阱,5,12.安全,25,11,36,ㄒㄧㄢˋ ㄐㄧㄥˇ,xiàn jǐng
4701,限量,5,9.購物、商店,2,3,5,ㄒㄧㄢˋ ㄌㄧㄤˋ,xiàn liàng
4702,閒聊,5,6.社交、人際,14,3,17,ㄒㄧㄢˊ ㄌㄧㄠˊ,xián liáo
4703,鮮明,5,核心詞,17,5,22,ㄒㄧㄢ ㄇㄧㄥˊ,xiān míng
4704,羨慕/羡慕,5,16.情緒、態度,22,19,41,ㄒㄧㄢˋ ㄇㄨˋ,xiàn mù
4705,先前,5,核心詞,49,13,62,ㄒㄧㄢ ㄑㄧㄢˊ,xiān qián
4706,顯然,5,核心詞,137,22,159,ㄒㄧㄢˇ ㄖㄢˊ,xiǎn rán
4707,顯示,5,核心詞,117,62,179,ㄒㄧㄢˇ ㄕˋ,xiǎn shì
4708,閒談,5,6.社交、人際,5,0,5,ㄒㄧㄢˊ ㄊㄢˊ,xián tán
4709,先天,5,核心詞,17,14,31,ㄒㄧㄢ ㄊㄧㄢ,xiān tiān
4710,線條,5,核心詞,18,10,28,ㄒㄧㄢˋ ㄊㄧㄠˊ,xiàn tiáo
4711,顯現,5,核心詞,15,5,20,ㄒㄧㄢˇ ㄒㄧㄢˋ,xiǎn xiàn
4712,顯著,5,核心詞,28,10,38,ㄒㄧㄢˇ ㄓㄨˋ,xiǎn zhù
4713,項,5,核心詞,348,191,539,ㄒㄧㄤˋ,xiàng
4714,鄉,5,核心詞,19,62,81,ㄒㄧㄤ,xiāng
4715,相愛,5,6.社交、人際,11,4,15,ㄒㄧㄤ ㄞˋ,xiāng ài
4716,想必,5,核心詞,20,6,26,ㄒㄧㄤˇ ㄅㄧˋ,xiǎng bì
4717,相比,5,核心詞,29,9,38,ㄒㄧㄤ ㄅㄧˇ,xiāng bǐ
4718,香腸,5,10.餐飲、烹飪,7,4,11,ㄒㄧㄤ ㄔㄤˊ,xiāng cháng
4719,相對,5,核心詞,76,93,169,ㄒㄧㄤ ㄉㄨㄟˋ,xiāng duì
4720,相互,5,6.社交、人際,69,34,103,ㄒㄧㄤ ㄏㄨˋ,xiāng hù
4721,相近,5,核心詞,10,9,19,ㄒㄧㄤ ㄐㄧㄣˋ,xiāng jìn
4722,向來,5,核心詞,29,18,47,ㄒㄧㄤˋ ㄌㄞˊ,xiàng lái
4723,項鍊,5,9.購物、商店,8,8,16,ㄒㄧㄤˋ ㄌㄧㄢˋ,xiàng liàn
4724,項目,5,核心詞,40,25,65,ㄒㄧㄤˋ ㄇㄨˋ,xiàng mù
4725,香氣,5,10.餐飲、烹飪,12,30,42,ㄒㄧㄤ ㄑㄧˋ,xiāng qì
4726,相親,5,6.社交、人際,3,2,5,ㄒㄧㄤˋ ㄑㄧㄣ,xiàng qīn
4727,鄉親,5,核心詞,20,35,55,ㄒㄧㄤ ㄑㄧㄣ,xiāng qīn
4728,相似,5,核心詞,41,13,54,ㄒㄧㄤ ㄙˋ,xiāng sì
4729,相遇,5,16.情緒、態度,18,12,30,ㄒㄧㄤ ㄩˋ,xiāng yù
4730,小便,5,7.身體、醫療,9,1,10,ㄒㄧㄠˇ ㄅㄧㄢˋ,xiǎo biàn
4731,消除,5,核心詞,32,11,43,ㄒㄧㄠ ㄔㄨˊ,xiāo chú
4732,消費,5,9.購物、商店,31,38,69,ㄒㄧㄠ ㄈㄟˋ,xiāo fèi
4733,消費者,5,9.購物、商店,75,106,181,ㄒㄧㄠ ㄈㄟˋ ㄓㄜˇ,xiāo fèi zhě
4734,消化,5,7.身體、醫療,27,24,51,ㄒㄧㄠ ㄏㄨㄚˋ,xiāo huà
4735,小伙子/小夥子,5,核心詞,45,1,46,ㄒㄧㄠˇ ㄏㄨㄛˇ ˙ㄗ,xiǎo huǒ zi
4736,消極,5,核心詞,22,6,28,ㄒㄧㄠ ㄐㄧˊ,xiāo jí
4737,小看,5,核心詞,6,14,20,ㄒㄧㄠˇ ㄎㄢˋ,xiǎo kàn
4738,銷路,5,9.購物、商店,5,3,8,ㄒㄧㄠ ㄌㄨˋ,xiāo lù
4739,消滅,5,12.安全,24,17,41,ㄒㄧㄠ ㄇㄧㄝˋ,xiāo miè
4740,銷售,5,3.職業,55,37,92,ㄒㄧㄠ ㄕㄡˋ,xiāo shòu
4741,孝順/孝,5,1.個人資料,22,36,58,ㄒㄧㄠˋ ㄕㄨㄣˋ/ㄒㄧㄠˋ,xiào shùn/xiào
4742,笑嘻嘻,5,核心詞,5,2,7,ㄒㄧㄠˋ ㄒㄧ ㄒㄧ,xiào xī xī
4743,效應,5,核心詞,33,58,91,ㄒㄧㄠˋ ㄧㄥˋ,xiào yìng
4744,校友,5,8.教育、學習,5,4,9,ㄒㄧㄠˋ ㄧㄡˇ,xiào yǒu
4745,小子,5,核心詞,25,4,29,ㄒㄧㄠˇ ㄗˇ/ㄒㄧㄠˇ ˙ㄗ,xiǎo zǐ/xiǎo zi
4746,小組,5,3.職業,46,28,74,ㄒㄧㄠˇ ㄗㄨˇ,xiǎo zǔ
4747,斜,5,核心詞,17,25,42,ㄒㄧㄝˊ,xié
4748,協辦,5,8.教育、學習,2,1,3,ㄒㄧㄝˊ ㄅㄢˋ,xié bàn
4749,血管,5,7.身體、醫療,24,22,46,ㄒㄧㄝˇ ㄍㄨㄢˇ,xiě guǎn
4750,協會,5,8.教育、學習,59,56,115,ㄒㄧㄝˊ ㄏㄨㄟˋ,xié huì
4751,血壓,5,7.身體、醫療,15,13,28,ㄒㄧㄝˇ ㄧㄚ,xiě yā
4752,血液,5,7.身體、醫療,46,22,68,ㄒㄧㄝˇ ㄧㄝˋ,xiě yè
4753,心愛,5,核心詞,16,3,19,ㄒㄧㄣ ㄞˋ,xīn ài
4754,心得,5,核心詞,18,16,34,ㄒㄧㄣ ㄉㄜˊ,xīn dé
4755,心動,5,16.情緒、態度,5,2,7,ㄒㄧㄣ ㄉㄨㄥˋ,xīn dòng
4756,信號,5,核心詞,16,2,18,ㄒㄧㄣˋ ㄏㄠˋ,xìn hào
4757,新進,5,3.職業,8,4,12,ㄒㄧㄣ ㄐㄧㄣˋ,xīn jìn
4758,信賴,5,核心詞,23,9,32,ㄒㄧㄣˋ ㄌㄞˋ,xìn lài
4759,心力,5,3.職業,23,23,46,ㄒㄧㄣ ㄌㄧˋ,xīn lì
4760,心理,5,7.身體、醫療,259,53,312,ㄒㄧㄣ ㄌㄧˇ,xīn lǐ
4761,心目中,5,核心詞,24,13,37,ㄒㄧㄣ ㄇㄨˋ ㄓㄨㄥ,xīn mù zhōng
4762,新奇,5,16.情緒、態度,13,6,19,ㄒㄧㄣ ㄑㄧˊ,xīn qí
4763,心事,5,16.情緒、態度,15,7,22,ㄒㄧㄣ ㄕˋ,xīn shì
4764,心思,5,核心詞,32,8,40,ㄒㄧㄣ ㄙ / ㄒㄧㄣ ˙ㄙ,xīn sī/xīn si
4765,心痛,5,16.情緒、態度,7,6,13,ㄒㄧㄣ ㄊㄨㄥˋ,xīn tòng
4766,信徒,5,15.文化,19,13,32,ㄒㄧㄣˋ ㄊㄨˊ,xìn tú
4767,信仰,5,1.個人資料,68,43,111,ㄒㄧㄣˋ ㄧㄤˇ,xìn yǎng
4768,心意,5,核心詞,22,20,42,ㄒㄧㄣ ㄧˋ,xīn yì
4769,信用,5,11.公共服務,12,6,18,ㄒㄧㄣˋ ㄩㄥˋ,xìn yòng
4770,心臟,5,7.身體、醫療,43,23,66,ㄒㄧㄣ ㄗㄤˋ,xīn zàng
4771,薪資,5,3.職業,11,7,18,ㄒㄧㄣ ㄗ,xīn zī
4772,行程,5,5.交通、旅遊,22,29,51,ㄒㄧㄥˊ ㄔㄥˊ,xíng chéng
4773,行動,5,核心詞,249,169,418,ㄒㄧㄥˊ ㄉㄨㄥˋ,xíng dòng
4774,性感,5,核心詞,7,2,9,ㄒㄧㄥˋ ㄍㄢˇ,xìng gǎn
4775,興建,5,3.職業,22,32,54,ㄒㄧㄥ ㄐㄧㄢˋ,xīng jiàn
4776,性命,5,7.身體、醫療,25,11,36,ㄒㄧㄥˋ ㄇㄧㄥˋ,xìng mìng
4777,興起1,5,核心詞,23,13,36,ㄒㄧㄥ ㄑㄧˇ,xīng qǐ
4778,形式,5,4.休閒、娛樂,99,31,130,ㄒㄧㄥˊ ㄕˋ,xíng shì
4779,行為,5,7.身體、醫療,378,104,482,ㄒㄧㄥˊ ㄨㄟˊ,xíng wéi
4780,形象,5,1.個人資料,65,27,92,ㄒㄧㄥˊ ㄒㄧㄤˋ,xíng xiàng
4781,行銷,5,3.職業,91,43,134,ㄒㄧㄥˊ ㄒㄧㄠ,xíng xiāo
4782,行政,5,3.職業,39,11,50,ㄒㄧㄥˊ ㄓㄥˋ,xíng zhèng
4783,性質,5,核心詞,41,11,52,ㄒㄧㄥˋ ㄓˊ,xìng zhí
4784,行走,5,核心詞,21,11,32,ㄒㄧㄥˊ ㄗㄡˇ,xíng zǒu
4785,雄,5,核心詞,29,12,41,ㄒㄩㄥˊ,xióng
4786,胸,5,7.身體、醫療,47,11,58,ㄒㄩㄥ,xiōng
4787,熊貓,5,13.自然環境,2,15,17,ㄒㄩㄥˊ ㄇㄠ,xióng māo
4788,凶手/兇手,5,12.安全,36,7,43,ㄒㄩㄥ ㄕㄡˇ,xiōng shǒu
4789,修改,5,核心詞,25,12,37,ㄒㄧㄡ ㄍㄞˇ,xiū gǎi
4790,休假,5,3.職業,8,5,13,ㄒㄧㄡ ㄐㄧㄚˋ,xiū jià
4791,修正,5,核心詞,29,19,48,ㄒㄧㄡ ㄓㄥˋ,xiū zhèng
4792,袖子/袖,5,9.購物、商店,16,6,22,ㄒㄧㄡˋ ˙ㄗ/ㄒㄧㄡˋ,xiù zi/xiù
4793,噓,5,核心詞,5,3,8,ㄒㄩ,xū
4794,酗酒,5,7.身體、醫療,19,3,22,ㄒㄩˋ ㄐㄧㄡˇ,xù jiǔ
4795,需求,5,核心詞,110,65,175,ㄒㄩ ㄑㄧㄡˊ,xū qiú
4796,許願,5,15.文化,3,6,9,ㄒㄩˇ ㄩㄢˋ,xǔ yuàn
4797,宣傳,5,4.休閒、娛樂,36,21,57,ㄒㄩㄢ ㄔㄨㄢˊ,xuān chuán
4798,選舉,5,14.社會,21,60,81,ㄒㄩㄢˇ ㄐㄩˇ,xuǎn jǔ
4799,選舉權,5,14.社會,2,1,3,ㄒㄩㄢˇ ㄐㄩˇ ㄑㄩㄢˊ,xuǎn jǔ quán
4800,選民,5,14.社會,10,10,20,ㄒㄩㄢˇ ㄇㄧㄣˊ,xuǎn mín
4801,選票,5,14.社會,4,7,11,ㄒㄩㄢˇ ㄆㄧㄠˋ,xuǎn piào
4802,選手,5,4.休閒、娛樂,47,18,65,ㄒㄩㄢˇ ㄕㄡˇ,xuǎn shǒu
4803,選用,5,核心詞,7,6,13,ㄒㄩㄢˇ ㄩㄥˋ,xuǎn yòng
4804,旋轉,5,核心詞,24,13,37,ㄒㄩㄢˊ ㄓㄨㄢˇ,xuán zhuǎn
4805,學科,5,8.教育、學習,25,5,30,ㄒㄩㄝˊ ㄎㄜ,xué kē
4806,學歷,5,8.教育、學習,10,9,19,ㄒㄩㄝˊ ㄌㄧˋ,xué lì
4807,學派,5,8.教育、學習,23,2,25,ㄒㄩㄝˊ ㄆㄞˋ,xué pài
4808,學士,5,8.教育、學習,10,1,11,ㄒㄩㄝˊ ㄕˋ,xué shì
4809,學術,5,8.教育、學習,59,11,70,ㄒㄩㄝˊ ㄕㄨˋ,xué shù
4810,學業,5,8.教育、學習,22,15,37,ㄒㄩㄝˊ ㄧㄝˋ,xué yè
4811,靴子,5,9.購物、商店,11,1,12,ㄒㄩㄝ ˙ㄗ,xuē zi
4812,訊號,5,2.日常起居,21,13,34,ㄒㄩㄣˋ ㄏㄠˋ,xùn hào
4813,循環,5,7.身體、醫療,48,71,119,ㄒㄩㄣˊ ㄏㄨㄢˊ,xún huán
4814,尋求,5,核心詞,62,33,95,ㄒㄩㄣˊ ㄑㄧㄡˊ,xún qiú
4815,詢問,5,核心詞,48,10,58,ㄒㄩㄣˊ ㄨㄣˋ,xún wèn
4816,訊息,5,8.教育、學習,160,60,220,ㄒㄩㄣˋ ㄒㄧˊ,xùn xí
4817,尋找,5,核心詞,115,51,166,ㄒㄩㄣˊ ㄓㄠˇ,xún zhǎo
4818,押金,5,2.日常起居,1,1,2,ㄧㄚ ㄐㄧㄣ,yā jīn
4819,亞軍,5,4.休閒、娛樂,1,2,3,ㄧㄚˋ ㄐㄩㄣ,yà jūn
4820,牙科,5,7.身體、醫療,2,4,6,ㄧㄚˊ ㄎㄜ,yá kē
4821,壓迫,5,14.社會,20,8,28,ㄧㄚ ㄆㄛˋ,yā pò
4822,壓歲錢,5,15.文化,1,4,5,ㄧㄚ ㄙㄨㄟˋ ㄑㄧㄢˊ,yā suì qián
4823,訝異,5,16.情緒、態度,18,9,27,ㄧㄚˋ ㄧˋ,yà yì
4824,沿,5,核心詞,77,44,121,ㄧㄢˊ,yán
4825,演變,5,8.教育、學習,14,10,24,ㄧㄢˇ ㄅㄧㄢˋ,yǎn biàn
4826,延長,5,核心詞,15,16,31,ㄧㄢˊ ㄔㄤˊ,yán cháng
4827,演唱,5,4.休閒、娛樂,10,5,15,ㄧㄢˇ ㄔㄤˋ,yǎn chàng
4828,研發,5,17.科技,30,46,76,ㄧㄢˊ ㄈㄚ,yán fā
4829,延後,5,3.職業,6,8,14,ㄧㄢˊ ㄏㄡˋ,yán hòu
4830,演技,5,4.休閒、娛樂,4,1,5,ㄧㄢˇ ㄐㄧˋ,yǎn jì
4831,嚴厲,5,12.安全,30,10,40,ㄧㄢˊ ㄌㄧˋ,yán lì
4832,言論,5,8.教育、學習,19,11,30,ㄧㄢˊ ㄌㄨㄣˋ,yán lùn
4833,炎熱,5,5.交通、旅遊,9,12,21,ㄧㄢˊ ㄖㄜˋ,yán rè
4834,眼神,5,6.社交、人際,59,22,81,ㄧㄢˇ ㄕㄣˊ,yǎn shén
4835,演說,5,8.教育、學習,16,16,32,ㄧㄢˇ ㄕㄨㄛ,yǎn shuō
4836,嚴肅,5,核心詞,42,20,62,ㄧㄢˊ ㄙㄨˋ,yán sù
4837,厭惡,5,16.情緒、態度,24,1,25,ㄧㄢˋ ㄨˋ,yàn wù
4838,演戲,5,4.休閒、娛樂,8,11,19,ㄧㄢˇ ㄒㄧˋ,yǎn xì
4839,言行,5,核心詞,15,5,20,ㄧㄢˊ ㄒㄧㄥˋ,yán xìng
4840,延續,5,核心詞,22,42,64,ㄧㄢˊ ㄒㄩˋ,yán xù
4841,演奏,5,4.休閒、娛樂,25,6,31,ㄧㄢˇ ㄗㄡˋ,yǎn zòu
4842,癢,5,7.身體、醫療,14,14,28,ㄧㄤˇ,yǎng
4843,養成,5,核心詞,41,41,82,ㄧㄤˇ ㄔㄥˊ,yǎng chéng
4844,養分/養份,5,7.身體、醫療,9,24,33,ㄧㄤˇ ㄈㄣˋ,yǎng fèn
4845,養家,5,3.職業,4,6,10,ㄧㄤˇ ㄐㄧㄚ,yǎng jiā
4846,養老,5,3.職業,3,3,6,ㄧㄤˇ ㄌㄠˇ,yǎng lǎo
4847,養生,5,7.身體、醫療,17,23,40,ㄧㄤˇ ㄕㄥ,yǎng shēng
4848,樣式,5,9.購物、商店,7,4,11,ㄧㄤˋ ㄕˋ,yàng shì
4849,洋裝,5,9.購物、商店,8,4,12,ㄧㄤˊ ㄓㄨㄤ,yáng zhuāng
4850,眼看,5,核心詞,22,8,30,ㄧㄢˇㄎㄢˋ,yǎnkàn
4851,喲,5,核心詞,13,4,17,ㄧㄠ,yāo
4852,要好,5,核心詞,7,4,11,ㄧㄠˋ ㄏㄠˇ,yào hǎo
4853,搖晃,5,核心詞,17,11,28,ㄧㄠˊ ㄏㄨㄤˋ,yáo huàng
4854,要命,5,核心詞,15,3,18,ㄧㄠˋ ㄇㄧㄥˋ,yào mìng
4855,要素,5,核心詞,22,5,27,ㄧㄠˋ ㄙㄨˋ,yào sù
4856,搖頭,5,核心詞,31,5,36,ㄧㄠˊ ㄊㄡˊ,yáo tóu
4857,藥丸,5,7.身體、醫療,7,2,9,ㄧㄠˋ ㄨㄢˊ,yào wán
4858,遙遠,5,核心詞,29,25,54,ㄧㄠˊ ㄩㄢˇ,yáo yuǎn
4859,夜間,5,核心詞,15,12,27,ㄧㄝˋ ㄐㄧㄢ,yè jiān
4860,夜景,5,5.交通、旅遊,1,1,2,ㄧㄝˋ ㄐㄧㄥˇ,yè jǐng
4861,野心,5,14.社會,19,3,22,ㄧㄝˇ ㄒㄧㄣ,yě xīn
4862,咦,5,核心詞,12,40,52,ㄧˊ,yí
4863,以,5,核心詞,1825,919,2744,ㄧˇ,yǐ
4864,一般而言,5,核心詞,12,3,15,ㄧˋ ㄅㄢ ㄦˊ ㄧㄢˊ,yì bān ér yán
4865,遺產,5,14.社會,18,35,53,ㄧˊ ㄔㄢˇ,yí chǎn
4866,異常,5,7.身體、醫療,42,39,81,ㄧˋ ㄔㄤˊ,yì cháng
4867,益處,5,核心詞,7,3,10,ㄧˋ ㄔㄨˋ,yì chù
4868,衣櫥,5,核心詞,5,4,9,ㄧ ㄔㄨˊ,yī chú
4869,遺傳,5,13.自然環境,30,15,45,ㄧˊ ㄔㄨㄢˊ,yí chuán
4870,一旦,5,核心詞,166,77,243,ㄧˊ ㄉㄢˋ,yí dàn
4871,一乾二淨,5,核心詞,5,0,5,ㄧˋ ㄍㄢ ㄦˋ ㄐㄧㄥˋ,yì gān èr jìng
4872,義工,5,8.教育、學習,10,9,19,ㄧˋ ㄍㄨㄥ,yì gōng
4873,遺憾,5,核心詞,40,23,63,ㄧˊ ㄏㄢˋ,yí hàn
4874,已婚,5,1.個人資料,8,1,9,ㄧˇ ㄏㄨㄣ,yǐ hūn
4875,以及/及,5,核心詞,1485,460,1945,ㄧˇ ㄐㄧˊ/ㄐㄧˊ,yǐ jí/jí
4876,依舊,5,核心詞,36,43,79,ㄧ ㄐㄧㄡˋ,yī jiù
4877,依據,5,核心詞,37,20,57,ㄧ ㄐㄩˋ,yī jù
4878,依靠,5,核心詞,23,18,41,ㄧ ㄎㄠˋ,yī kào
4879,一口氣,5,核心詞,13,6,19,ㄧˋ ㄎㄡˇ ㄑㄧˋ,yì kǒu qì
4880,依賴,5,核心詞,54,24,78,ㄧ ㄌㄞˋ,yī lài
4881,一連,5,核心詞,16,5,21,ㄧˋ ㄌㄧㄢˊ,yì lián
4882,一連串,5,核心詞,34,29,63,ㄧˋ ㄌㄧㄢˊ ㄔㄨㄢˋ,yì lián chuàn
4883,醫療,5,7.身體、醫療,63,145,208,ㄧ ㄌㄧㄠˊ,yī liáo
4884,一流,5,3.職業,16,4,20,ㄧˋ ㄌㄧㄡˊ,yì liú
4885,以免,5,12.安全,34,12,46,ㄧˇ ㄇㄧㄢˇ,yǐ miǎn
4886,一模一樣,5,核心詞,20,15,35,ㄧˋ ㄇㄛˊ ㄧˊ ㄧㄤˋ,yì mó yí yàng
4887,儀器,5,17.科技,20,32,52,ㄧˊ ㄑㄧˋ,yí qì
4888,一清二楚,5,核心詞,7,2,9,ㄧˋ ㄑㄧㄥ ㄦˋ ㄔㄨˇ,yì qīng èr chǔ
4889,藝人,5,4.休閒、娛樂,7,13,20,ㄧˋ ㄖㄣˊ,yì rén
4890,意識,5,8.教育、學習,134,34,168,ㄧˋ ㄕˋ,yì shì
4891,遺忘,5,核心詞,20,11,31,ㄧˊ ㄨㄤˋ,yí wàng
4892,以往,5,核心詞,34,29,63,ㄧˇ ㄨㄤˇ,yǐ wǎng
4893,疑問,5,核心詞,37,20,57,ㄧˊ ㄨㄣˋ,yí wèn
4894,義務,5,14.社會,23,13,36,ㄧˋ ㄨˋ,yì wù
4895,醫藥,5,7.身體、醫療,11,6,17,ㄧ ㄧㄠˋ,yī yào
4896,意義,5,核心詞,243,142,385,ㄧˋ ㄧˋ,yì yì
4897,意願,5,核心詞,23,16,39,ㄧˋ ㄩㄢˋ,yì yuàn
4898,一早,5,核心詞,15,9,24,ㄧˋ ㄗㄠˇ,yì zǎo
4899,依照,5,核心詞,39,33,72,ㄧ ㄓㄠˋ,yī zhào
4900,一致,5,核心詞,63,27,90,ㄧˊ ㄓˋ,yí zhì
4901,醫治,5,7.身體、醫療,7,12,19,ㄧ ㄓˋ,yī zhì
4902,印,5,8.教育、學習,24,28,52,ㄧㄣˋ,yìn
4903,癮,5,核心詞,4,2,6,ㄧㄣˇ,yǐn
4904,陰,5,13.自然環境,27,3,30,ㄧㄣ,yīn
4905,隱藏,5,核心詞,35,14,49,ㄧㄣˇ ㄘㄤˊ,yǐn cáng
4906,因而,5,核心詞,106,18,124,ㄧㄣ ㄦˊ,yīn ér
4907,引發,5,12.安全,70,68,138,ㄧㄣˇ ㄈㄚ,yǐn fā
4908,陰謀,5,12.安全,20,3,23,ㄧㄣ ㄇㄡˊ,yīn móu
4909,引擎,5,11.公共服務,26,12,38,ㄧㄣˇ ㄑㄧㄥˊ,yǐn qíng
4910,音效,5,4.休閒、娛樂,5,2,7,ㄧㄣ ㄒㄧㄠˋ,yīn xiào
4911,隱形,5,核心詞,5,3,8,ㄧㄣˇ ㄒㄧㄥˊ,yǐn xíng
4912,隱形眼鏡,5,9.購物、商店,3,1,4,ㄧㄣˇ ㄒㄧㄥˊ ㄧㄢˇ ㄐㄧㄥˋ,yǐn xíng yǎn jìng
4913,陰影,5,13.自然環境,26,19,45,ㄧㄣ ㄧㄥˇ,yīn yǐng
4914,引用,5,8.教育、學習,26,8,34,ㄧㄣˇ ㄩㄥˋ,yǐn yòng
4915,印章/圖章,5,11.公共服務,5,3,8,ㄧㄣˋ ㄓㄤ/ㄊㄨˊ ㄓㄤ,yìn zhāng/tú zhāng
4916,英鎊,5,11.公共服務,10,8,18,ㄧㄥ ㄅㄤˋ,yīng bàng
4917,影本,5,8.教育、學習,2,1,3,ㄧㄥˇ ㄅㄣˇ,yǐng běn
4918,贏得,5,4.休閒、娛樂,38,15,53,ㄧㄥˊ ㄉㄜˊ,yíng dé
4919,應付,5,核心詞,45,16,61,ㄧㄥ ㄈㄨˋ  ,yīng fù  
4920,影集,5,4.休閒、娛樂,6,4,10,ㄧㄥˇ ㄐㄧˊ,yǐng jí
4921,贏家,5,4.休閒、娛樂,8,2,10,ㄧㄥˊ ㄐㄧㄚ,yíng jiā
4922,迎接,5,6.社交、人際,36,24,60,ㄧㄥˊ ㄐㄧㄝ,yíng jiē
4923,英俊,5,核心詞,16,1,17,ㄧㄥ ㄐㄩㄣˋ,yīng jùn
4924,螢幕,5,4.休閒、娛樂,26,27,53,ㄧㄥˊ ㄇㄨˋ,yíng mù
4925,櫻桃,5,10.餐飲、烹飪,6,4,10,ㄧㄥ ㄊㄠˊ,yīng táo
4926,硬體,5,3.職業,9,8,17,ㄧㄥˋ ㄊㄧˇ,yìng tǐ
4927,營養,5,10.餐飲、烹飪,44,137,181,ㄧㄥˊ ㄧㄤˇ,yíng yǎng
4928,營業,5,3.職業,15,7,22,ㄧㄥˊ ㄧㄝˋ,yíng yè
4929,應用,5,3.職業,69,28,97,ㄧㄥˋ ㄩㄥˋ,yìng yòng
4930,應有盡有,5,核心詞,3,1,4,ㄧㄥ ㄧㄡˇ ㄐㄧㄣˋ ㄧㄡˇ,yīng yǒu jìn yǒu
4931,影展,5,4.休閒、娛樂,9,4,13,ㄧㄥˇ ㄓㄢˇ,yǐng zhǎn
4932,應徵,5,3.職業,8,4,12,ㄧㄥˋ ㄓㄥ,yìng zhēng
4933,擁抱,5,6.社交、人際,40,21,61,ㄩㄥˇ ㄅㄠˋ,yǒng bào
4934,永久,5,核心詞,13,12,25,ㄩㄥˇ ㄐㄧㄡˇ,yǒng jiǔ
4935,用來,5,核心詞,98,73,171,ㄩㄥˋ ㄌㄞˊ,yòng lái
4936,用途,5,3.職業,19,28,47,ㄩㄥˋ ㄊㄨˊ,yòng tú
4937,擁有,5,核心詞,196,132,328,ㄩㄥˇ ㄧㄡˇ,yǒng yǒu
4938,幼兒,5,核心詞,35,6,41,ㄧㄡˋ ㄦˊ,yòu ér
4939,有害,5,7.身體、醫療,13,14,27,ㄧㄡˇ ㄏㄞˋ,yǒu hài
4940,友好,5,6.社交、人際,10,7,17,ㄧㄡˇ ㄏㄠˇ,yǒu hǎo
4941,有機,5,10.餐飲、烹飪,13,325,338,ㄧㄡˇ ㄐㄧ,yǒu jī
4942,遊覽,5,5.交通、旅遊,5,3,8,ㄧㄡˊ ㄌㄢˇ,yóu lǎn
4943,有利,5,核心詞,29,10,39,ㄧㄡˇ ㄌㄧˋ,yǒu lì
4944,有力,5,核心詞,28,7,35,ㄧㄡˇ ㄌㄧˋ,yǒu lì
4945,憂慮,5,核心詞,25,5,30,ㄧㄡ ㄌㄩˋ,yōu lǜ
4946,幽默,5,1.個人資料,29,23,52,ㄧㄡ ㄇㄛˋ,yōu mò
4947,幼年,5,1.個人資料,9,3,12,ㄧㄡˋ ㄋㄧㄢˊ,yòu nián
4948,友情,5,6.社交、人際,9,6,15,ㄧㄡˇ ㄑㄧㄥˊ,yǒu qíng
4949,友善,5,6.社交、人際,22,108,130,ㄧㄡˇ ㄕㄢˋ,yǒu shàn
4950,遊玩,5,4.休閒、娛樂,7,5,12,ㄧㄡˊ ㄨㄢˊ,yóu wán
4951,有限,5,核心詞,59,49,108,ㄧㄡˇ ㄒㄧㄢˋ,yǒu xiàn
4952,優先,5,核心詞,23,16,39,ㄧㄡ ㄒㄧㄢ,yōu xiān
4953,有心,5,核心詞,17,28,45,ㄧㄡˇ ㄒㄧㄣ,yǒu xīn
4954,遊行,5,14.社會,10,19,29,ㄧㄡˊ ㄒㄧㄥˊ,yóu xíng
4955,有形,5,核心詞,7,8,15,ㄧㄡˇ ㄒㄧㄥˊ,yǒu xíng
4956,優秀,5,核心詞,45,23,68,ㄧㄡ ㄒㄧㄡˋ,yōu xiù
4957,友誼,5,6.社交、人際,28,16,44,ㄧㄡˇ ㄧˋ,yǒu yì
4958,有意,5,16.情緒、態度,29,6,35,ㄧㄡˇ ㄧˋ,yǒu yì
4959,猶豫,5,核心詞,32,13,45,ㄧㄡˊ ㄩˋ,yóu yù
4960,憂鬱,5,7.身體、醫療,51,8,59,ㄧㄡ ㄩˋ,yōu yù
4961,幼稚,5,核心詞,10,6,16,ㄧㄡˋ ㄓˋ,yòu zhì
4962,於,5,核心詞,1026,269,1295,ㄩˊ,yú
4963,餘,5,核心詞,12,13,25,ㄩˊ,yú
4964,玉,5,核心詞,24,19,43,ㄩˋ,yù
4965,預備,5,核心詞,13,15,28,ㄩˋ ㄅㄟˋ,yù bèi
4966,預測,5,核心詞,69,34,103,ㄩˋ ㄘㄜˋ,yù cè
4967,預定,5,核心詞,14,9,23,ㄩˋ ㄉㄧㄥˋ,yù dìng
4968,預訂,5,4.休閒、娛樂,3,2,5,ㄩˋ ㄉㄧㄥˋ,yù dìng
4969,預防,5,12.安全,44,59,103,ㄩˋ ㄈㄤˊ,yù fáng
4970,預告,5,核心詞,4,3,7,ㄩˋ ㄍㄠˋ,yù gào
4971,預計,5,核心詞,9,50,59,ㄩˋ ㄐㄧˋ,yù jì
4972,娛樂,5,4.休閒、娛樂,29,12,41,ㄩˊ ㄌㄜˋ,yú lè
4973,漁民,5,3.職業,9,14,23,ㄩˊ ㄇㄧㄣˊ,yú mín
4974,語氣,5,核心詞,43,6,49,ㄩˇ ㄑㄧˋ,yǔ qì
4975,預賽,5,4.休閒、娛樂,1,0,1,ㄩˋ ㄙㄞˋ,yù sài
4976,預算,5,3.職業,19,35,54,ㄩˋ ㄙㄨㄢˋ,yù suàn
4977,慾望/欲望/慾,5,16.情緒、態度,51,25,76,ㄩˋ ㄨㄤˋ/ㄩˋ,yù wàng/yù
4978,語文,5,1.個人資料,13,6,19,ㄩˇ ㄨㄣˊ,yǔ wén
4979,預先/預,5,核心詞,26,21,47,ㄩˋ ㄒㄧㄢ/ㄩˋ,yù xiān/yù
4980,預言,5,15.文化,21,5,26,ㄩˋ ㄧㄢˊ,yù yán
4981,愉悅,5,核心詞,23,6,29,ㄩˊ ㄩㄝˋ,yú yuè
4982,預約,5,7.身體、醫療,5,4,9,ㄩˋ ㄩㄝ,yù yuē
4983,宇宙,5,13.自然環境,82,19,101,ㄩˇ ㄓㄡˋ,yǔ zhòu
4984,願,5,核心詞,122,69,191,ㄩㄢˋ,yuàn
4985,緣分/緣份,5,6.社交、人際,7,13,20,ㄩㄢˊ ㄈㄣˋ,yuán fèn
4986,緣故,5,核心詞,27,4,31,ㄩㄢˊ ㄍㄨˋ,yuán gù
4987,原來如此,5,核心詞,7,6,13,ㄩㄢˊ ㄌㄞˊ ㄖㄨˊ ㄘˇ,yuán lái rú cǐ
4988,原料,5,3.職業,19,49,68,ㄩㄢˊ ㄌㄧㄠˋ,yuán liào
4989,圓滿,5,核心詞,19,34,53,ㄩㄢˊ ㄇㄢˇ,yuán mǎn
4990,圓圈,5,核心詞,9,4,13,ㄩㄢˊ ㄑㄩㄢ,yuán quān
4991,原始,5,核心詞,38,36,74,ㄩㄢˊ ㄕˇ,yuán shǐ
4992,原先,5,核心詞,36,15,51,ㄩㄢˊ ㄒㄧㄢ,yuán xiān
4993,怨言,5,核心詞,5,4,9,ㄩㄢˋ ㄧㄢˊ,yuàn yán
4994,原則上,5,核心詞,1,2,3,ㄩㄢˊ ㄗㄜˊ ㄕㄤˋ,yuán zé shàng
4995,原住民,5,1.個人資料,31,58,89,ㄩㄢˊ ㄓㄨˋ ㄇㄧㄣˊ,yuán zhù mín
4996,源自,5,核心詞,16,11,27,ㄩㄢˊ ㄗˋ,yuán zì
4997,約定,5,核心詞,19,8,27,ㄩㄝ ㄉㄧㄥˋ,yuē dìng
4998,樂隊,5,4.休閒、娛樂,7,2,9,ㄩㄝˋ ㄉㄨㄟˋ,yuè duì
4999,月分,5,核心詞,1,1,2,ㄩㄝˋ ㄈㄣˋ,yuè fèn
5000,岳父,5,6.社交、人際,7,2,9,ㄩㄝˋ ㄈㄨˋ,yuè fù
5001,岳母,5,6.社交、人際,4,4,8,ㄩㄝˋ ㄇㄨˇ,yuè mǔ
5002,樂器,5,4.休閒、娛樂,18,16,34,ㄩㄝˋ ㄑㄧˋ,yuè qì
5003,暈1,5,7.身體、醫療,5,5,10,ㄩㄣ,yūn
5004,暈倒,5,7.身體、醫療,3,2,5,ㄩㄣ ㄉㄠˇ,yūn dǎo
5005,運動會,5,4.休閒、娛樂,5,8,13,ㄩㄣˋ ㄉㄨㄥˋ ㄏㄨㄟˋ,yùn dòng huì
5006,雲端,5,17.科技,5,1,6,ㄩㄣˊ ㄉㄨㄢ,yún duān
5007,運送,5,5.交通、旅遊,11,22,33,ㄩㄣˋ ㄙㄨㄥˋ,yùn sòng
5008,允許,5,核心詞,49,16,65,ㄩㄣˇ ㄒㄩˇ,yǔn xǔ
5009,運用,5,核心詞,128,81,209,ㄩㄣˋ ㄩㄥˋ,yùn yòng
5010,雜,5,核心詞,9,10,19,ㄗㄚˊ,zá
5011,在場,5,12.安全,34,7,41,ㄗㄞˋ ㄔㄤˊ,zài cháng
5012,再度,5,核心詞,85,66,151,ㄗㄞˋ ㄉㄨˋ,zài dù
5013,災害,5,12.安全,7,68,75,ㄗㄞ ㄏㄞˋ,zāi hài
5014,災難,5,12.安全,35,78,113,ㄗㄞ ㄋㄢˋ,zāi nàn
5015,在意,5,核心詞,40,29,69,ㄗㄞˋ ㄧˋ,zài yì
5016,讚,5,核心詞,5,25,30,ㄗㄢˋ,zàn
5017,贊成,5,8.教育、學習,24,20,44,ㄗㄢˋ ㄔㄥˊ,zàn chéng
5018,讚美,5,6.社交、人際,34,31,65,ㄗㄢˋ ㄇㄟˇ,zàn měi
5019,咱們,5,核心詞,49,21,70,ㄗㄢˊ ˙ㄇㄣ,zán men
5020,贊同,5,核心詞,22,5,27,ㄗㄢˋ ㄊㄨㄥˊ,zàn tóng
5021,糟糕,5,核心詞,30,29,59,ㄗㄠ ㄍㄠ,zāo gāo
5022,早年,5,核心詞,20,10,30,ㄗㄠˇ ㄋㄧㄢˊ,zǎo nián
5023,早日,5,核心詞,10,11,21,ㄗㄠˇ ㄖˋ,zǎo rì
5024,遭受,5,12.安全,25,23,48,ㄗㄠ ㄕㄡˋ,zāo shòu
5025,早晚,5,核心詞,9,9,18,ㄗㄠˇ ㄨㄢˇ,zǎo wǎn
5026,造型,5,核心詞,15,23,38,ㄗㄠˋ ㄒㄧㄥˊ,zào xíng
5027,噪音,5,14.社會,19,26,45,ㄗㄠˋ ㄧㄣ,zào yīn
5028,遭遇,5,12.安全,49,21,70,ㄗㄠ ㄩˋ,zāo yù
5029,則,5,核心詞,908,256,1164,ㄗㄜˊ,zé
5030,賊,5,12.安全,30,3,33,ㄗㄟˊ,zéi
5031,增進,5,核心詞,26,7,33,ㄗㄥ ㄐㄧㄣˋ,zēng jìn
5032,贈送/贈,5,核心詞,16,6,22,ㄗㄥˋ ㄙㄨㄥˋ/ㄗㄥˋ,zèng sòng/zèng
5033,增長,5,核心詞,22,16,38,ㄗㄥ ㄓㄤˇ,zēng zhǎng
5034,炸2,5,12.安全,16,17,33,ㄓㄚˋ,zhà
5035,詐騙,5,12.安全,4,3,7,ㄓㄚˋ ㄆㄧㄢˋ,zhà piàn
5036,窄,5,核心詞,11,7,18,ㄓㄞˇ,zhǎi
5037,摘,5,10.餐飲、烹飪,18,46,64,ㄓㄞ,zhāi
5038,占/佔,5,核心詞,85,91,176,ㄓㄢˋ / ㄓㄢˋ,zhàn
5039,沾,5,10.餐飲、烹飪,19,13,32,ㄓㄢ,zhān
5040,戰場,5,14.社會,33,13,46,ㄓㄢˋ ㄔㄤˊ,zhàn cháng
5041,展開,5,核心詞,64,72,136,ㄓㄢˇ ㄎㄞ,zhǎn kāi
5042,站立,5,核心詞,15,4,19,ㄓㄢˋ ㄌㄧˋ,zhàn lì
5043,佔領/占領,5,14.社會,25,16,41,ㄓㄢˋ ㄌㄧㄥˇ,zhàn lǐng
5044,展示,5,4.休閒、娛樂,31,11,42,ㄓㄢˇ ㄕˋ,zhǎn shì
5045,戰術,5,14.社會,20,4,24,ㄓㄢˋ ㄕㄨˋ,zhàn shù
5046,佔有/占有,5,3.職業,20,9,29,ㄓㄢˋ ㄧㄡˇ,zhàn yǒu
5047,丈,5,核心詞,19,7,26,ㄓㄤˋ,zhàng
5048,漲2,5,13.自然環境,15,17,32,ㄓㄤˋ,zhàng
5049,漲1,5,9.購物、商店,15,17,32,ㄓㄤˇ,zhǎng
5050,障礙,5,核心詞,88,57,145,ㄓㄤˋ ㄞˋ,zhàng ài
5051,長輩,5,1.個人資料,18,43,61,ㄓㄤˇ ㄅㄟˋ,zhǎng bèi
5052,帳戶,5,11.公共服務,6,5,11,ㄓㄤˋ ㄏㄨˋ,zhàng hù
5053,漲價,5,9.購物、商店,3,3,6,ㄓㄤˇ ㄐㄧㄚˋ,zhǎng jià
5054,掌控,5,核心詞,34,12,46,ㄓㄤˇ ㄎㄨㄥˋ,zhǎng kòng
5055,長女,5,1.個人資料,5,2,7,ㄓㄤˇ ㄋㄩˇ,zhǎng nǚ
5056,帳篷,5,4.休閒、娛樂,12,3,15,ㄓㄤˋ ㄆㄥˊ,zhàng péng
5057,掌握,5,核心詞,93,86,179,ㄓㄤˇ ㄨㄛˋ,zhǎng wò
5058,長子,5,1.個人資料,22,4,26,ㄓㄤˇ ㄗˇ,zhǎng zǐ
5059,照常,5,核心詞,5,4,9,ㄓㄠˋ ㄔㄤˊ,zhào cháng
5060,招待,5,10.餐飲、烹飪,17,7,24,ㄓㄠ ㄉㄞˋ,zhāo dài
5061,招呼,5,核心詞,22,8,30,ㄓㄠ ㄏㄨ,zhāo hū
5062,召集,5,3.職業,18,8,26,ㄓㄠˋ ㄐㄧˊ,zhào jí
5063,照舊,5,核心詞,4,1,5,ㄓㄠˋ ㄐㄧㄡˋ,zhào jiù
5064,招牌,5,9.購物、商店,17,8,25,ㄓㄠ ㄆㄞˊ,zhāo pái
5065,照樣,5,核心詞,18,7,25,ㄓㄠˋ ㄧㄤˋ,zhào yàng
5066,折,5,9.購物、商店,15,18,33,ㄓㄜˊ,zhé
5067,鎮,5,核心詞,31,13,44,ㄓㄣˋ,zhèn
5068,針,5,7.身體、醫療,23,33,56,ㄓㄣ,zhēn
5069,真誠,5,16.情緒、態度,21,18,39,ㄓㄣ ㄔㄥˊ,zhēn chéng
5070,震動,5,核心詞,14,9,23,ㄓㄣˋ ㄉㄨㄥˋ,zhèn dòng
5071,診斷,5,7.身體、醫療,43,13,56,ㄓㄣˇ ㄉㄨㄢˋ,zhěn duàn
5072,珍貴,5,核心詞,29,63,92,ㄓㄣ ㄍㄨㄟˋ,zhēn guì
5073,震驚,5,16.情緒、態度,27,23,50,ㄓㄣˋ ㄐㄧㄥ,zhèn jīng
5074,針灸,5,7.身體、醫療,7,3,10,ㄓㄣ ㄐㄧㄡˇ,zhēn jiǔ
5075,真空,5,13.自然環境,7,2,9,ㄓㄣ ㄎㄨㄥ,zhēn kōng
5076,真理,5,8.教育、學習,32,6,38,ㄓㄣ ㄌㄧˇ,zhēn lǐ
5077,診所,5,7.身體、醫療,16,15,31,ㄓㄣˇ ㄙㄨㄛˇ,zhěn suǒ
5078,偵探,5,12.安全,18,3,21,ㄓㄣ ㄊㄢˋ,zhēn tàn
5079,珍惜,5,核心詞,26,82,108,ㄓㄣ ㄒㄧˊ,zhēn xí
5080,真相,5,12.安全,51,11,62,ㄓㄣ ㄒㄧㄤˋ,zhēn xiàng
5081,真心,5,16.情緒、態度,24,13,37,ㄓㄣ ㄒㄧㄣ,zhēn xīn
5082,珍珠,5,13.自然環境,19,16,35,ㄓㄣ ㄓㄨ,zhēn zhū
5083,振作,5,核心詞,18,3,21,ㄓㄣˋ ㄗㄨㄛˋ,zhèn zuò
5084,蒸,5,10.餐飲、烹飪,9,15,24,ㄓㄥ,zhēng
5085,爭吵,5,核心詞,19,4,23,ㄓㄥ ㄔㄠˇ,zhēng chǎo
5086,爭奪,5,14.社會,15,7,22,ㄓㄥ ㄉㄨㄛˊ,zhēng duó
5087,證件,5,3.職業,5,3,8,ㄓㄥˋ ㄐㄧㄢˋ,zhèng jiàn
5088,爭論,5,8.教育、學習,30,3,33,ㄓㄥ ㄌㄨㄣˋ,zhēng lùn
5089,正面,5,核心詞,61,46,107,ㄓㄥˋ ㄇㄧㄢˋ,zhèng miàn
5090,整齊,5,2.日常起居,21,28,49,ㄓㄥˇ ㄑㄧˊ,zhěng qí
5091,徵求,5,核心詞,7,2,9,ㄓㄥ ㄑㄧㄡˊ,zhēng qiú
5092,爭取,5,14.社會,38,30,68,ㄓㄥ ㄑㄩˇ,zhēng qǔ
5093,證實,5,8.教育、學習,44,25,69,ㄓㄥˋ ㄕˊ,zhèng shí
5094,證書,5,8.教育、學習,5,7,12,ㄓㄥˋ ㄕㄨ,zhèng shū
5095,正向,5,核心詞,38,14,52,ㄓㄥˋ ㄒㄧㄤˋ,zhèng xiàng
5096,爭議,5,核心詞,24,19,43,ㄓㄥ ㄧˋ,zhēng yì
5097,正月,5,15.文化,20,3,23,ㄓㄥ ㄩㄝˋ,zhēng yuè
5098,掙扎,5,16.情緒、態度,39,20,59,ㄓㄥ ㄓㄚˊ,zhēng zhá
5099,整整,5,核心詞,24,14,38,ㄓㄥˇ ㄓㄥˇ,zhěng zhěng
5100,爭執,5,核心詞,20,8,28,ㄓㄥ ㄓˊ,zhēng zhí
5101,症狀,5,7.身體、醫療,87,51,138,ㄓㄥˋ ㄓㄨㄤˋ,zhèng zhuàng
5102,至,5,核心詞,314,78,392,ㄓˋ,zhì
5103,之,5,核心詞,2848,1026,3874,ㄓ,zhī
5104,治病,5,7.身體、醫療,13,7,20,ㄓˋ ㄅㄧㄥˋ,zhì bìng
5105,職場,5,3.職業,27,21,48,ㄓˊㄔㄤˇ,zhí chǎng
5106,支出,5,2.日常起居,9,11,20,ㄓ ㄔㄨ,zhī chū
5107,制定/制訂,5,8.教育、學習,29,14,43,ㄓˋ ㄉㄧㄥˋ,zhì dìng
5108,指定,5,核心詞,18,6,24,ㄓˇ ㄉㄧㄥˋ,zhǐ dìng
5109,制服,5,3.職業,19,7,26,ㄓˋ ㄈㄨˊ,zhì fú
5110,支付,5,核心詞,18,10,28,ㄓ ㄈㄨˋ,zhī fù
5111,志工,5,8.教育、學習,11,338,349,ㄓˋ ㄍㄨㄥ,zhì gōng
5112,智慧,5,核心詞,192,125,317,ㄓˋ ㄏㄨㄟˋ,zhì huì
5113,指揮,5,12.安全,46,11,57,ㄓˇ ㄏㄨㄟ,zhǐ huī
5114,指甲,5,7.身體、醫療,13,9,22,ㄓˇ ˙ㄐㄧㄚ,zhǐ jia
5115,指教,5,6.社交、人際,5,3,8,ㄓˇ ㄐㄧㄠˋ,zhǐ jiào
5116,知覺,5,7.身體、醫療,32,3,35,ㄓ ㄐㄩㄝˊ,zhī jué
5117,治理,5,3.職業,19,9,28,ㄓˋ ㄌㄧˇ,zhì lǐ
5118,治療,5,7.身體、醫療,248,140,388,ㄓˋ ㄌㄧㄠˊ,zhì liáo
5119,指令,5,核心詞,21,4,25,ㄓˇ ㄌㄧㄥˋ,zhǐ lìng
5120,芝麻,5,10.餐飲、烹飪,6,12,18,ㄓ ㄇㄚˊ,zhī má
5121,殖民,5,14.社會,18,15,33,ㄓˊ ㄇㄧㄣˊ,zhí mín
5122,殖民地,5,14.社會,13,4,17,ㄓˊ ㄇㄧㄣˊ ㄉㄧˋ,zhí mín dì
5123,致命,5,12.安全,19,8,27,ㄓˋ ㄇㄧㄥˋ,zhì mìng
5124,知名,5,核心詞,37,28,65,ㄓ ㄇㄧㄥˊ,zhī míng
5125,姪女,5,1.個人資料,6,1,7,ㄓˊ ㄋㄩˇ,zhí nǚ
5126,支票,5,11.公共服務,12,4,16,ㄓ ㄆㄧㄠˋ,zhī piào
5127,值錢,5,核心詞,7,4,11,ㄓˊ ㄑㄧㄢˊ,zhí qián
5128,指示,5,核心詞,37,8,45,ㄓˇ ㄕˋ,zhǐ shì
5129,之所以,5,核心詞,79,25,104,ㄓ ㄙㄨㄛˇ ㄧˇ,zhī suǒ yǐ
5130,肢體,5,7.身體、醫療,21,20,41,ㄓ ㄊㄧˇ,zhī tǐ
5131,紙條,5,11.公共服務,13,14,27,ㄓˇ ㄊㄧㄠˊ,zhǐ tiáo
5132,職位,5,3.職業,26,7,33,ㄓˊ ㄨㄟˋ,zhí wèi
5133,職務,5,3.職業,26,8,34,ㄓˊ ㄨˋ,zhí wù
5134,直線,5,5.交通、旅遊,14,8,22,ㄓˊ ㄒㄧㄢˋ,zhí xiàn
5135,執行,5,核心詞,104,47,151,ㄓˊ ㄒㄧㄥˊ,zhí xíng
5136,秩序,5,8.教育、學習,34,19,53,ㄓˋ ㄒㄩˋ,zhì xù
5137,枝葉,5,核心詞,7,5,12,ㄓ ㄧㄝˋ,zhī yè
5138,指引,5,核心詞,18,4,22,ㄓˇ ㄧㄣˇ,zhǐ yǐn
5139,至於,5,核心詞,153,50,203,ㄓˋ ㄩˊ,zhì yú
5140,之餘,5,核心詞,23,9,32,ㄓ ㄩˊ,zhī yú
5141,志願,5,8.教育、學習,8,13,21,ㄓˋ ㄩㄢˋ,zhì yuàn
5142,支援,5,3.職業,27,23,50,ㄓ ㄩㄢˊ,zhī yuán
5143,製造商,5,3.職業,12,3,15,ㄓˋ ㄗㄠˋ ㄕㄤ,zhì zào shāng
5144,職責,5,3.職業,18,4,22,ㄓˊ ㄗㄜˊ,zhí zé
5145,紙張,5,9.購物、商店,9,17,26,ㄓˇ ㄓㄤ,zhǐ zhāng
5146,執照,5,5.交通、旅遊,9,6,15,ㄓˊ ㄓㄠˋ,zhí zhào
5147,侄子/姪子/侄兒/姪兒,5,1.個人資料,14,4,18,ㄓˊ ˙ㄗ/ㄓˊㄦ,zhí zi/zhír 
5148,製作,5,3.職業,68,106,174,ㄓˋ ㄗㄨㄛˋ,zhì zuò
5149,腫,5,7.身體、醫療,9,8,17,ㄓㄨㄥˇ,zhǒng
5150,重病,5,7.身體、醫療,7,4,11,ㄓㄨㄥˋ ㄅㄧㄥˋ,zhòng bìng
5151,中等,5,8.教育、學習,9,4,13,ㄓㄨㄥ ㄉㄥˇ,zhōng děng
5152,終點,5,5.交通、旅遊,17,11,28,ㄓㄨㄥ ㄉㄧㄢˇ,zhōng diǎn
5153,中毒,5,7.身體、醫療,12,16,28,ㄓㄨㄥˋ ㄉㄨˊ,zhòng dú
5154,中斷,5,核心詞,18,20,38,ㄓㄨㄥ ㄉㄨㄢˋ,zhōng duàn
5155,眾多,5,核心詞,41,15,56,ㄓㄨㄥˋ ㄉㄨㄛ,zhòng duō
5156,中風,5,7.身體、醫療,18,12,30,ㄓㄨㄥˋ ㄈㄥ,zhòng fēng
5157,中古,5,8.教育、學習,5,4,9,ㄓㄨㄥ ㄍㄨˇ,zhōng gǔ
5158,中華民國,5,1.個人資料,22,5,27,ㄓㄨㄥ ㄏㄨㄚˊ ㄇㄧㄣˊ ㄍㄨㄛˊ,zhōng huá mín guó
5159,中級,5,8.教育、學習,3,1,4,ㄓㄨㄥ ㄐㄧˊ,zhōng jí
5160,中獎,5,核心詞,2,2,4,ㄓㄨㄥˋ ㄐㄧㄤˇ,zhòng jiǎng
5161,仲介,5,核心詞,5,3,8,ㄓㄨㄥˋ ㄐㄧㄝˋ,zhòng jiè
5162,重量,5,核心詞,28,31,59,ㄓㄨㄥˋ ㄌㄧㄤˋ,zhòng liàng
5163,眾人,5,核心詞,64,17,81,ㄓㄨㄥˋ ㄖㄣˊ,zhòng rén
5164,終身,5,核心詞,25,7,32,ㄓㄨㄥ ㄕㄣ,zhōng shēn
5165,中暑,5,7.身體、醫療,3,7,10,ㄓㄨㄥˋ ㄕㄨˇ,zhòng shǔ
5166,中途,5,5.交通、旅遊,12,8,20,ㄓㄨㄥ ㄊㄨˊ,zhōng tú
5167,重心,5,7.身體、醫療,24,17,41,ㄓㄨㄥˋ ㄒㄧㄣ,zhòng xīn
5168,中性,5,核心詞,4,3,7,ㄓㄨㄥ ㄒㄧㄥˋ,zhōng xìng
5169,中央,5,14.社會,150,50,200,ㄓㄨㄥ ㄧㄤ,zhōng yāng
5170,中藥,5,7.身體、醫療,6,12,18,ㄓㄨㄥ ㄧㄠˋ,zhōng yào
5171,重要性,5,核心詞,52,27,79,ㄓㄨㄥˋ ㄧㄠˋ ㄒㄧㄥˋ,zhòng yào xìng
5172,中醫,5,7.身體、醫療,22,13,35,ㄓㄨㄥ ㄧ,zhōng yī
5173,種子,5,13.自然環境,26,119,145,ㄓㄨㄥˇ ㄗˇ,zhǒng zǐ
5174,種族,5,8.教育、學習,30,36,66,ㄓㄨㄥˇ ㄗㄨˊ,zhǒng zú
5175,皺,5,核心詞,16,4,20,ㄓㄡˋ,zhòu
5176,周,5,核心詞,28,55,83,ㄓㄡ,zhōu
5177,州,5,核心詞,29,18,47,ㄓㄡ,zhōu
5178,粥,5,10.餐飲、烹飪,11,16,27,ㄓㄡ,zhōu
5179,週刊/周刊,5,4.休閒、娛樂,16,3,19,ㄓㄡ ㄎㄢ  ,zhōu kān 
5180,主辦,5,8.教育、學習,13,10,23,ㄓㄨˇ ㄅㄢˋ,zhǔ bàn
5181,主編,5,8.教育、學習,17,5,22,ㄓㄨˇ ㄅㄧㄢ,zhǔ biān
5182,逐步,5,核心詞,20,13,33,ㄓㄨˊ ㄅㄨˋ,zhú bù
5183,註冊,5,8.教育、學習,6,5,11,ㄓㄨˋ ㄘㄜˋ,zhù cè
5184,主持,5,核心詞,38,20,58,ㄓㄨˇ ㄔˊ,zhǔ chí
5185,主廚,5,10.餐飲、烹飪,2,4,6,ㄓㄨˇ ㄔㄨˊ,zhǔ chú
5186,主導,5,核心詞,22,21,43,ㄓㄨˇ ㄉㄠˇ,zhǔ dǎo
5187,祝福,5,6.社交、人際,21,93,114,ㄓㄨˋ ㄈㄨˊ,zhù fú
5188,主婦,5,2.日常起居,13,21,34,ㄓㄨˇ ㄈㄨˋ,zhǔ fù
5189,主觀,5,16.情緒、態度,20,4,24,ㄓㄨˇ ㄍㄨㄢ,zhǔ guān
5190,燭光,5,核心詞,5,2,7,ㄓㄨˊ ㄍㄨㄤ,zhú guāng
5191,祝賀,5,6.社交、人際,7,2,9,ㄓㄨˋ ㄏㄜˋ,zhù hè
5192,住家,5,2.日常起居,11,15,26,ㄓㄨˋ ㄐㄧㄚ,zhù jiā
5193,逐漸,5,核心詞,149,130,279,ㄓㄨˊ ㄐㄧㄢˋ,zhú jiàn
5194,主見,5,1.個人資料,5,2,7,ㄓㄨˇ ㄐㄧㄢˋ,zhǔ jiàn
5195,助理,5,3.職業,20,40,60,ㄓㄨˋ ㄌㄧˇ,zhù lǐ
5196,主流,5,核心詞,24,13,37,ㄓㄨˇ ㄌㄧㄡˊ,zhǔ liú
5197,注視,5,核心詞,25,3,28,ㄓㄨˋ ㄕˋ,zhù shì
5198,住宿,5,5.交通、旅遊,8,7,15,ㄓㄨˋ ㄙㄨˋ,zhù sù
5199,主體,5,核心詞,18,7,25,ㄓㄨˇ ㄊㄧˇ,zhǔ tǐ
5200,主席,5,14.社會,30,25,55,ㄓㄨˇ ㄒㄧˊ,zhǔ xí
5201,主修,5,8.教育、學習,6,2,8,ㄓㄨˇ ㄒㄧㄡ,zhǔ xiū
5202,主演,5,4.休閒、娛樂,4,1,5,ㄓㄨˇ ㄧㄢˇ,zhǔ yǎn
5203,主義,5,14.社會,186,46,232,ㄓㄨˇ ㄧˋ,zhǔ yì
5204,住宅,5,2.日常起居,19,23,42,ㄓㄨˋ ㄓㄞˊ,zhù zhái
5205,主張,5,8.教育、學習,81,25,106,ㄓㄨˇ ㄓㄤ,zhǔ zhāng
5206,注重,5,核心詞,20,27,47,ㄓㄨˋ ㄓㄨㄥˋ,zhù zhòng
5207,珠子,5,13.自然環境,7,1,8,ㄓㄨ ˙ㄗ,zhū zi
5208,抓狂,5,16.情緒、態度,6,4,10,ㄓㄨㄚ ㄎㄨㄤˊ,zhuā kuáng
5209,抓住,5,核心詞,67,10,77,ㄓㄨㄚ ㄓㄨˋ,zhuā zhù
5210,轉2,5,核心詞,76,92,168,ㄓㄨㄢˋ,zhuàn
5211,轉變,5,核心詞,38,52,90,ㄓㄨㄢˇ ㄅㄧㄢˋ,zhuǎn biàn
5212,轉播,5,4.休閒、娛樂,5,3,8,ㄓㄨㄢˇ ㄅㄛˋ,zhuǎn bò
5213,專長,5,3.職業,13,21,34,ㄓㄨㄢ ㄔㄤˊ,zhuān cháng
5214,轉動,5,核心詞,21,15,36,ㄓㄨㄢˇ ㄉㄨㄥˋ ,zhuǎn dòng  
5215,轉告,5,核心詞,5,1,6,ㄓㄨㄢˇ ㄍㄠˋ,zhuǎn gào
5216,轉換,5,核心詞,24,22,46,ㄓㄨㄢˇ ㄏㄨㄢˋ,zhuǎn huàn
5217,專輯,5,4.休閒、娛樂,4,5,9,ㄓㄨㄢ ㄐㄧˊ,zhuān jí
5218,轉角,5,5.交通、旅遊,4,2,6,ㄓㄨㄢˇ ㄐㄧㄠˇ,zhuǎn jiǎo
5219,專人,5,核心詞,6,3,9,ㄓㄨㄢ ㄖㄣˊ,zhuān rén
5220,轉身,5,核心詞,52,6,58,ㄓㄨㄢˇ ㄕㄣ,zhuǎn shēn
5221,轉彎,5,核心詞,8,9,17,ㄓㄨㄢˇ ㄨㄢ,zhuǎn wān
5222,轉眼,5,核心詞,8,4,12,ㄓㄨㄢˇ ㄧㄢˇ,zhuǎn yǎn
5223,轉移,5,核心詞,25,12,37,ㄓㄨㄢˇ ㄧˊ,zhuǎn yí
5224,轉帳,5,11.公共服務,1,1,2,ㄓㄨㄢˇ ㄓㄤˋ,zhuǎn zhàng
5225,專制,5,14.社會,17,2,19,ㄓㄨㄢ ㄓˋ,zhuān zhì
5226,專注,5,核心詞,55,29,84,ㄓㄨㄢ ㄓㄨˋ,zhuān zhù
5227,壯,5,7.身體、醫療,20,9,29,ㄓㄨㄤˋ,zhuàng
5228,撞,5,核心詞,20,10,30,ㄓㄨㄤˋ,zhuàng
5229,妝,5,核心詞,4,3,7,ㄓㄨㄤ,zhuāng
5230,狀況,5,核心詞,180,301,481,ㄓㄨㄤˋ ㄎㄨㄤˋ,zhuàng kuàng
5231,裝飾,5,2.日常起居,18,11,29,ㄓㄨㄤ ㄕˋ,zhuāng shì
5232,狀態,5,7.身體、醫療,135,97,232,ㄓㄨㄤˋ ㄊㄞˋ,zhuàng tài
5233,裝置,5,17.科技,28,21,49,ㄓㄨㄤ ㄓˋ,zhuāng zhì
5234,裝作/裝做,5,核心詞,8,3,11,ㄓㄨㄤ ㄗㄨㄛˋ ,zhuāng zuò 
5235,追尋,5,核心詞,22,13,35,ㄓㄨㄟ ㄒㄩㄣˊ,zhuī xún
5236,追逐,5,4.休閒、娛樂,19,7,26,ㄓㄨㄟ ㄓㄨˊ,zhuī zhú
5237,追蹤,5,核心詞,31,28,59,ㄓㄨㄟ ㄗㄨㄥ,zhuī zōng
5238,准,5,核心詞,10,4,14,ㄓㄨㄣˇ,zhǔn
5239,準確,5,核心詞,24,10,34,ㄓㄨㄣˇ ㄑㄩㄝˋ,zhǔn què
5240,捉,5,12.安全,19,3,22,ㄓㄨㄛ,zhuō
5241,自,5,核心詞,195,67,262,ㄗˋ,zì
5242,資產,5,3.職業,42,18,60,ㄗ ㄔㄢˇ,zī chǎn
5243,自稱,5,核心詞,25,4,29,ㄗˋ ㄔㄥ,zì chēng
5244,資格,5,8.教育、學習,31,9,40,ㄗ ㄍㄜˊ,zī gé
5245,自己人,5,核心詞,5,2,7,ㄗˋ ㄐㄧˇ ㄖㄣˊ,zì jǐ rén
5246,資金,5,14.社會,36,31,67,ㄗ ㄐㄧㄣ,zī jīn
5247,字母,5,8.教育、學習,30,4,34,ㄗˋ ㄇㄨˇ,zì mǔ
5248,資深,5,3.職業,18,19,37,ㄗ ㄕㄣ,zī shēn
5249,姿勢,5,核心詞,50,12,62,ㄗ ㄕˋ,zī shì
5250,自私,5,16.情緒、態度,20,7,27,ㄗˋ ㄙ,zì sī
5251,子孫,5,1.個人資料,29,20,49,ㄗˇ ㄙㄨㄣ,zǐ sūn
5252,姿態,5,核心詞,37,8,45,ㄗ ㄊㄞˋ,zī tài
5253,字體,5,8.教育、學習,9,3,12,ㄗˋ ㄊㄧˇ,zì tǐ
5254,字條,5,11.公共服務,7,3,10,ㄗˋ ㄊㄧㄠˊ,zì tiáo
5255,滋味,5,10.餐飲、烹飪,31,32,63,ㄗ ㄨㄟˋ,zī wèi
5256,自行,5,核心詞,33,17,50,ㄗˋ ㄒㄧㄥˊ,zì xíng
5257,自願,5,核心詞,17,11,28,ㄗˋ ㄩㄢˋ,zì yuàn
5258,自主,5,核心詞,26,6,32,ㄗˋ ㄓㄨˇ,zì zhǔ
5259,自傳,5,核心詞,10,1,11,ㄗˋ ㄓㄨㄢˋ,zì zhuàn
5260,自尊,5,核心詞,29,3,32,ㄗˋ ㄗㄨㄣ,zì zūn
5261,總裁,5,3.職業,29,14,43,ㄗㄨㄥˇ ㄘㄞˊ,zǒng cái
5262,總公司,5,3.職業,8,1,9,ㄗㄨㄥˇ ㄍㄨㄥ ㄙ,zǒng gōng sī
5263,綜合,5,10.餐飲、烹飪,28,11,39,ㄗㄨㄥˋ ㄏㄜˊ,zòng hé
5264,總理,5,14.社會,18,77,95,ㄗㄨㄥˇ ㄌㄧˇ,zǒng lǐ
5265,總算,5,核心詞,29,11,40,ㄗㄨㄥˇ ㄙㄨㄢˋ,zǒng suàn
5266,總之/總而言之,5,核心詞,57,12,69,ㄗㄨㄥˇ ㄓ/ㄗㄨㄥˇ ㄦˊ ㄧㄢˊ ㄓ,zǒng zhī/zǒng ér yán zhī
5267,走道,5,5.交通、旅遊,10,4,14,ㄗㄡˇ ㄉㄠˋ,zǒu dào
5268,走動,5,核心詞,18,6,24,ㄗㄡˇ ㄉㄨㄥˋ,zǒu dòng
5269,走廊,5,5.交通、旅遊,29,37,66,ㄗㄡˇ ㄌㄤˊ,zǒu láng
5270,阻礙,5,核心詞,28,21,49,ㄗㄨˇ ㄞˋ,zǔ ài
5271,族群,5,核心詞,34,56,90,ㄗㄨˊ ㄑㄩㄣˊ,zú qún
5272,祖先,5,1.個人資料,43,41,84,ㄗㄨˇ ㄒㄧㄢ,zǔ xiān
5273,足以,5,核心詞,69,19,88,ㄗㄨˊ ㄧˇ,zú yǐ
5274,阻止,5,12.安全,38,23,61,ㄗㄨˇ ㄓˇ,zǔ zhǐ
5275,組織,5,3.職業,263,243,506,ㄗㄨˇ ㄓ,zǔ zhī
5276,鑽1,5,核心詞,13,17,30,ㄗㄨㄢ,zuān
5277,罪,5,12.安全,44,13,57,ㄗㄨㄟˋ,zuì
5278,嘴脣/嘴唇/脣/唇,5,7.身體、醫療,44,10,54,ㄗㄨㄟˇ ㄔㄨㄣˊ/ㄔㄨㄣˊ,zuǐ chún/chún/
5279,罪惡,5,12.安全,17,4,21,ㄗㄨㄟˋ ㄜˋ,zuì è
5280,最終,5,核心詞,55,28,83,ㄗㄨㄟˋ ㄓㄨㄥ,zuì zhōng
5281,尊敬,5,6.社交、人際,34,28,62,ㄗㄨㄣ ㄐㄧㄥˋ,zūn jìng
5282,遵守,5,核心詞,26,17,43,ㄗㄨㄣ ㄕㄡˇ,zūn shǒu
5283,尊重,5,6.社交、人際,73,76,149,ㄗㄨㄣ ㄓㄨㄥˋ,zūn zhòng
5284,作弊,5,8.教育、學習,5,2,7,ㄗㄨㄛˋ ㄅㄧˋ,zuò bì
5285,作客/做客,5,6.社交、人際,8,1,9,ㄗㄨㄛˋ ㄎㄜˋ ,zuò kè 
5286,昨日,5,核心詞,9,3,12,ㄗㄨㄛˊ ㄖˋ,zuó rì
5287,作為,5,核心詞,166,85,251,ㄗㄨㄛˋ ㄨㄟˊ,zuò wéi
5288,作用,5,7.身體、醫療,149,112,261,ㄗㄨㄛˋ ㄩㄥˋ,zuò yòng
5289,愛國,6,,15,6,21,ㄞˋ ㄍㄨㄛˊ,ài guó
5290,曖昧,6,,9,1,10,ㄞˋ ㄇㄟˋ,ài mèi
5291,愛慕,6,,8,1,9,ㄞˋ ㄇㄨˋ,ài mù
5292,哀求,6,,12,1,13,ㄞ ㄑㄧㄡˊ,āi qiú
5293,哀傷,6,,12,6,18,ㄞ ㄕㄤ,āi shāng
5294,黯淡/暗淡,6,,9,3,12,ㄢˋ ㄉㄢˋ,àn dàn
5295,安頓,6,,5,4,9,ㄢ ㄉㄨㄣˋ,ān dùn
5296,安撫,6,,20,9,29,ㄢ ㄈㄨˇ,ān fǔ
5297,安寧,6,,13,25,38,ㄢ ㄋㄧㄥˊ,ān níng
5298,按鈕,6,,8,2,10,ㄢˋ ㄋㄧㄡˇ,àn niǔ
5299,暗殺,6,,8,2,10,ㄢˋ ㄕㄚ,àn shā
5300,安危,6,,6,3,9,ㄢ ㄨㄟˊ,ān wéi
5301,安穩,6,,8,7,15,ㄢ ㄨㄣˇ,ān wěn
5302,安置,6,,12,16,28,ㄢ ㄓˋ,ān zhì
5303,安裝,6,,10,8,18,ㄢ ㄓㄨㄤ,ān zhuāng
5304,暗自,6,,13,1,14,ㄢˋ ㄗˋ,àn zì
5305,骯髒,6,,12,3,15,ㄤ ㄗㄤ,āng zāng
5306,熬,6,,12,12,24,ㄠˊ,áo
5307,傲慢,6,,13,2,15,ㄠˋ ㄇㄢˋ,ào màn
5308,奧祕/奧秘,6,,12,8,20,ㄠˋ ㄇㄧˋ,ào mì
5309,懊惱,6,,9,6,15,ㄠˋ ㄋㄠˇ,ào nǎo
5310,霸道,6,,8,3,11,ㄅㄚˋ ㄉㄠˋ,bà dào
5311,八卦,6,,8,6,14,ㄅㄚ ㄍㄨㄚˋ,bā guà
5312,疤痕,6,,5,4,9,ㄅㄚ ㄏㄣˊ,bā hén
5313,罷休,6,,5,1,6,ㄅㄚˋ ㄒㄧㄡ,bà xiū
5314,巴掌,6,,9,3,12,ㄅㄚ ㄓㄤˇ,bā zhǎng
5315,白白,6,,10,17,27,ㄅㄞˊ ㄅㄞˊ,bái bái
5316,白癡/白痴,6,,12,3,15,ㄅㄞˊ ㄔ,bái chī
5317,擺放,6,,9,4,13,ㄅㄞˇ ㄈㄤˋ,bǎi fàng
5318,白費,6,,6,6,12,ㄅㄞˊ ㄈㄟˋ,bái fèi
5319,擺設,6,,8,4,12,ㄅㄞˇ ㄕㄜˋ,bǎi shè
5320,板,6,,11,14,25,ㄅㄢˇ,bǎn
5321,斑,6,,5,8,13,ㄅㄢ,bān
5322,般,6,,155,37,192,ㄅㄢ,bān
5323,頒布/頒佈,6,,11,4,15,ㄅㄢ ㄅㄨˋ,bān bù
5324,頒發/頒,6,,10,7,17,ㄅㄢ ㄈㄚ/ㄅㄢ,bān fā/bān
5325,頒獎,6,,4,3,7,ㄅㄢ ㄐㄧㄤˇ,bān jiǎng
5326,半信半疑,6,,4,2,6,ㄅㄢˋ ㄒㄧㄣˋ ㄅㄢˋ ㄧˊ,bàn xìn bàn yí
5327,綁架,6,,9,8,17,ㄅㄤˇ ㄐㄧㄚˋ,bǎng jià
5328,榜樣,6,,12,8,20,ㄅㄤˇ ㄧㄤˋ,bǎng yàng
5329,磅,6,,12,3,15,ㄅㄤˋ/ㄆㄤ,bàng/pāng
5330,豹,6,,7,2,9,ㄅㄠˋ,bào
5331,抱持,6,,21,10,31,ㄅㄠˋ ㄔˊ,bào chí
5332,報仇,6,,14,2,16,ㄅㄠˋ ㄔㄡˊ,bào chóu
5333,報酬,6,,17,4,21,ㄅㄠˋ ㄔㄡˊ,bào chóu
5334,報答,6,,8,5,13,ㄅㄠˋ ㄉㄚˊ,bào dá
5335,暴動,6,,9,11,20,ㄅㄠˋ ㄉㄨㄥˋ,bào dòng
5336,暴風,6,,4,5,9,ㄅㄠˋ ㄈㄥ,bào fēng
5337,抱負,6,,9,2,11,ㄅㄠˋ ㄈㄨˋ,bào fù
5338,包袱,6,,14,5,19,ㄅㄠ ㄈㄨˊ,bāo fú
5339,保健,6,,13,16,29,ㄅㄠˇ ㄐㄧㄢˋ,bǎo jiàn
5340,飽滿,6,,8,13,21,ㄅㄠˇ ㄇㄢˇ,bǎo mǎn
5341,保密,6,,8,4,12,ㄅㄠˇ ㄇㄧˋ,bǎo mì
5342,保全,6,,13,4,17,ㄅㄠˇ ㄑㄩㄢˊ,bǎo quán
5343,包容,6,,15,24,39,ㄅㄠ ㄖㄨㄥˊ,bāo róng
5344,寶石,6,,13,5,18,ㄅㄠˇ ㄕˊ,bǎo shí
5345,飽受,6,,9,16,25,ㄅㄠˇ ㄕㄡˋ,bǎo shòu
5346,保衛,6,,9,3,12,ㄅㄠˇ ㄨㄟˋ,bǎo wèi
5347,暴行,6,,6,3,9,ㄅㄠˋ ㄒㄧㄥˊ,bào xíng
5348,保養,6,,11,14,25,ㄅㄠˇ ㄧㄤˇ,bǎo yǎng
5349,報應,6,,6,2,8,ㄅㄠˋ ㄧㄥˋ,bào yìng
5350,保佑,6,,10,14,24,ㄅㄠˇ ㄧㄡˋ,bǎo yòu
5351,暴雨,6,,6,32,38,ㄅㄠˋ ㄩˇ,bào yǔ
5352,寶藏,6,,9,10,19,ㄅㄠˇ ㄗㄤˋ,bǎo zàng
5353,暴躁,6,,9,4,13,ㄅㄠˋ ㄗㄠˋ,bào zào
5354,寶座,6,,15,3,18,ㄅㄠˇ ㄗㄨㄛˋ,bǎo zuò
5355,卑鄙,6,,8,0,8,ㄅㄟ ㄅㄧˇ,bēi bǐ
5356,背負,6,,9,6,15,ㄅㄟ ㄈㄨˋ,bēi fù
5357,被告,6,,10,1,11,ㄅㄟˋ ㄍㄠˋ,bèi gào
5358,貝殼,6,,6,6,12,ㄅㄟˋ ㄎㄜˊ,bèi ké
5359,備受,6,,13,12,25,ㄅㄟˋ ㄕㄡˋ,bèi shòu
5360,背誦,6,,8,8,16,ㄅㄟˋ ㄙㄨㄥˋ,bèi sòng
5361,悲痛,6,,14,4,18,ㄅㄟ ㄊㄨㄥˋ,bēi tòng
5362,備用,6,,6,3,9,ㄅㄟˋ ㄩㄥˋ,bèi yòng
5363,奔波,6,,7,9,16,ㄅㄣ ㄅㄛ,bēn bō
5364,奔馳,6,,8,5,13,ㄅㄣ ㄔˊ,bēn chí
5365,本分/本份,6,,7,10,17,ㄅㄣˇ ㄈㄣˋ,běn fèn
5366,奔跑,6,,13,5,18,ㄅㄣ ㄆㄠˇ,bēn pǎo
5367,笨手笨腳,6,,3,1,4,ㄅㄣˋ ㄕㄡˇ ㄅㄣˋ ㄐㄧㄠˇ,bèn shǒu bèn jiǎo
5368,本意,6,,7,3,10,ㄅㄣˇ ㄧˋ,běn yì
5369,本質,6,,66,15,81,ㄅㄣˇ ㄓˊ,běn zhí
5370,笨拙,6,,10,1,11,ㄅㄣˋ ㄓㄨㄛˊ,bèn zhuó
5371,奔走,6,,9,6,15,ㄅㄣ ㄗㄡˇ,bēn zǒu
5372,崩,6,,16,10,26,ㄅㄥ,bēng
5373,崩潰,6,,22,6,28,ㄅㄥ ㄎㄨㄟˋ,bēng kuì
5374,彼,6,,16,4,20,ㄅㄧˇ,bǐ
5375,比對,6,,10,8,18,ㄅㄧˇ ㄉㄨㄟˋ,bǐ duì
5376,筆跡,6,,5,1,6,ㄅㄧˇ ㄐㄧ,bǐ jī
5377,逼近,6,,10,8,18,ㄅㄧ ㄐㄧㄣˋ,bī jìn
5378,壁爐,6,,10,1,11,ㄅㄧˋ ㄌㄨˊ,bì lú
5379,筆墨,6,,5,2,7,ㄅㄧˇ ㄇㄛˋ,bǐ mò
5380,閉幕,6,,1,1,2,ㄅㄧˋ ㄇㄨˋ,bì mù
5381,避難,6,,5,19,24,ㄅㄧˋ ㄋㄢˋ,bì nàn
5382,比擬,6,,8,4,12,ㄅㄧˇ ㄋㄧˇ,bǐ nǐ
5383,逼迫,6,,10,3,13,ㄅㄧ ㄆㄛˋ,bī pò
5384,畢生,6,,7,4,11,ㄅㄧˋ ㄕㄥ,bì shēng
5385,避暑,6,,6,6,12,ㄅㄧˋ ㄕㄨˇ,bì shǔ
5386,筆下,6,,15,3,18,ㄅㄧˇ ㄒㄧㄚˋ,bǐ xià
5387,筆友,6,,1,0,1,ㄅㄧˇ ㄧㄡˇ,bǐ yǒu
5388,筆者,6,,39,0,39,ㄅㄧˇ ㄓㄜˇ,bǐ zhě
5389,逼真,6,,5,2,7,ㄅㄧ ㄓㄣ,bī zhēn
5390,幣值,6,,1,2,3,ㄅㄧˋ ㄓˊ,bì zhí
5391,筆直,6,,10,1,11,ㄅㄧˇ ㄓˊ,bǐ zhí
5392,比重,6,,4,3,7,ㄅㄧˇ ㄓㄨㄥˋ,bǐ zhòng
5393,便,6,,903,75,978,ㄅㄧㄢˋ,biàn
5394,辨別,6,,6,5,11,ㄅㄧㄢˋ ㄅㄧㄝˊ,biàn bié
5395,遍布/遍佈,6,,8,10,18,ㄅㄧㄢˋ ㄅㄨˋ,biàn bù
5396,變革,6,,16,2,18,ㄅㄧㄢˋ ㄍㄜˊ,biàn gé
5397,變更,6,,7,2,9,ㄅㄧㄢˋ ㄍㄥ,biàn gēng
5398,編號,6,,5,4,9,ㄅㄧㄢ ㄏㄠˋ,biān hào
5399,辯護,6,,15,1,16,ㄅㄧㄢˋ ㄏㄨˋ,biàn hù
5400,變換,6,,9,4,13,ㄅㄧㄢˋ ㄏㄨㄢˋ,biàn huàn
5401,遍及,6,,5,4,9,ㄅㄧㄢˋ ㄐㄧˊ,biàn jí
5402,辯解,6,,8,2,10,ㄅㄧㄢˋ ㄐㄧㄝˇ,biàn jiě
5403,邊界,6,,14,19,33,ㄅㄧㄢ ㄐㄧㄝˋ,biān jiè
5404,邊境,6,,10,28,38,ㄅㄧㄢ ㄐㄧㄥˋ,biān jìng
5405,辯論,6,,16,10,26,ㄅㄧㄢˋ ㄌㄨㄣˋ,biàn lùn
5406,變遷,6,,25,95,120,ㄅㄧㄢˋ ㄑㄧㄢ,biàn qiān
5407,辨認,6,,10,4,14,ㄅㄧㄢˋ ㄖㄣˋ,biàn rèn
5408,變數,6,,20,7,27,ㄅㄧㄢˋ ㄕㄨˋ,biàn shù
5409,變態,6,,7,1,8,ㄅㄧㄢˋ ㄊㄞˋ,biàn tài
5410,變通,6,,5,2,7,ㄅㄧㄢˋ ㄊㄨㄥ,biàn tōng
5411,編寫,6,,8,2,10,ㄅㄧㄢ ㄒㄧㄝˇ,biān xiě
5412,變形,6,,12,19,31,ㄅㄧㄢˋ ㄒㄧㄥˊ,biàn xíng
5413,便於,6,,7,2,9,ㄅㄧㄢˋ ㄩˊ,biàn yú
5414,邊緣,6,,38,26,64,ㄅㄧㄢ ㄩㄢˊ,biān yuán
5415,貶值,6,,3,6,9,ㄅㄧㄢˇ ㄓˊ,biǎn zhí
5416,編織,6,,11,14,25,ㄅㄧㄢ ㄓ,biān zhī
5417,辮子,6,,10,4,14,ㄅㄧㄢˋ ˙ㄗ,biàn zi
5418,鞭子,6,,8,2,10,ㄅㄧㄢ ˙ㄗ,biān zi
5419,編纂,6,,7,1,8,ㄅㄧㄢ ㄗㄨㄢˇ,biān zuǎn
5420,標記,6,,10,4,14,ㄅㄧㄠ ㄐㄧˋ,biāo jì
5421,表露,6,,7,2,9,ㄅㄧㄠˇ ㄌㄨˋ,biǎo lù
5422,標示,6,,16,16,32,ㄅㄧㄠ ㄕˋ,biāo shì
5423,表態,6,,6,7,13,ㄅㄧㄠˇ ㄊㄞˋ,biǎo tài
5424,標語,6,,7,6,13,ㄅㄧㄠ ㄩˇ,biāo yǔ
5425,標誌,6,,16,8,24,ㄅㄧㄠ ㄓˋ,biāo zhì
5426,憋,6,,5,4,9,ㄅㄧㄝ,biē
5427,別墅,6,,15,4,19,ㄅㄧㄝˊ ㄕㄨˋ,bié shù
5428,瀕臨/瀕,6,,12,28,40,ㄅㄧㄣ ㄌㄧㄣˊ / ㄅㄧㄣ,bīn lín / bīn
5429,丙,6,,9,2,11,ㄅㄧㄥˇ,bǐng
5430,柄,6,,9,4,13,ㄅㄧㄥˇ,bǐng
5431,病變,6,,17,9,26,ㄅㄧㄥˋ ㄅㄧㄢˋ,bìng biàn
5432,並肩,6,,9,2,11,ㄅㄧㄥˋ ㄐㄧㄢ,bìng jiān
5433,病例,6,,13,24,37,ㄅㄧㄥˋ ㄌㄧˋ,bìng lì
5434,兵馬,6,,24,0,24,ㄅㄧㄥ ㄇㄚˇ,bīng mǎ
5435,病態,6,,14,3,17,ㄅㄧㄥˋ ㄊㄞˋ,bìng tài
5436,病因,6,,8,1,9,ㄅㄧㄥˋ ㄧㄣ,bìng yīn
5437,病症,6,,13,3,16,ㄅㄧㄥˋ ㄓㄥˋ,bìng zhèng
5438,柏,6,,16,12,28,ㄅㄛˊ,bó
5439,剝,6,,9,25,34,ㄅㄛ,bō
5440,波動,6,,12,7,19,ㄅㄛ ㄉㄨㄥˋ,bō dòng
5441,搏鬥,6,,8,3,11,ㄅㄛˊ ㄉㄡˋ,bó dòu
5442,剝奪,6,,17,7,24,ㄅㄛ ㄉㄨㄛˊ,bō duó
5443,播放,6,,16,9,25,ㄅㄛˋ ㄈㄤˋ,bò fàng
5444,波浪,6,,8,24,32,ㄅㄛ ㄌㄤˋ,bō làng
5445,薄弱,6,,10,5,15,ㄅㄛˊ ㄖㄨㄛˋ,bó ruò
5446,波濤,6,,7,3,10,ㄅㄛ ㄊㄠˊ,bō táo
5447,博物院,6,,17,2,19,ㄅㄛˊ ㄨˋ ㄩㄢˋ,bó wù yuàn
5448,剝削,6,,8,5,13,ㄅㄛ ㄒㄩㄝˋ,bō xuè
5449,補償,6,,11,4,15,ㄅㄨˇ ㄔㄤˊ,bǔ cháng
5450,不單,6,,8,5,13,ㄅㄨˋ ㄉㄢ,bù dān
5451,不等,6,,10,3,13,ㄅㄨˋ ㄉㄥˇ,bù děng
5452,步調,6,,10,7,17,ㄅㄨˋ ㄉㄧㄠˋ,bù diào
5453,不動產,6,,3,1,4,ㄅㄨˊ ㄉㄨㄥˋ ㄔㄢˇ,bú dòng chǎn
5454,部隊,6,,58,35,93,ㄅㄨˋ ㄉㄨㄟˋ,bù duì
5455,不對勁,6,,17,3,20,ㄅㄨˊ ㄉㄨㄟˋ ㄐㄧㄣˋ,bú duì jìn
5456,不法,6,,5,3,8,ㄅㄨˋ ㄈㄚˇ,bù fǎ
5457,步伐,6,,16,8,24,ㄅㄨˋ ㄈㄚ,bù fā
5458,不凡,6,,7,1,8,ㄅㄨˋ ㄈㄢˊ,bù fán
5459,不復,6,,10,7,17,ㄅㄨˊ ㄈㄨˋ,bú fù
5460,布告欄/佈告欄,6,,3,1,4,ㄅㄨˋ ㄍㄠˋ ㄌㄢˊ,bù gào lán
5461,不公,6,,5,4,9,ㄅㄨˋ ㄍㄨㄥ,bù gōng
5462,不及,6,,21,6,27,ㄅㄨˋ ㄐㄧˊ,bù jí
5463,補給,6,,11,6,17,ㄅㄨˇ ㄐㄧˇ,bǔ jǐ
5464,不禁,6,,61,7,68,ㄅㄨˋ ㄐㄧㄣ,bù jīn
5465,不經意,6,,8,4,12,ㄅㄨˋ ㄐㄧㄥ ㄧˋ,bù jīng yì
5466,補救,6,,10,4,14,ㄅㄨˇ ㄐㄧㄡˋ,bǔ jiù
5467,不覺,6,,19,2,21,ㄅㄨˋ ㄐㄩㄝˊ,bù jué
5468,不堪,6,,27,10,37,ㄅㄨˋ ㄎㄢ,bù kān
5469,不可或缺,6,,13,8,21,ㄅㄨˋ ㄎㄜˇ ㄏㄨㄛˋ ㄑㄩㄝ,bù kě huò quē
5470,布滿/佈滿,6,,11,7,18,ㄅㄨˋ ㄇㄢˇ,bù mǎn
5471,不平,6,,10,5,15,ㄅㄨˋ ㄆㄧㄥˊ,bù píng
5472,不切實際,6,,8,1,9,ㄅㄨˊ ㄑㄧㄝˋ ㄕˊ ㄐㄧˋ,bú qiè shí jì
5473,不時,6,,40,12,52,ㄅㄨˋ ㄕˊ,bù shí
5474,部署,6,,9,10,19,ㄅㄨˋ ㄕㄨˋ,bù shù
5475,不妥,6,,7,1,8,ㄅㄨˋ ㄊㄨㄛˇ,bù tuǒ
5476,不外乎/不外,6,,8,6,14,ㄅㄨˊ ㄨㄞˋ ㄏㄨ/ㄅㄨˊ ㄨㄞˋ,bú wài hū/bú wài
5477,不惜,6,,16,6,22,ㄅㄨˋ ㄒㄧˊ,bù xí
5478,部下,6,,15,1,16,ㄅㄨˋ ㄒㄧㄚˋ,bù xià
5479,不屑,6,,10,2,12,ㄅㄨˊ ㄒㄧㄝˋ,bú xiè
5480,步行,6,,13,6,19,ㄅㄨˋ ㄒㄧㄥˊ,bù xíng
5481,不朽,6,,7,2,9,ㄅㄨˋ ㄒㄧㄡˇ,bù xiǔ
5482,不宜,6,,14,5,19,ㄅㄨˋ ㄧˊ,bù yí
5483,不已,6,,47,2,49,ㄅㄨˋ ㄧˇ,bù yǐ
5484,不一會/不一會兒,6,,15,1,16,ㄅㄨˊ ㄧˋ ㄏㄨㄟˇ / ㄅㄨˊ ㄧˋ ㄏㄨㄟˇ ㄦ,bú yì huǐ / bú yì huǐr
5485,不以為然,6,,11,4,15,ㄅㄨˋ ㄧˇ ㄨㄟˊ ㄖㄢˊ,bù yǐ wéi rán
5486,不由得,6,,13,1,14,ㄅㄨˋ ㄧㄡˊ ˙ㄉㄜ,bù yóu de
5487,不由自主,6,,11,2,13,ㄅㄨˋ ㄧㄡˊ ㄗˋ ㄓㄨˇ,bù yóu zì zhǔ
5488,不約而同,6,,5,3,8,ㄅㄨˋ ㄩㄝ ㄦˊ ㄊㄨㄥˊ,bù yuē ér tóng
5489,不折不扣,6,,5,1,6,ㄅㄨˋ ㄓㄜˊ ㄅㄨˊ ㄎㄡˋ,bù zhé bú kòu
5490,不致,6,,17,1,18,ㄅㄨˊ ㄓˋ,bú zhì
5491,不知所措,6,,12,5,17,ㄅㄨˋ ㄓ ㄙㄨㄛˇ ㄘㄨㄛˋ,bù zhī suǒ cuò
5492,不至於/不致於,6,,3,2,5,ㄅㄨˊ ㄓˋ ㄩˊ,bú zhì yú
5493,補助,6,,12,24,36,ㄅㄨˇ ㄓㄨˋ,bǔ zhù
5494,捕捉,6,,13,6,19,ㄅㄨˇ ㄓㄨㄛ,bǔ zhuō
5495,擦拭,6,,7,5,12,ㄘㄚ ㄕˋ,cā shì
5496,才幹,6,,5,0,5,ㄘㄞˊ ㄍㄢˋ,cái gàn
5497,採光,6,,1,4,5,ㄘㄞˇ ㄍㄨㄤ,cǎi guāng
5498,彩繪,6,,4,20,24,ㄘㄞˇ ㄏㄨㄟˋ,cǎi huì
5499,採集,6,,11,19,30,ㄘㄞˇ ㄐㄧˊ,cǎi jí
5500,財經,6,,8,4,12,ㄘㄞˊ ㄐㄧㄥ,cái jīng
5501,採買,6,,4,3,7,ㄘㄞˇ ㄇㄞˇ,cǎi mǎi
5502,採納,6,,11,1,12,ㄘㄞˇ ㄋㄚˋ,cǎi nà
5503,財政,6,,17,27,44,ㄘㄞˊ ㄓㄥˋ,cái zhèng
5504,才智,6,,11,1,12,ㄘㄞˊ ㄓˋ,cái zhì
5505,財主,6,,22,1,23,ㄘㄞˊ ㄓㄨˇ,cái zhǔ
5506,殘暴,6,,11,1,12,ㄘㄢˊ ㄅㄠˋ,cán bào
5507,慚愧,6,,11,7,18,ㄘㄢˊ ㄎㄨㄟˋ,cán kuì
5508,燦爛,6,,17,12,29,ㄘㄢˋ ㄌㄢˋ,càn làn
5509,殘留,6,,6,20,26,ㄘㄢˊ ㄌㄧㄡˊ,cán liú
5510,殘破,6,,5,6,11,ㄘㄢˊ ㄆㄛˋ,cán pò
5511,參閱,6,,11,0,11,ㄘㄢ ㄩㄝˋ,cān yuè
5512,殘障,6,,9,9,18,ㄘㄢˊ ㄓㄤˋ,cán zhàng
5513,參照,6,,8,1,9,ㄘㄢ ㄓㄠˋ,cān zhào
5514,倉促,6,,5,1,6,ㄘㄤ ㄘㄨˋ,cāng cù
5515,蒼蠅,6,,12,10,22,ㄘㄤ ㄧㄥˊ,cāng yíng
5516,操,6,,19,11,30,ㄘㄠ,cāo
5517,草案,6,,4,6,10,ㄘㄠˇ ㄢˋ,cǎo àn
5518,草叢,6,,9,3,12,ㄘㄠˇ ㄘㄨㄥˊ,cǎo cóng
5519,草稿,6,,5,2,7,ㄘㄠˇ ㄍㄠˇ,cǎo gǎo
5520,操控,6,,12,5,17,ㄘㄠ ㄎㄨㄥˋ,cāo kòng
5521,草坪,6,,8,1,9,ㄘㄠˇ ㄆㄧㄥˊ,cǎo píng
5522,操心,6,,8,4,12,ㄘㄠ ㄒㄧㄣ,cāo xīn
5523,草藥,6,,9,5,14,ㄘㄠˇ ㄧㄠˋ,cǎo yào
5524,操縱,6,,17,2,19,ㄘㄠ ㄗㄨㄥˋ,cāo zòng
5525,側,6,,60,26,86,ㄘㄜˋ,cè
5526,策畫/策劃,6,,23,8,31,ㄘㄜˋ ㄏㄨㄚˋ,cè huà
5527,測量,6,,42,30,72,ㄘㄜˋ ㄌㄧㄤˊ,cè liáng
5528,層次,6,,51,22,73,ㄘㄥˊ ㄘˋ,céng cì
5529,層級,6,,8,4,12,ㄘㄥˊ ㄐㄧˊ,céng jí
5530,層面,6,,47,25,72,ㄘㄥˊ ㄇㄧㄢˋ,céng miàn
5531,差錯,6,,6,3,9,ㄔㄚ ㄘㄨㄛˋ,chā cuò
5532,差勁,6,,7,1,8,ㄔㄚˋ ㄐㄧㄣˋ,chà jìn
5533,察覺,6,,25,6,31,ㄔㄚˊ ㄐㄩㄝˊ,chá jué
5534,察看,6,,8,1,9,ㄔㄚˊ ㄎㄢˋ,chá kàn
5535,查看,6,,12,4,16,ㄔㄚˊ ㄎㄢˋ,chá kàn
5536,插曲,6,,5,3,8,ㄔㄚ ㄑㄩˇ,chā qǔ
5537,插手,6,,7,3,10,ㄔㄚ ㄕㄡˇ,chā shǒu
5538,插圖,6,,8,2,10,ㄔㄚ ㄊㄨˊ,chā tú
5539,查詢,6,,7,2,9,ㄔㄚˊ ㄒㄩㄣˊ,chá xún
5540,詫異,6,,8,1,9,ㄔㄚˋ ㄧˋ,chà yì
5541,差2,6,,97,159,256,ㄔㄞ,chāi
5542,拆除,6,,6,11,17,ㄔㄞ ㄔㄨˊ,chāi chú
5543,差事,6,,8,0,8,ㄔㄞ ㄕˋ,chāi shì
5544,纏,6,,18,3,21,ㄔㄢˊ,chán
5545,懺悔,6,,8,80,88,ㄔㄢˋ ㄏㄨㄟˇ,chàn huǐ
5546,闡述,6,,13,3,16,ㄔㄢˇ ㄕㄨˋ,chǎn shù
5547,產值,6,,3,9,12,ㄔㄢˇ ㄓˊ,chǎn zhí
5548,禪,6,,39,3,42,ㄔㄢˊ/ㄕㄢˋ,chán/shàn
5549,常規,6,,10,4,14,ㄔㄤˊ ㄍㄨㄟ,cháng guī
5550,長久以來,6,,14,7,21,ㄔㄤˊ ㄐㄧㄡˇ ㄧˇ ㄌㄞˊ,cháng jiǔ yǐ lái
5551,敞開,6,,15,4,19,ㄔㄤˇ ㄎㄞ,chǎng kāi
5552,常客,6,,3,1,4,ㄔㄤˊ ㄎㄜˋ,cháng kè
5553,場面,6,,32,9,41,ㄔㄤˊ ㄇㄧㄢˋ,cháng miàn
5554,長年,6,,12,19,31,ㄔㄤˊ ㄋㄧㄢˊ,cháng nián
5555,常態,6,,9,8,17,ㄔㄤˊ ㄊㄞˋ,cháng tài
5556,長線,6,,1,1,2,ㄔㄤˊ ㄒㄧㄢˋ,cháng xiàn
5557,暢銷,6,,13,4,17,ㄔㄤˋ ㄒㄧㄠ,chàng xiāo
5558,腸子/腸,6,,12,10,22,ㄔㄤˊ ˙ㄗ/ㄔㄤˊ,cháng zi/cháng
5559,巢,6,,17,17,34,ㄔㄠˊ,cháo
5560,朝代/朝2,6,,245,68,313,ㄔㄠˊ ㄉㄞˋ / ㄔㄠˊ,cháo dài / cháo
5561,嘲諷,6,,10,2,12,ㄔㄠˊ ㄈㄥˋ,cháo fèng
5562,超乎,6,,11,4,15,ㄔㄠ ㄏㄨ,chāo hū
5563,嘲弄,6,,9,0,9,ㄔㄠˊ ㄋㄨㄥˋ,cháo nòng
5564,朝野,6,,9,2,11,ㄔㄠˊ ㄧㄝˇ,cháo yě
5565,扯,6,,18,3,21,ㄔㄜˇ,chě
5566,撤離,6,,5,25,30,ㄔㄜˋ ㄌㄧˊ,chè lí
5567,撤退,6,,23,5,28,ㄔㄜˋ ㄊㄨㄟˋ,chè tuì
5568,撤銷,6,,5,3,8,ㄔㄜˋ ㄒㄧㄠ,chè xiāo
5569,徹夜,6,,5,2,7,ㄔㄜˋ ㄧㄝˋ,chè yè
5570,趁機,6,,14,8,22,ㄔㄣˋ ㄐㄧ,chèn jī
5571,沉浸,6,,11,4,15,ㄔㄣˊ ㄐㄧㄣˋ,chén jìn
5572,陳列,6,,8,4,12,ㄔㄣˊ ㄌㄧㄝˋ,chén liè
5573,沉迷,6,,7,4,11,ㄔㄣˊ ㄇㄧˊ,chén mí
5574,沉思,6,,21,1,22,ㄔㄣˊ ㄙ,chén sī
5575,塵土,6,,9,3,12,ㄔㄣˊ ㄊㄨˇ,chén tǔ
5576,呈,6,,34,9,43,ㄔㄥˊ,chéng
5577,程,6,,14,16,30,ㄔㄥˊ,chéng
5578,城堡,6,,16,6,22,ㄔㄥˊ ㄅㄠˇ,chéng bǎo
5579,承擔,6,,35,41,76,ㄔㄥˊ ㄉㄢ,chéng dān
5580,稱得上,6,,8,2,10,ㄔㄥ ˙ㄉㄜ ㄕㄤˋ,chēng de shàng
5581,乘機,6,,11,0,11,ㄔㄥˊ ㄐㄧ,chéng jī
5582,成家,6,,5,2,7,ㄔㄥˊ ㄐㄧㄚ,chéng jiā
5583,成見,6,,11,2,13,ㄔㄥˊ ㄐㄧㄢˋ,chéng jiàn
5584,成交,6,,6,1,7,ㄔㄥˊ ㄐㄧㄠ,chéng jiāo
5585,誠懇,6,,13,4,17,ㄔㄥˊ ㄎㄣˇ,chéng kěn
5586,成千上萬,6,,8,6,14,ㄔㄥˊ ㄑㄧㄢ ㄕㄤˋ ㄨㄢˋ,chéng qiān shàng wàn
5587,城牆,6,,11,6,17,ㄔㄥˊ ㄑㄧㄤˊ,chéng qiáng
5588,成親,6,,8,0,8,ㄔㄥˊ ㄑㄧㄣ,chéng qīn
5589,澄清,6,,11,6,17,ㄔㄥˊ ㄑㄧㄥ,chéng qīng
5590,成全,6,,5,3,8,ㄔㄥˊ ㄑㄩㄢˊ,chéng quán
5591,成群,6,,8,4,12,ㄔㄥˊ ㄑㄩㄣˊ,chéng qún
5592,誠如,6,,12,3,15,ㄔㄥˊㄖㄨˊ,chéng rú
5593,承受,6,,38,31,69,ㄔㄥˊ ㄕㄡˋ,chéng shòu
5594,成天,6,,11,2,13,ㄔㄥˊ ㄊㄧㄢ,chéng tiān
5595,呈現,6,,75,75,150,ㄔㄥˊ ㄒㄧㄢˋ,chéng xiàn
5596,誠信,6,,5,2,7,ㄔㄥˊ ㄒㄧㄣˋ,chéng xìn
5597,誠心,6,,7,6,13,ㄔㄥˊ ㄒㄧㄣ,chéng xīn
5598,成形,6,,11,9,20,ㄔㄥˊ ㄒㄧㄥˊ,chéng xíng
5599,程序,6,,41,19,60,ㄔㄥˊ ㄒㄩˋ,chéng xù
5600,誠意,6,,8,10,18,ㄔㄥˊ ㄧˋ,chéng yì
5601,成衣,6,,2,9,11,ㄔㄥˊ ㄧ,chéng yī
5602,成因,6,,9,2,11,ㄔㄥˊ ㄧㄣ,chéng yīn
5603,誠摯,6,,5,3,8,ㄔㄥˊ ㄓˋ,chéng zhì
5604,盛,6,,24,12,36,ㄔㄥˊ/ㄕㄥˋ,chéng/shèng
5605,遲,6,,26,6,32,ㄔˊ,chí
5606,癡/痴,6,,11,12,23,ㄔ/ ㄔ,chī / chī
5607,尺度,6,,9,4,13,ㄔˇ ㄉㄨˋ,chǐ dù
5608,遲鈍,6,,8,2,10,ㄔˊ ㄉㄨㄣˋ,chí dùn
5609,遲緩,6,,7,7,14,ㄔˊ ㄏㄨㄢˇ,chí huǎn
5610,持久,6,,11,3,14,ㄔˊ ㄐㄧㄡˇ,chí jiǔ
5611,池塘,6,,8,7,15,ㄔˊ ㄊㄤˊ,chí táng
5612,遲疑,6,,21,4,25,ㄔˊ ㄧˊ,chí yí
5613,斥責,6,,10,1,11,ㄔˋ ㄗㄜˊ,chì zé
5614,衝2,6,,32,19,51,ㄔㄨㄥˋ,chòng
5615,寵愛,6,,13,3,16,ㄔㄨㄥˇ ㄞˋ,chǒng ài
5616,充斥,6,,13,4,17,ㄔㄨㄥ ㄔˋ,chōng chì
5617,重重,6,,25,15,40,ㄔㄨㄥˊ ㄔㄨㄥˊ,chóng chóng
5618,衝刺,6,,7,3,10,ㄔㄨㄥ ㄘˋ,chōng cì
5619,充當,6,,11,3,14,ㄔㄨㄥ ㄉㄤ,chōng dāng
5620,重疊,6,,11,6,17,ㄔㄨㄥˊ ㄉㄧㄝˊ,chóng dié
5621,重逢,6,,6,1,7,ㄔㄨㄥˊ ㄈㄥˊ,chóng féng
5622,崇高,6,,14,6,20,ㄔㄨㄥˊ ㄍㄠ,chóng gāo
5623,衝擊,6,,35,47,82,ㄔㄨㄥ ㄐㄧˊ,chōng jí
5624,充沛,6,,12,6,18,ㄔㄨㄥ ㄆㄟˋ,chōng pèi
5625,崇尚,6,,7,4,11,ㄔㄨㄥˊ ㄕㄤˋ,chóng shàng
5626,重演,6,,7,4,11,ㄔㄨㄥˊ ㄧㄢˇ,chóng yǎn
5627,充裕,6,,6,3,9,ㄔㄨㄥ ㄩˋ,chōng yù
5628,重整,6,,6,8,14,ㄔㄨㄥˊ ㄓㄥˇ,chóng zhěng
5629,仇,6,,14,8,22,ㄔㄡˊ,chóu
5630,愁,6,,19,4,23,ㄔㄡˊ,chóu
5631,籌備,6,,8,7,15,ㄔㄡˊ ㄅㄟˋ,chóu bèi
5632,抽查,6,,1,2,3,ㄔㄡ ㄔㄚˊ,chōu chá
5633,抽搐,6,,9,1,10,ㄔㄡ ㄔㄨˋ,chōu chù
5634,醜惡,6,,5,1,6,ㄔㄡˇ ㄜˋ,chǒu è
5635,仇恨,6,,14,7,21,ㄔㄡˊ ㄏㄣˋ,chóu hèn
5636,籌畫/籌劃,6,,7,4,11,ㄔㄡˊ ㄏㄨㄚˋ,chóu huà
5637,醜陋,6,,13,2,15,ㄔㄡˇ ㄌㄡˋ,chǒu lòu
5638,醜聞,6,,7,5,12,ㄔㄡˇ ㄨㄣˊ,chǒu wén
5639,抽樣,6,,4,2,6,ㄔㄡ ㄧㄤˋ,chōu yàng
5640,處2,6,,288,106,394,ㄔㄨˇ,chǔ
5641,齣,6,,18,14,32,ㄔㄨ,chū
5642,儲備,6,,8,5,13,ㄔㄨˊ ㄅㄟˋ,chú bèi
5643,出場,6,,12,2,14,ㄔㄨ ㄔㄤˊ,chū cháng
5644,出超,6,,1,0,1,ㄔㄨ ㄔㄠ,chū chāo
5645,櫥窗,6,,7,2,9,ㄔㄨˊ ㄔㄨㄤ,chú chuāng
5646,觸動,6,,9,8,17,ㄔㄨˋ ㄉㄨㄥˋ,chù dòng
5647,出動,6,,7,18,25,ㄔㄨ ㄉㄨㄥˋ,chū dòng
5648,出發點,6,,8,8,16,ㄔㄨ ㄈㄚ ㄉㄧㄢˇ,chū fā diǎn
5649,處分,6,,8,1,9,ㄔㄨˇ ㄈㄣˋ,chǔ fèn
5650,出乎意料,6,,9,2,11,ㄔㄨ ㄏㄨ ㄧˋ ㄌㄧㄠˋ,chū hū yì liào
5651,觸及,6,,10,2,12,ㄔㄨˋ ㄐㄧˊ,chù jí
5652,出擊,6,,10,2,12,ㄔㄨ ㄐㄧˊ,chū jí
5653,出嫁,6,,8,2,10,ㄔㄨ ㄐㄧㄚˋ,chū jià
5654,出家,6,,9,9,18,ㄔㄨ ㄐㄧㄚ,chū jiā
5655,處境,6,,32,20,52,ㄔㄨˇ ㄐㄧㄥˋ,chǔ jìng
5656,觸覺,6,,13,4,17,ㄔㄨˋ ㄐㄩㄝˊ,chù jué
5657,觸控,6,,2,14,16,ㄔㄨˋ ㄎㄨㄥˋ,chù kòng
5658,出爐,6,,4,9,13,ㄔㄨ ㄌㄨˊ,chū lú
5659,出馬,6,,5,2,7,ㄔㄨ ㄇㄚˇ,chū mǎ
5660,出賣,6,,10,2,12,ㄔㄨ ㄇㄞˋ,chū mài
5661,出面,6,,15,16,31,ㄔㄨ ㄇㄧㄢˋ,chū miàn
5662,觸摸,6,,10,7,17,ㄔㄨˋ ㄇㄛ,chù mō
5663,出奇,6,,9,2,11,ㄔㄨ ㄑㄧˊ,chū qí
5664,出任,6,,15,4,19,ㄔㄨ ㄖㄣˋ,chū rèn
5665,出人頭地,6,,5,2,7,ㄔㄨ ㄖㄣˊ ㄊㄡˊ ㄉㄧˋ,chū rén tóu dì
5666,出入,6,,14,4,18,ㄔㄨ ㄖㄨˋ,chū rù
5667,出聲,6,,13,1,14,ㄔㄨ ㄕㄥ,chū shēng
5668,處世,6,,10,2,12,ㄔㄨˇ ㄕˋ,chǔ shì
5669,處事,6,,7,6,13,ㄔㄨˇ ㄕˋ,chǔ shì
5670,出世,6,,8,3,11,ㄔㄨ ㄕˋ,chū shì
5671,出事,6,,11,4,15,ㄔㄨ ㄕˋ,chū shì
5672,出售,6,,12,3,15,ㄔㄨ ㄕㄡˋ,chū shòu
5673,處死,6,,15,1,16,ㄔㄨˇ ㄙˇ,chǔ sǐ
5674,出頭,6,,11,6,17,ㄔㄨ ㄊㄡˊ,chū tóu
5675,出遊,6,,7,3,10,ㄔㄨ ㄧㄡˊ,chū yóu
5676,處於,6,,51,23,74,ㄔㄨˇ ㄩˊ,chǔ yú
5677,出於,6,,37,5,42,ㄔㄨ ㄩˊ,chū yú
5678,出獄,6,,8,8,16,ㄔㄨ ㄩˋ,chū yù
5679,出征,6,,13,1,14,ㄔㄨ ㄓㄥ,chū zhēng
5680,處置,6,,14,3,17,ㄔㄨˇ ㄓˋ,chǔ zhì
5681,出眾,6,,8,1,9,ㄔㄨ ㄓㄨㄥˋ,chū zhòng
5682,傳承,6,,23,61,84,ㄔㄨㄢˊ ㄔㄥˊ,chuán chéng
5683,傳導,6,,11,10,21,ㄔㄨㄢˊ ㄉㄠˇ,chuán dǎo
5684,傳遞,6,,24,26,50,ㄔㄨㄢˊ ㄉㄧˋ,chuán dì
5685,傳授,6,,10,5,15,ㄔㄨㄢˊ ㄕㄡˋ,chuán shòu
5686,穿透,6,,9,8,17,ㄔㄨㄢ ㄊㄡˋ,chuān tòu
5687,傳聞,6,,10,2,12,ㄔㄨㄢˊ ㄨㄣˊ,chuán wén
5688,喘息,6,,8,4,12,ㄔㄨㄢˇ ㄒㄧˊ,chuǎn xí
5689,傳言,6,,9,2,11,ㄔㄨㄢˊ ㄧㄢˊ,chuán yán
5690,瘡,6,,8,11,19,ㄔㄨㄤ,chuāng
5691,創建,6,,8,3,11,ㄔㄨㄤˋ ㄐㄧㄢˋ,chuàng jiàn
5692,窗簾,6,,11,7,18,ㄔㄨㄤ ㄌㄧㄢˊ,chuāng lián
5693,創傷,6,,42,13,55,ㄔㄨㄤ ㄕㄤ,chuāng shāng
5694,垂,6,,13,4,17,ㄔㄨㄟˊ,chuí
5695,捶,6,,6,2,8,ㄔㄨㄟˊ,chuí
5696,垂直,6,,14,18,32,ㄔㄨㄟˊ ㄓˊ,chuí zhí
5697,蠢,6,,20,2,22,ㄔㄨㄣˇ,chǔn
5698,純粹,6,,31,13,44,ㄔㄨㄣˊ ㄘㄨㄟˋ,chún cuì
5699,純潔,6,,10,1,11,ㄔㄨㄣˊ ㄐㄧㄝˊ,chún jié
5700,純淨,6,,7,6,13,ㄔㄨㄣˊ ㄐㄧㄥˋ,chún jìng
5701,純真,6,,10,6,16,ㄔㄨㄣˊ ㄓㄣ,chún zhēn
5702,戳,6,,7,3,10,ㄔㄨㄛ,chuō
5703,綽號,6,,8,5,13,ㄔㄨㄛˋ ㄏㄠˋ,chuò hào
5704,雌,6,,12,20,32,ㄘ,cī
5705,慈愛,6,,7,3,10,ㄘˊ ㄞˋ,cí ài
5706,慈悲,6,,17,30,47,ㄘˊ ㄅㄟ,cí bēi
5707,刺耳,6,,7,1,8,ㄘˋ ㄦˇ,cì ěr
5708,伺候,6,,8,1,9,ㄘˋ ㄏㄡˋ,cì hòu
5709,瓷器,6,,7,10,17,ㄘˊ ㄑㄧˋ,cí qì
5710,辭去,6,,8,3,11,ㄘˊ ㄑㄩˋ,cí qù
5711,次日,6,,11,0,11,ㄘˋ ㄖˋ,cì rì
5712,慈善,6,,13,50,63,ㄘˊ ㄕㄢˋ,cí shàn
5713,刺痛,6,,6,2,8,ㄘˋ ㄊㄨㄥˋ,cì tòng
5714,次序,6,,9,4,13,ㄘˋ ㄒㄩˋ,cì xù
5715,次要,6,,8,2,10,ㄘˋ ㄧㄠˋ,cì yào
5716,次於,6,,7,4,11,ㄘˋ ㄩˊ,cì yú
5717,叢,6,,11,7,18,ㄘㄨㄥˊ,cóng
5718,從而,6,,36,1,37,ㄘㄨㄥˊ ㄦˊ,cóng ér
5719,叢林,6,,11,8,19,ㄘㄨㄥˊ ㄌㄧㄣˊ,cóng lín
5720,從容,6,,13,4,17,ㄘㄨㄥ ㄖㄨㄥˊ,cōng róng
5721,叢書,6,,30,1,31,ㄘㄨㄥˊ ㄕㄨ,cóng shū
5722,湊,6,,10,7,17,ㄘㄡˋ,còu
5723,湊巧,6,,6,1,7,ㄘㄡˋ ㄑㄧㄠˇ,còu qiǎo
5724,粗暴,6,,8,1,9,ㄘㄨ ㄅㄠˋ,cū bào
5725,粗糙,6,,14,8,22,ㄘㄨ ㄘㄠ,cū cāo
5726,促成,6,,17,11,28,ㄘㄨˋ ㄔㄥˊ,cù chéng
5727,促進,6,,41,24,65,ㄘㄨˋ ㄐㄧㄣˋ,cù jìn
5728,粗魯,6,,8,3,11,ㄘㄨ ㄌㄨˇ,cū lǔ
5729,促銷,6,,11,4,15,ㄘㄨˋ ㄒㄧㄠ,cù xiāo
5730,脆,6,,8,17,25,ㄘㄨㄟˋ,cuì
5731,催促,6,,12,3,15,ㄘㄨㄟ ㄘㄨˋ,cuī cù
5732,摧毀,6,,17,16,33,ㄘㄨㄟ ㄏㄨㄟˇ,cuī huǐ
5733,催眠,6,,8,3,11,ㄘㄨㄟ ㄇㄧㄢˊ,cuī mián
5734,存活,6,,12,13,25,ㄘㄨㄣˊ ㄏㄨㄛˊ,cún huó
5735,存貨,6,,5,1,6,ㄘㄨㄣˊ ㄏㄨㄛˋ,cún huò
5736,村落,6,,13,23,36,ㄘㄨㄣ ㄌㄨㄛˋ,cūn luò
5737,村民,6,,13,37,50,ㄘㄨㄣ ㄇㄧㄣˊ,cūn mín
5738,存心,6,,6,0,6,ㄘㄨㄣˊ ㄒㄧㄣ,cún xīn
5739,存有,6,,11,2,13,ㄘㄨㄣˊㄧㄡˇ,cún yǒu
5740,村莊,6,,16,34,50,ㄘㄨㄣ ㄓㄨㄤ,cūn zhuāng
5741,搓,6,,9,19,28,ㄘㄨㄛ,cuō
5742,挫敗,6,,14,3,17,ㄘㄨㄛˋ ㄅㄞˋ,cuò bài
5743,錯覺,6,,9,1,10,ㄘㄨㄛˋ ㄐㄩㄝˊ,cuò jué
5744,錯亂,6,,7,1,8,ㄘㄨㄛˋ ㄌㄨㄢˋ,cuò luàn
5745,措施,6,,39,51,90,ㄘㄨㄛˋ ㄕ,cuò shī
5746,錯失,6,,8,2,10,ㄘㄨㄛˋ ㄕ,cuò shī
5747,大敗,6,,10,1,11,ㄉㄚˋ ㄅㄞˋ,dà bài
5748,大不了,6,,7,3,10,ㄉㄚˋ ㄅㄨˋ ㄌㄧㄠˇ,dà bù liǎo
5749,達成,6,,68,41,109,ㄉㄚˊ ㄔㄥˊ,dá chéng
5750,大吃一驚,6,,16,2,18,ㄉㄚˋ ㄔ ㄧˋ ㄐㄧㄥ,dà chī yì jīng
5751,打從,6,,16,6,22,ㄉㄚˇ ㄘㄨㄥˊ,dǎ cóng
5752,大錯特錯,6,,4,0,4,ㄉㄚˋ ㄘㄨㄛˋ ㄊㄜˋ ㄘㄨㄛˋ,dà cuò tè cuò
5753,大大小小,6,,10,16,26,ㄉㄚˋ ㄉㄚˋ ㄒㄧㄠˇ ㄒㄧㄠˇ,dà dà xiǎo xiǎo
5754,搭檔,6,,6,2,8,ㄉㄚ ㄉㄤˇ,dā dǎng
5755,大抵,6,,8,1,9,ㄉㄚˋ ㄉㄧˇ,dà dǐ
5756,打鬥,6,,5,1,6,ㄉㄚˇ ㄉㄡˋ,dǎ dòu
5757,打發,6,,12,3,15,ㄉㄚˇ ㄈㄚ,dǎ fā
5758,答覆,6,,12,2,14,ㄉㄚˊ ㄈㄨˋ,dá fù
5759,大幅,6,,25,25,50,ㄉㄚˋ ㄈㄨˊ,dà fú
5760,大綱,6,,6,3,9,ㄉㄚˋ ㄍㄤ,dà gāng
5761,大漢,6,,8,1,9,ㄉㄚˋ ㄏㄢˋ,dà hàn
5762,大戶,6,,5,1,6,ㄉㄚˋ ㄏㄨˋ,dà hù
5763,大夥,6,,9,2,11,ㄉㄚˋ ㄏㄨㄛˇ,dà huǒ
5764,大夥兒,6,,12,3,15,ㄉㄚˋ ㄏㄨㄛˇㄦ,dà huǒr
5765,打交道,6,,10,3,13,ㄉㄚˇ ㄐㄧㄠ ㄉㄠˋ,dǎ jiāo dào
5766,大驚小怪,6,,6,2,8,ㄉㄚˋ ㄐㄧㄥ ㄒㄧㄠˇ ㄍㄨㄞˋ,dà jīng xiǎo guài
5767,大局,6,,8,3,11,ㄉㄚˋ ㄐㄩˊ,dà jú
5768,大舉,6,,8,5,13,ㄉㄚˋ ㄐㄩˇ,dà jǔ
5769,大開眼界,6,,3,3,6,ㄉㄚˋ ㄎㄞ ㄧㄢˇ ㄐㄧㄝˋ,dà kāi yǎn jiè
5770,大力,6,,18,17,35,ㄉㄚˋ ㄌㄧˋ,dà lì
5771,打量,6,,19,1,20,ㄉㄚˇ ㄌㄧㄤˋ,dǎ liàng
5772,大略,6,,7,2,9,ㄉㄚˋ ㄌㄩㄝˋ,dà lüè
5773,大氣,6,,12,37,49,ㄉㄚˋ ㄑㄧˋ,dà qì
5774,大權,6,,16,3,19,ㄉㄚˋ ㄑㄩㄢˊ,dà quán
5775,打擾,6,,16,9,25,ㄉㄚˇ ㄖㄠˇ,dǎ rǎo
5776,搭訕,6,,3,1,4,ㄉㄚ ㄕㄢˋ,dā shàn
5777,大勢,6,,7,1,8,ㄉㄚˋ ㄕˋ,dà shì
5778,大使,6,,10,11,21,ㄉㄚˋ ㄕˇ,dà shǐ
5779,大體,6,,12,28,40,ㄉㄚˋ ㄊㄧˇ,dà tǐ
5780,大同小異,6,,4,1,5,ㄉㄚˋ ㄊㄨㄥˊ ㄒㄧㄠˇ ㄧˋ,dà tóng xiǎo yì
5781,大為,6,,24,5,29,ㄉㄚˋ ㄨㄟˊ,dà wéi
5782,大喜,6,,12,1,13,ㄉㄚˋ ㄒㄧˇ,dà xǐ
5783,大廈,6,,12,2,14,ㄉㄚˋ ㄒㄧㄚˋ,dà xià
5784,打烊,6,,3,3,6,ㄉㄚˇ ㄧㄤˊ,dǎ yáng
5785,大意,6,,11,4,15,ㄉㄚˋ ㄧˋ,dà yì
5786,打造,6,,19,32,51,ㄉㄚˇ ㄗㄠˋ,dǎ zào
5787,打針,6,,4,10,14,ㄉㄚˇ ㄓㄣ,dǎ zhēn
5788,打轉,6,,9,2,11,ㄉㄚˇ ㄓㄨㄢˋ,dǎ zhuàn
5789,大作,6,,13,4,17,ㄉㄚˋ ㄗㄨㄛˋ,dà zuò
5790,帶兵,6,,9,1,10,ㄉㄞˋ ㄅㄧㄥ,dài bīng
5791,帶動,6,,15,51,66,ㄉㄞˋ ㄉㄨㄥˋ,dài dòng
5792,殆盡,6,,9,6,15,ㄉㄞˋ ㄐㄧㄣˋ,dài jìn
5793,帶頭,6,,9,7,16,ㄉㄞˋ ㄊㄡˊ,dài tóu
5794,歹徒,6,,5,4,9,ㄉㄞˇ ㄊㄨˊ,dǎi tú
5795,擔1,6,,14,4,18,ㄉㄢˋ,dàn
5796,擔2,6,,14,4,18,ㄉㄢ,dān
5797,蛋白質,6,,40,37,77,ㄉㄢˋ ㄅㄞˊ ㄓˊ,dàn bái zhí
5798,單單,6,,8,7,15,ㄉㄢ ㄉㄢ,dān dān
5799,擔當,6,,11,2,13,ㄉㄢ ㄉㄤ,dān dāng
5800,單調,6,,11,5,16,ㄉㄢ ㄉㄧㄠˋ,dān diào
5801,耽擱,6,,5,3,8,ㄉㄢ ㄍㄜ,dān gē
5802,膽固醇,6,,9,11,20,ㄉㄢˇ ㄍㄨˋ ㄔㄨㄣˊ,dǎn gù chún
5803,膽量,6,,5,3,8,ㄉㄢˇ ㄌㄧㄤˋ,dǎn liàng
5804,膽怯,6,,7,0,7,ㄉㄢˇ ㄑㄩㄝˋ,dǎn què
5805,單行道,6,,1,1,2,ㄉㄢ ㄒㄧㄥˊ ㄉㄠˋ,dān xíng dào
5806,單元,6,,12,31,43,ㄉㄢ ㄩㄢˊ,dān yuán
5807,擔子,6,,5,2,7,ㄉㄢˋ ˙ㄗ,dàn zi
5808,檔,6,,8,4,12,ㄉㄤˇ,dǎng
5809,當家,6,,8,3,11,ㄉㄤ ㄐㄧㄚ,dāng jiā
5810,黨派,6,,4,4,8,ㄉㄤˇ ㄆㄞˋ,dǎng pài
5811,當前,6,,16,7,23,ㄉㄤ ㄑㄧㄢˊ,dāng qián
5812,當下,6,,53,64,117,ㄉㄤ ㄒㄧㄚˋ,dāng xià
5813,當真,6,,10,0,10,ㄉㄤˋ ㄓㄣ,dàng zhēn
5814,當眾,6,,7,1,8,ㄉㄤ ㄓㄨㄥˋ,dāng zhòng
5815,盜,6,,8,9,17,ㄉㄠˋ,dào
5816,倒閉,6,,6,4,10,ㄉㄠˇ ㄅㄧˋ,dǎo bì
5817,道別,6,,11,2,13,ㄉㄠˋ ㄅㄧㄝˊ,dào bié
5818,搗蛋,6,,5,4,9,ㄉㄠˇ ㄉㄢˋ,dǎo dàn
5819,道家,6,,8,1,9,ㄉㄠˋ ㄐㄧㄚ,dào jiā
5820,道具,6,,8,13,21,ㄉㄠˋ ㄐㄩˋ,dào jù
5821,刀刃,6,,2,1,3,ㄉㄠ ㄖㄣˋ,dāo rèn
5822,導入,6,,5,4,9,ㄉㄠˇㄖㄨˋ,dǎo rù
5823,道士,6,,13,2,15,ㄉㄠˋ ㄕˋ,dào shì
5824,導師,6,,15,10,25,ㄉㄠˇ ㄕ,dǎo shī
5825,到手,6,,8,3,11,ㄉㄠˋ ㄕㄡˇ,dào shǒu
5826,倒塌,6,,5,21,26,ㄉㄠˇ ㄊㄚ,dǎo tā
5827,到頭來,6,,9,2,11,ㄉㄠˋ ㄊㄡˊ ㄌㄞˊ,dào tóu lái
5828,導向,6,,16,4,20,ㄉㄠˇ ㄒㄧㄤˋ,dǎo xiàng
5829,導引,6,,10,4,14,ㄉㄠˇ ㄧㄣˇ,dǎo yǐn
5830,島嶼,6,,10,35,45,ㄉㄠˇ ㄩˇ,dǎo yǔ
5831,導致,6,,118,87,205,ㄉㄠˇ ㄓˋ,dǎo zhì
5832,得力,6,,5,5,10,ㄉㄜˊ ㄌㄧˋ,dé lì
5833,得失,6,,9,3,12,ㄉㄜˊ ㄕ,dé shī
5834,得體,6,,7,1,8,ㄉㄜˊ ㄊㄧˇ,dé tǐ
5835,得以,6,,65,32,97,ㄉㄜˊ ㄧˇ,dé yǐ
5836,得主,6,,11,10,21,ㄉㄜˊ ㄓㄨˇ,dé zhǔ
5837,得罪,6,,15,2,17,ㄉㄜˊ ㄗㄨㄟˋ,dé zuì
5838,登場,6,,9,8,17,ㄉㄥ ㄔㄤˊ,dēng cháng
5839,等級,6,,13,17,30,ㄉㄥˇ ㄐㄧˊ,děng jí
5840,燈籠,6,,10,15,25,ㄉㄥ ㄌㄨㄥˊ,dēng lóng
5841,登陸,6,,11,10,21,ㄉㄥ ㄌㄨˋ,dēng lù
5842,等同,6,,9,6,15,ㄉㄥˇ ㄊㄨㄥˊ,děng tóng
5843,凳子/凳,6,,11,3,14,ㄉㄥˋ ˙ㄗ/ㄉㄥˋ,dèng zi/dèng
5844,抵,6,,18,5,23,ㄉㄧˇ,dǐ
5845,地步,6,,31,7,38,ㄉㄧˋ ㄅㄨˋ,dì bù
5846,低潮,6,,5,13,18,ㄉㄧ ㄔㄠˊ,dī cháo
5847,低沉,6,,11,1,12,ㄉㄧ ㄔㄣˊ,dī chén
5848,抵達,6,,56,29,85,ㄉㄧˇ ㄉㄚˊ,dǐ dá
5849,抵擋,6,,9,6,15,ㄉㄧˇ ㄉㄤˇ,dǐ dǎng
5850,低調,6,,7,7,14,ㄉㄧ ㄉㄧㄠˋ,dī diào
5851,敵對,6,,9,8,17,ㄉㄧˊ ㄉㄨㄟˋ,dí duì
5852,嘀咕,6,,5,1,6,ㄉㄧˊ ˙ㄍㄨ,dí gu
5853,低估,6,,9,3,12,ㄉㄧ ㄍㄨ,dī gū
5854,帝國,6,,120,22,142,ㄉㄧˋ ㄍㄨㄛˊ,dì guó
5855,敵軍,6,,15,2,17,ㄉㄧˊ ㄐㄩㄣ,dí jūn
5856,地利,6,,5,4,9,ㄉㄧˋ ㄌㄧˋ,dì lì
5857,低廉,6,,6,4,10,ㄉㄧ ㄌㄧㄢˊ,dī lián
5858,地盤,6,,13,4,17,ㄉㄧˋ ㄆㄢˊ,dì pán
5859,地平線,6,,8,1,9,ㄉㄧˋ ㄆㄧㄥˊ ㄒㄧㄢˋ,dì píng xiàn
5860,地勢,6,,5,12,17,ㄉㄧˋ ㄕˋ,dì shì
5861,地毯,6,,14,6,20,ㄉㄧˋ ㄊㄢˇ,dì tǎn
5862,低下,6,,13,2,15,ㄉㄧ ㄒㄧㄚˋ,dī xià
5863,弟兄,6,,23,8,31,ㄉㄧˋ ㄒㄩㄥ,dì xiōng
5864,地域,6,,10,4,14,ㄉㄧˋ ㄩˋ,dì yù
5865,地獄,6,,23,11,34,ㄉㄧˋ ㄩˋ,dì yù
5866,抵制,6,,7,4,11,ㄉㄧˇ ㄓˋ,dǐ zhì
5867,地主,6,,20,11,31,ㄉㄧˋ ㄓㄨˇ,dì zhǔ
5868,電報,6,,17,9,26,ㄉㄧㄢˋ ㄅㄠˋ,diàn bào
5869,顛倒,6,,10,5,15,ㄉㄧㄢ ㄉㄠˇ,diān dǎo
5870,點滴,6,,6,14,20,ㄉㄧㄢˇ ㄉㄧ,diǎn dī
5871,奠定,6,,13,6,19,ㄉㄧㄢˋ ㄉㄧㄥˋ,diàn dìng
5872,巔峰,6,,6,5,11,ㄉㄧㄢ ㄈㄥ,diān fēng
5873,顛覆,6,,13,6,19,ㄉㄧㄢ ㄈㄨˋ,diān fù
5874,店家,6,,13,9,22,ㄉㄧㄢˋ ㄐㄧㄚ,diàn jiā
5875,店面,6,,12,6,18,ㄉㄧㄢˋ ㄇㄧㄢˋ,diàn miàn
5876,點燃,6,,15,11,26,ㄉㄧㄢˇ ㄖㄢˊ,diǎn rán
5877,電台/電臺,6,,14,11,25,ㄉㄧㄢˋ ㄊㄞˊ,diàn tái
5878,殿堂,6,,7,5,12,ㄉㄧㄢˋ ㄊㄤˊ,diàn táng
5879,點綴,6,,5,3,8,ㄉㄧㄢˇ ㄓㄨㄟˋ,diǎn zhuì
5880,吊,6,,15,14,29,ㄉㄧㄠˋ,diào
5881,雕,6,,8,5,13,ㄉㄧㄠ,diāo
5882,雕刻,6,,9,8,17,ㄉㄧㄠ ㄎㄜˋ,diāo kè
5883,雕塑,6,,7,6,13,ㄉㄧㄠ ㄙㄨˋ,diāo sù
5884,雕像,6,,12,5,17,ㄉㄧㄠ ㄒㄧㄤˋ,diāo xiàng
5885,疊,6,,16,13,29,ㄉㄧㄝˊ,dié
5886,釘2,6,,12,14,26,ㄉㄧㄥˋ,dìng
5887,丁,6,,11,50,61,ㄉㄧㄥ,dīng
5888,釘1,6,,12,14,26,ㄉㄧㄥ,dīng
5889,頂點,6,,5,2,7,ㄉㄧㄥˇ ㄉㄧㄢˇ,dǐng diǎn
5890,訂定,6,,10,6,16,ㄉㄧㄥˋ ㄉㄧㄥˋ,dìng dìng
5891,頂端,6,,12,10,22,ㄉㄧㄥˇ ㄉㄨㄢ,dǐng duān
5892,頂尖,6,,15,3,18,ㄉㄧㄥˇ ㄐㄧㄢ,dǐng jiān
5893,定居,6,,12,14,26,ㄉㄧㄥˋ ㄐㄩ,dìng jū
5894,定律,6,,18,4,22,ㄉㄧㄥˋ ㄌㄩˋ,dìng lǜ
5895,叮嚀,6,,9,12,21,ㄉㄧㄥ ㄋㄧㄥˊ,dīng níng
5896,定位,6,,27,25,52,ㄉㄧㄥˋ ㄨㄟˋ,dìng wèi
5897,定型,6,,5,4,9,ㄉㄧㄥˋ ㄒㄧㄥˊ,dìng xíng
5898,釘子,6,,7,4,11,ㄉㄧㄥ ˙ㄗ,dīng zi
5899,丟棄,6,,9,17,26,ㄉㄧㄡ ㄑㄧˋ,diū qì
5900,丟人,6,,3,0,3,ㄉㄧㄡ ㄖㄣˊ,diū rén
5901,動盪,6,,8,25,33,ㄉㄨㄥˋ ㄉㄤˋ,dòng dàng
5902,動靜,6,,16,3,19,ㄉㄨㄥˋ ㄐㄧㄥˋ,dòng jìng
5903,動亂,6,,8,18,26,ㄉㄨㄥˋ ㄌㄨㄢˋ,dòng luàn
5904,董事,6,,15,3,18,ㄉㄨㄥˇ ㄕˋ,dǒng shì
5905,動態,6,,16,12,28,ㄉㄨㄥˋ ㄊㄞˋ,dòng tài
5906,動彈,6,,5,1,6,ㄉㄨㄥˋ ㄊㄢˊ,dòng tán
5907,動線,6,,2,4,6,ㄉㄨㄥˋ ㄒㄧㄢˋ,dòng xiàn
5908,動向,6,,6,1,7,ㄉㄨㄥˋ ㄒㄧㄤˋ,dòng xiàng
5909,洞穴,6,,10,4,14,ㄉㄨㄥˋ ㄒㄩㄝˋ,dòng xuè
5910,動搖,6,,15,4,19,ㄉㄨㄥˋ ㄧㄠˊ,dòng yáo
5911,動用,6,,10,8,18,ㄉㄨㄥˋ ㄩㄥˋ,dòng yòng
5912,動員,6,,16,12,28,ㄉㄨㄥˋ ㄩㄢˊ,dòng yuán
5913,東張西望,6,,3,2,5,ㄉㄨㄥ ㄓㄤ ㄒㄧ ㄨㄤˋ,dōng zhāng xī wàng
5914,逗,6,,14,6,20,ㄉㄡˋ,dòu
5915,抖,6,,13,5,18,ㄉㄡˇ,dǒu
5916,陡,6,,7,7,14,ㄉㄡˇ,dǒu
5917,鬥爭,6,,38,6,44,ㄉㄡˋ ㄓㄥ,dòu zhēng
5918,渡,6,,13,7,20,ㄉㄨˋ,dù
5919,堵,6,,10,6,16,ㄉㄨˇ,dǔ
5920,獨裁,6,,12,18,30,ㄉㄨˊ ㄘㄞˊ,dú cái
5921,獨處,6,,16,3,19,ㄉㄨˊ ㄔㄨˇ,dú chǔ
5922,獨到,6,,5,3,8,ㄉㄨˊ ㄉㄠˋ,dú dào
5923,獨家,6,,4,3,7,ㄉㄨˊ ㄐㄧㄚ,dú jiā
5924,肚皮,6,,7,2,9,ㄉㄨˋ ㄆㄧˊ,dù pí
5925,毒手,6,,5,1,6,ㄉㄨˊ ㄕㄡˇ,dú shǒu
5926,毒素,6,,9,13,22,ㄉㄨˊ ㄙㄨˋ,dú sù
5927,獨一無二,6,,11,10,21,ㄉㄨˊ ㄧ ㄨˊ ㄦˋ,dú yī wú èr
5928,賭注,6,,6,2,8,ㄉㄨˇ ㄓㄨˋ,dǔ zhù
5929,斷定,6,,9,4,13,ㄉㄨㄢˋ ㄉㄧㄥˋ,duàn dìng
5930,斷斷續續,6,,6,2,8,ㄉㄨㄢˋ ㄉㄨㄢˋ ㄒㄩˋ ㄒㄩˋ,duàn duàn xù xù
5931,斷絕,6,,11,2,13,ㄉㄨㄢˋ ㄐㄩㄝˊ,duàn jué
5932,鍛鍊,6,,16,11,27,ㄉㄨㄢˋ ㄌㄧㄢˋ,duàn liàn
5933,斷裂,6,,8,10,18,ㄉㄨㄢˋ ㄌㄧㄝˋ,duàn liè
5934,短缺,6,,6,13,19,ㄉㄨㄢˇ ㄑㄩㄝ,duǎn quē
5935,斷然,6,,8,2,10,ㄉㄨㄢˋ ㄖㄢˊ,duàn rán
5936,短線,6,,1,0,1,ㄉㄨㄢˇ ㄒㄧㄢˋ,duǎn xiàn
5937,對岸,6,,10,7,17,ㄉㄨㄟˋ ㄢˋ,duì àn
5938,對白,6,,8,1,9,ㄉㄨㄟˋ ㄅㄞˊ,duì bái
5939,對策,6,,13,7,20,ㄉㄨㄟˋ ㄘㄜˋ,duì cè
5940,對稱,6,,14,6,20,ㄉㄨㄟˋ ㄔㄥˋ,duì chèng
5941,堆積,6,,8,22,30,ㄉㄨㄟ ㄐㄧ,duī jī
5942,堆積如山,6,,5,2,7,ㄉㄨㄟ ㄐㄧ ㄖㄨˊ ㄕㄢ,duī jī rú shān
5943,對決,6,,4,1,5,ㄉㄨㄟˋ ㄐㄩㄝˊ,duì jué
5944,對應,6,,24,7,31,ㄉㄨㄟˋ ㄧㄥˋ,duì yìng
5945,對照,6,,15,13,28,ㄉㄨㄟˋ ㄓㄠˋ,duì zhào
5946,對峙,6,,9,12,21,ㄉㄨㄟˋ ㄓˋ,duì zhì
5947,對準,6,,11,4,15,ㄉㄨㄟˋ ㄓㄨㄣˇ,duì zhǔn
5948,噸,6,,23,59,82,ㄉㄨㄣˋ,dùn
5949,燉,6,,9,6,15,ㄉㄨㄣˋ,dùn
5950,頓時,6,,36,6,42,ㄉㄨㄣˋ ㄕˊ,dùn shí
5951,躲避,6,,11,6,17,ㄉㄨㄛˇ ㄅㄧˋ,duǒ bì
5952,多采多姿,6,,4,2,6,ㄉㄨㄛ ㄘㄞˇ ㄉㄨㄛ ㄗ,duō cǎi duō zī
5953,躲藏,6,,7,2,9,ㄉㄨㄛˇ ㄘㄤˊ,duǒ cáng
5954,多重,6,,14,8,22,ㄉㄨㄛ ㄔㄨㄥˊ,duō chóng
5955,多方,6,,7,4,11,ㄉㄨㄛ ㄈㄤ,duō fāng
5956,多寡,6,,8,4,12,ㄉㄨㄛ ㄍㄨㄚˇ,duō guǎ
5957,多加,6,,8,6,14,ㄉㄨㄛ ㄐㄧㄚ,duō jiā
5958,奪魁,6,,1,0,1,ㄉㄨㄛˊ ㄎㄨㄟˊ,duó kuí
5959,多虧,6,,6,3,9,ㄉㄨㄛ ㄎㄨㄟ,duō kuī
5960,墮落,6,,12,1,13,ㄉㄨㄛˋ ㄌㄨㄛˋ,duò luò
5961,多情,6,,13,0,13,ㄉㄨㄛ ㄑㄧㄥˊ,duō qíng
5962,奪取,6,,14,2,16,ㄉㄨㄛˊ ㄑㄩˇ,duó qǔ
5963,呃,6,,16,2,18,ㄜˋ,è
5964,額度,6,,2,2,4,ㄜˊ ㄉㄨˋ,é dù
5965,惡毒,6,,7,1,8,ㄜˋ ㄉㄨˊ,è dú
5966,惡魔,6,,11,3,14,ㄜˋ ㄇㄛˊ,è mó
5967,惡習,6,,6,6,12,ㄜˋ ㄒㄧˊ,è xí
5968,惡意,6,,12,3,15,ㄜˋ ㄧˋ,è yì
5969,惡作劇,6,,7,2,9,ㄜˋ ㄗㄨㄛˋ ㄐㄩˋ,è zuò jù
5970,恩愛,6,,6,3,9,ㄣ ㄞˋ,ēn ài
5971,耳光,6,,6,1,7,ㄦˇ ㄍㄨㄤ,ěr guāng
5972,耳目,6,,5,0,5,ㄦˇ ㄇㄨˋ,ěr mù
5973,兒女,6,,37,11,48,ㄦˊ ㄋㄩˇ,ér nǚ
5974,二氧化碳,6,,7,101,108,ㄦˋ ㄧㄤˇ ㄏㄨㄚˋ ㄊㄢˋ,èr yǎng huà tàn
5975,法案,6,,9,14,23,ㄈㄚˇ ㄢˋ,fǎ àn
5976,法寶,6,,5,4,9,ㄈㄚˇ ㄅㄠˇ,fǎ bǎo
5977,發病,6,,9,14,23,ㄈㄚ ㄅㄧㄥˋ,fā bìng
5978,發布/發佈,6,,12,19,31,ㄈㄚ ㄅㄨˋ,fā bù
5979,發愁,6,,6,1,7,ㄈㄚ ㄔㄡˊ,fā chóu
5980,發放,6,,5,46,51,ㄈㄚ ㄈㄤˋ,fā fàng
5981,發光,6,,11,18,29,ㄈㄚ ㄍㄨㄤ,fā guāng
5982,法規,6,,8,13,21,ㄈㄚˇ ㄍㄨㄟ,fǎ guī
5983,發火,6,,5,3,8,ㄈㄚ ㄏㄨㄛˇ,fā huǒ
5984,發掘,6,,17,10,27,ㄈㄚ ㄐㄩㄝˊ,fā jué
5985,發狂,6,,6,1,7,ㄈㄚ ㄎㄨㄤˊ,fā kuáng
5986,發亮,6,,15,9,24,ㄈㄚ ㄌㄧㄤˋ,fā liàng
5987,法令,6,,14,11,25,ㄈㄚˇ ㄌㄧㄥˋ,fǎ lìng
5988,發霉,6,,3,6,9,ㄈㄚ ㄇㄟˊ,fā méi
5989,發怒,6,,7,1,8,ㄈㄚ ㄋㄨˋ,fā nù
5990,法人,6,,8,2,10,ㄈㄚˇ ㄖㄣˊ,fǎ rén
5991,發射,6,,15,15,30,ㄈㄚ ㄕㄜˋ,fā shè
5992,發聲,6,,7,5,12,ㄈㄚ ㄕㄥ,fā shēng
5993,法師,6,,14,151,165,ㄈㄚˇ ㄕ,fǎ shī
5994,乏味,6,,11,2,13,ㄈㄚˊ ㄨㄟˋ,fá wèi
5995,發酵,6,,7,52,59,ㄈㄚ ㄒㄧㄠˋ,fā xiào
5996,發洩,6,,13,5,18,ㄈㄚ ㄒㄧㄝˋ,fā xiè
5997,發芽,6,,6,22,28,ㄈㄚ ㄧㄚˊ,fā yá
5998,法則,6,,36,8,44,ㄈㄚˇ ㄗㄜˊ,fǎ zé
5999,法治,6,,8,4,12,ㄈㄚˇ ㄓˋ,fǎ zhì
6000,發作,6,,26,6,32,ㄈㄚ ㄗㄨㄛˋ,fā zuò
6001,泛,6,,11,3,14,ㄈㄢˋ,fàn
6002,反常,6,,4,1,5,ㄈㄢˇ ㄔㄤˊ,fǎn cháng
6003,範疇,6,,16,3,19,ㄈㄢˋ ㄔㄡˊ,fàn chóu
6004,帆船,6,,6,3,9,ㄈㄢˊ ㄔㄨㄢˊ,fán chuán
6005,反倒,6,,19,10,29,ㄈㄢˇ ㄉㄠˋ,fǎn dào
6006,繁複,6,,7,5,12,ㄈㄢˊ ㄈㄨˋ,fán fù
6007,反覆,6,,40,14,54,ㄈㄢˇ ㄈㄨˋ,fǎn fù
6008,反感,6,,12,3,15,ㄈㄢˇ ㄍㄢˇ,fǎn gǎn
6009,反觀,6,,7,4,11,ㄈㄢˇ ㄍㄨㄢ,fǎn guān
6010,返國,6,,4,3,7,ㄈㄢˇ ㄍㄨㄛˊ,fǎn guó
6011,繁華,6,,8,15,23,ㄈㄢˊ ㄏㄨㄚˊ,fán huá
6012,反擊,6,,13,6,19,ㄈㄢˇ ㄐㄧˊ,fǎn jí
6013,氾濫,6,,7,12,19,ㄈㄢˋ ㄌㄢˋ,fàn làn
6014,範例,6,,10,3,13,ㄈㄢˋ ㄌㄧˋ,fàn lì
6015,繁忙,6,,8,10,18,ㄈㄢˊ ㄇㄤˊ,fán máng
6016,反叛,6,,8,1,9,ㄈㄢˇ ㄆㄢˋ,fǎn pàn
6017,犯人,6,,13,1,14,ㄈㄢˋ ㄖㄣˊ,fàn rén
6018,反射,6,,15,10,25,ㄈㄢˇ ㄕㄜˋ,fǎn shè
6019,翻身,6,,12,5,17,ㄈㄢ ㄕㄣ,fān shēn
6020,凡是/凡,6,,63,14,77,ㄈㄢˊ ㄕˋ/ㄈㄢˊ,fán shì/fán
6021,販售,6,,8,12,20,ㄈㄢˋ ㄕㄡˋ,fàn shòu
6022,反思,6,,17,6,23,ㄈㄢˇ ㄙ,fǎn sī
6023,反彈,6,,7,8,15,ㄈㄢˇ ㄊㄢˊ,fǎn tán
6024,反問,6,,10,1,11,ㄈㄢˇ ㄨㄣˋ,fǎn wèn
6025,煩心,6,,4,1,5,ㄈㄢˊ ㄒㄧㄣ,fán xīn
6026,翻閱,6,,11,4,15,ㄈㄢ ㄩㄝˋ,fān yuè
6027,煩躁,6,,10,3,13,ㄈㄢˊ ㄗㄠˋ,fán zào
6028,繁殖,6,,10,41,51,ㄈㄢˊ ㄓˊ,fán zhí
6029,妨礙,6,,13,4,17,ㄈㄤˊ ㄞˋ,fáng ài
6030,方案,6,,51,31,82,ㄈㄤ ㄢˋ,fāng àn
6031,防備,6,,10,1,11,ㄈㄤˊ ㄅㄟˋ,fáng bèi
6032,方才,6,,15,1,16,ㄈㄤ ㄘㄞˊ,fāng cái
6033,放大,6,,13,21,34,ㄈㄤˋ ㄉㄚˋ,fàng dà
6034,房地產,6,,12,3,15,ㄈㄤˊ ㄉㄧˋ ㄔㄢˇ,fáng dì chǎn
6035,防範,6,,12,16,28,ㄈㄤˊ ㄈㄢˋ,fáng fàn
6036,彷彿,6,,141,34,175,ㄈㄤˇ ㄈㄨˊ,fǎng fú
6037,放過,6,,14,6,20,ㄈㄤˋ ㄍㄨㄛˋ,fàng guò
6038,防護,6,,6,17,23,ㄈㄤˊ ㄏㄨˋ,fáng hù
6039,放火,6,,8,3,11,ㄈㄤˋ ㄏㄨㄛˇ,fàng huǒ
6040,坊間,6,,7,5,12,ㄈㄤ ㄐㄧㄢ,fāng jiān
6041,放寬,6,,4,5,9,ㄈㄤˋ ㄎㄨㄢ,fàng kuān
6042,放任,6,,7,6,13,ㄈㄤˋ ㄖㄣˋ,fàng rèn
6043,放聲大哭,6,,0,0,0,ㄈㄤˋ ㄕㄥ ㄉㄚˋ ㄎㄨ,fàng shēng dà kū
6044,防衛,6,,19,5,24,ㄈㄤˊ ㄨㄟˋ,fáng wèi
6045,方位,6,,9,4,13,ㄈㄤ ㄨㄟˋ,fāng wèi
6046,芳香,6,,7,4,11,ㄈㄤ ㄒㄧㄤ,fāng xiāng
6047,放眼,6,,7,12,19,ㄈㄤˋ ㄧㄢˇ,fàng yǎn
6048,防禦,6,,16,9,25,ㄈㄤˊ ㄩˋ,fáng yù
6049,方針,6,,12,3,15,ㄈㄤ ㄓㄣ,fāng zhēn
6050,放置,6,,12,7,19,ㄈㄤˋ ㄓˋ,fàng zhì
6051,紡織,6,,8,7,15,ㄈㄤˇ ㄓ,fǎng zhī
6052,放縱,6,,8,2,10,ㄈㄤˋ ㄗㄨㄥˋ,fàng zòng
6053,飛奔,6,,8,2,10,ㄈㄟ ㄅㄣ,fēi bēn
6054,廢除,6,,11,12,23,ㄈㄟˋ ㄔㄨˊ,fèi chú
6055,飛彈,6,,7,30,37,ㄈㄟ ㄉㄢˋ,fēi dàn
6056,非凡,6,,14,4,18,ㄈㄟ ㄈㄢˊ,fēi fán
6057,廢棄,6,,7,34,41,ㄈㄟˋ ㄑㄧˋ,fèi qì
6058,沸騰,6,,10,4,14,ㄈㄟˋ ㄊㄥˊ,fèi téng
6059,飛舞,6,,8,4,12,ㄈㄟ ㄨˇ,fēi wǔ
6060,飛翔,6,,10,4,14,ㄈㄟ ㄒㄧㄤˊ,fēi xiáng
6061,費心,6,,5,3,8,ㄈㄟˋ ㄒㄧㄣ,fèi xīn
6062,廢墟,6,,7,11,18,ㄈㄟˋ ㄒㄩ,fèi xū
6063,飛揚,6,,7,3,10,ㄈㄟ ㄧㄤˊ,fēi yáng
6064,糞,6,,11,6,17,ㄈㄣˋ,fèn
6065,分布/分佈,6,,20,46,66,ㄈㄣ ㄅㄨˋ,fēn bù
6066,分擔,6,,9,16,25,ㄈㄣ ㄉㄢ,fēn dān
6067,奮鬥,6,,26,19,45,ㄈㄣˋ ㄉㄡˋ,fèn dòu
6068,分割,6,,9,5,14,ㄈㄣ ㄍㄜ,fēn gē
6069,分工,6,,11,9,20,ㄈㄣ ㄍㄨㄥ,fēn gōng
6070,奮力,6,,13,5,18,ㄈㄣˋ ㄌㄧˋ,fèn lì
6071,分泌,6,,18,13,31,ㄈㄣ ㄇㄧˋ,fēn mì
6072,分明,6,,17,5,22,ㄈㄣ ㄇㄧㄥˊ,fēn míng
6073,墳墓/墓/墳,6,,53,20,73,ㄈㄣˊ ㄇㄨˋ / ㄇㄨˋ / ㄈㄣˊ,fén mù/mù/fén
6074,分派,6,,5,1,6,ㄈㄣ ㄆㄞˋ,fēn pài
6075,分歧,6,,16,7,23,ㄈㄣ ㄑㄧˊ,fēn qí
6076,焚燒/焚,6,,10,11,21,ㄈㄣˊ ㄕㄠ/ ㄈㄣˊ,fén shāo / fén
6077,粉碎,6,,9,2,11,ㄈㄣˇ ㄙㄨㄟˋ,fěn suì
6078,分頭,6,,4,2,6,ㄈㄣ ㄊㄡˊ,fēn tóu
6079,氛圍,6,,17,22,39,ㄈㄣ ㄨㄟˊ,fēn wéi
6080,分校,6,,9,3,12,ㄈㄣ ㄒㄧㄠˋ,fēn xiào
6081,分心,6,,16,1,17,ㄈㄣ ㄒㄧㄣ,fēn xīn
6082,奮戰,6,,9,6,15,ㄈㄣˋ ㄓㄢˋ,fèn zhàn
6083,紛爭,6,,8,6,14,ㄈㄣ ㄓㄥ,fēn zhēng
6084,分子,6,,64,70,134,ㄈㄣ ㄗˇ / ㄈㄣˋ ㄗˇ / ㄈㄣˋ ˙ㄗ,fēn zǐ / fèn zǐ / fèn zi
6085,縫2,6,,17,20,37,ㄈㄥˋ,fèng
6086,鳳,6,,16,10,26,ㄈㄥˋ,fèng
6087,風暴,6,,15,27,42,ㄈㄥ ㄅㄠˋ,fēng bào
6088,風波,6,,7,7,14,ㄈㄥ ㄅㄛ,fēng bō
6089,風潮,6,,10,11,21,ㄈㄥ ㄔㄠˊ,fēng cháo
6090,風度,6,,8,3,11,ㄈㄥ ㄉㄨˋ,fēng dù
6091,風格,6,,57,37,94,ㄈㄥ ㄍㄜˊ,fēng gé
6092,風光,6,,11,15,26,ㄈㄥ ㄍㄨㄤ,fēng guāng
6093,鳳凰,6,,13,3,16,ㄈㄥˋ ㄏㄨㄤˊ,fèng huáng
6094,封建,6,,17,2,19,ㄈㄥ ㄐㄧㄢˋ,fēng jiàn
6095,風浪,6,,4,7,11,ㄈㄥ ㄌㄤˋ,fēng làng
6096,鋒利,6,,5,1,6,ㄈㄥ ㄌㄧˋ,fēng lì
6097,風流,6,,8,0,8,ㄈㄥ ㄌㄧㄡˊ,fēng liú
6098,豐滿,6,,5,1,6,ㄈㄥ ㄇㄢˇ,fēng mǎn
6099,奉命,6,,11,1,12,ㄈㄥˋ ㄇㄧㄥˋ,fèng mìng
6100,風情,6,,7,8,15,ㄈㄥ ㄑㄧㄥˊ,fēng qíng
6101,豐盛,6,,8,7,15,ㄈㄥ ㄕㄥˋ,fēng shèng
6102,風聲,6,,10,2,12,ㄈㄥ ㄕㄥ,fēng shēng
6103,豐收,6,,9,19,28,ㄈㄥ ㄕㄡ,fēng shōu
6104,封鎖,6,,6,9,15,ㄈㄥ ㄙㄨㄛˇ,fēng suǒ
6105,風土,6,,5,3,8,ㄈㄥ ㄊㄨˇ,fēng tǔ
6106,風味,6,,11,15,26,ㄈㄥ ㄨㄟˋ,fēng wèi
6107,縫隙,6,,8,6,14,ㄈㄥˋ ㄒㄧˋ,fèng xì
6108,奉獻,6,,15,24,39,ㄈㄥˋ ㄒㄧㄢˋ,fèng xiàn
6109,風向,6,,4,9,13,ㄈㄥ ㄒㄧㄤˋ,fēng xiàng
6110,奉行,6,,10,4,14,ㄈㄥˋ ㄒㄧㄥˊ,fèng xíng
6111,風行,6,,5,3,8,ㄈㄥ ㄒㄧㄥˊ,fēng xíng
6112,佛家,6,,6,2,8,ㄈㄛˊ ㄐㄧㄚ,fó jiā
6113,佛經,6,,5,9,14,ㄈㄛˊ ㄐㄧㄥ,fó jīng
6114,否決,6,,5,5,10,ㄈㄡˇ ㄐㄩㄝˊ,fǒu jué
6115,赴,6,,42,7,49,ㄈㄨˋ,fù
6116,敷,6,,8,7,15,ㄈㄨ,fū
6117,腐敗,6,,13,5,18,ㄈㄨˇ ㄅㄞˋ,fǔ bài
6118,扶持,6,,9,11,20,ㄈㄨˊ ㄔˊ,fú chí
6119,復仇,6,,15,1,16,ㄈㄨˋ ㄔㄡˊ,fù chóu
6120,附帶,6,,9,3,12,ㄈㄨˋ ㄉㄞˋ,fù dài
6121,幅度,6,,8,9,17,ㄈㄨˊ ㄉㄨˋ,fú dù
6122,覆蓋,6,,14,27,41,ㄈㄨˋ ㄍㄞˋ,fù gài
6123,富貴,6,,14,5,19,ㄈㄨˋ ㄍㄨㄟˋ,fù guì
6124,富豪,6,,15,5,20,ㄈㄨˋ ㄏㄠˊ,fù háo
6125,負荷,6,,12,11,23,ㄈㄨˋ ㄏㄜˋ,fù hè
6126,附和,6,,9,1,10,ㄈㄨˋ ㄏㄜˋ,fù hè
6127,腐化,6,,5,3,8,ㄈㄨˇ ㄏㄨㄚˋ,fǔ huà
6128,復活,6,,9,3,12,ㄈㄨˋ ㄏㄨㄛˊ,fù huó
6129,附加,6,,11,8,19,ㄈㄨˋ ㄐㄧㄚ,fù jiā
6130,腐爛,6,,6,4,10,ㄈㄨˇ ㄌㄢˋ,fǔ làn
6131,福利,6,,14,24,38,ㄈㄨˊ ㄌㄧˋ,fú lì
6132,俘虜,6,,10,2,12,ㄈㄨˊ ㄌㄨˇ,fú lǔ
6133,附錄,6,,12,1,13,ㄈㄨˋ ㄌㄨˋ,fù lù
6134,撫摸,6,,14,3,17,ㄈㄨˇ ㄇㄛ,fǔ mō
6135,服氣,6,,7,3,10,ㄈㄨˊ ㄑㄧˋ,fú qì
6136,膚淺,6,,8,1,9,ㄈㄨ ㄑㄧㄢˇ,fū qiǎn
6137,富強,6,,3,1,4,ㄈㄨˋ ㄑㄧㄤˊ,fù qiáng
6138,服侍,6,,9,3,12,ㄈㄨˊ ㄕˋ,fú shì
6139,服飾,6,,11,10,21,ㄈㄨˊ ㄕˋ,fú shì
6140,附屬,6,,5,2,7,ㄈㄨˋ ㄕㄨˇ,fù shǔ
6141,復甦,6,,5,11,16,ㄈㄨˋ ㄙㄨ,fù sū
6142,斧頭/斧,6,,20,2,22,ㄈㄨˇ ˙ㄊㄡ/ㄈㄨˇ,fǔ tou/fǔ
6143,撫慰,6,,9,6,15,ㄈㄨˇ ㄨㄟˋ,fǔ wèi
6144,富翁,6,,8,1,9,ㄈㄨˋ ㄨㄥ,fù wēng
6145,浮現,6,,26,6,32,ㄈㄨˊ ㄒㄧㄢˋ,fú xiàn
6146,復興,6,,11,8,19,ㄈㄨˋ ㄒㄧㄥ,fù xīng
6147,敷衍,6,,6,2,8,ㄈㄨ ㄧㄢˇ,fū yǎn
6148,撫養,6,,11,5,16,ㄈㄨˇ ㄧㄤˇ,fǔ yǎng
6149,服藥,6,,13,4,17,ㄈㄨˊ ㄧㄠˋ,fú yào
6150,福音,6,,10,5,15,ㄈㄨˊ ㄧㄣ,fú yīn
6151,服用,6,,33,4,37,ㄈㄨˊ ㄩㄥˋ,fú yòng
6152,賦予,6,,25,11,36,ㄈㄨˋ ㄩˇ,fù yǔ
6153,負債,6,,8,9,17,ㄈㄨˋ ㄓㄞˋ,fù zhài
6154,輔助,6,,14,12,26,ㄈㄨˇ ㄓㄨˋ,fǔ zhù
6155,附著,6,,5,4,9,ㄈㄨˋ ㄓㄨㄛˊ,fù zhuó
6156,富足,6,,5,9,14,ㄈㄨˋ ㄗㄨˊ,fù zú
6157,輔佐,6,,8,1,9,ㄈㄨˇ ㄗㄨㄛˇ,fǔ zuǒ
6158,副作用,6,,16,6,22,ㄈㄨˋ ㄗㄨㄛˋ ㄩㄥˋ,fù zuò yòng
6159,改觀,6,,5,3,8,ㄍㄞˇ ㄍㄨㄢ,gǎi guān
6160,改行,6,,3,2,5,ㄍㄞˇ ㄏㄤˊ,gǎi háng
6161,改良,6,,15,25,40,ㄍㄞˇ ㄌㄧㄤˊ,gǎi liáng
6162,概念,6,,150,135,285,ㄍㄞˋ ㄋㄧㄢˋ,gài niàn
6163,該死,6,,15,0,15,ㄍㄞ ㄙˇ,gāi sǐ
6164,改寫,6,,9,3,12,ㄍㄞˇ ㄒㄧㄝˇ,gǎi xiě
6165,改正,6,,11,3,14,ㄍㄞˇ ㄓㄥˋ,gǎi zhèng
6166,改組,6,,5,1,6,ㄍㄞˇ ㄗㄨˇ,gǎi zǔ
6167,桿,6,,13,8,21,ㄍㄢˇ,gǎn
6168,甘,6,,7,13,20,ㄍㄢ,gān
6169,乾旱,6,,5,87,92,ㄍㄢ ㄏㄢˋ,gān hàn
6170,幹活,6,,11,4,15,ㄍㄢˋ ㄏㄨㄛˊ,gàn huó
6171,感慨,6,,15,5,20,ㄍㄢˇ ㄎㄞˇ,gǎn kǎi
6172,乾糧,6,,5,3,8,ㄍㄢ ㄌㄧㄤˊ,gān liáng
6173,趕路,6,,8,3,11,ㄍㄢˇ ㄌㄨˋ,gǎn lù
6174,感傷,6,,7,4,11,ㄍㄢˇ ㄕㄤ,gǎn shāng
6175,干涉,6,,14,13,27,ㄍㄢ ㄕㄜˋ,gān shè
6176,感嘆/感歎,6,,16,6,22,ㄍㄢˇ ㄊㄢˋ,gǎn tàn
6177,甘心,6,,12,5,17,ㄍㄢ ㄒㄧㄣ,gān xīn
6178,感性,6,,11,9,20,ㄍㄢˇ ㄒㄧㄥˋ,gǎn xìng
6179,感應,6,,8,9,17,ㄍㄢˇ ㄧㄥˋ,gǎn yìng
6180,干預,6,,12,9,21,ㄍㄢ ㄩˋ,gān yù
6181,甘願,6,,5,12,17,ㄍㄢ ㄩㄢˋ,gān yuàn
6182,乾燥,6,,16,41,57,ㄍㄢ ㄗㄠˋ,gān zào
6183,感知,6,,12,2,14,ㄍㄢˇ ㄓ,gǎn zhī
6184,缸,6,,10,5,15,ㄍㄤ,gāng
6185,鋼,6,,13,10,23,ㄍㄤ,gāng
6186,崗位,6,,7,9,16,ㄍㄤˇ ㄨㄟˋ,gǎng wèi
6187,高昂,6,,8,5,13,ㄍㄠ ㄤˊ,gāo áng
6188,高潮,6,,13,2,15,ㄍㄠ ㄔㄠˊ,gāo cháo
6189,高超,6,,7,1,8,ㄍㄠ ㄔㄠ,gāo chāo
6190,告辭,6,,9,1,10,ㄍㄠˋ ㄘˊ,gào cí
6191,高低,6,,16,7,23,ㄍㄠ ㄉㄧ,gāo dī
6192,高峰,6,,12,13,25,ㄍㄠ ㄈㄥ,gāo fēng
6193,告誡,6,,13,1,14,ㄍㄠˋ ㄐㄧㄝˋ,gào jiè
6194,高齡,6,,10,13,23,ㄍㄠ ㄌㄧㄥˊ,gāo líng
6195,高尚,6,,12,3,15,ㄍㄠ ㄕㄤˋ,gāo shàng
6196,高聳,6,,7,7,14,ㄍㄠ ㄙㄨㄥˇ,gāo sǒng
6197,告訴2,6,,546,363,909,ㄍㄠˋ ㄙㄨˋ,gào sù
6198,高下,6,,5,0,5,ㄍㄠ ㄒㄧㄚˋ,gāo xià
6199,高雅,6,,6,3,9,ㄍㄠ ㄧㄚˇ,gāo yǎ
6200,告一段落,6,,5,4,9,ㄍㄠˋ ㄧˊ ㄉㄨㄢˋ ㄌㄨㄛˋ,gào yí duàn luò
6201,高原,6,,9,25,34,ㄍㄠ ㄩㄢˊ,gāo yuán
6202,告狀,6,,7,2,9,ㄍㄠˋ ㄓㄨㄤˋ,gào zhuàng
6203,稿子/稿,6,,26,16,42,ㄍㄠˇ ˙ㄗ/ㄍㄠˇ,gǎo zi/gǎo
6204,擱,6,,17,2,19,ㄍㄜ,gē
6205,個案,6,,58,29,87,ㄍㄜˋ ㄢˋ,gè àn
6206,隔閡,6,,6,7,13,ㄍㄜˊ ㄏㄜˊ,gé hé
6207,格局,6,,11,5,16,ㄍㄜˊ ㄐㄩˊ,gé jú
6208,歌劇,6,,11,2,13,ㄍㄜ ㄐㄩˋ,gē jù
6209,隔絕,6,,8,7,15,ㄍㄜˊ ㄐㄩㄝˊ,gé jué
6210,隔離,6,,15,20,35,ㄍㄜˊ ㄌㄧˊ,gé lí
6211,閣樓,6,,7,2,9,ㄍㄜˊ ㄌㄡˊ,gé lóu
6212,隔年,6,,9,13,22,ㄍㄜˊ ㄋㄧㄢˊ,gé nián
6213,格式,6,,4,1,5,ㄍㄜˊ ㄕˋ,gé shì
6214,個體,6,,30,8,38,ㄍㄜˋ ㄊㄧˇ,gè tǐ
6215,革新,6,,11,3,14,ㄍㄜˊ ㄒㄧㄣ,gé xīn
6216,箇中/個中,6,,8,2,10,ㄍㄜˋ ㄓㄨㄥ,gè zhōng
6217,鴿子,6,,10,4,14,ㄍㄜ ˙ㄗ,gē zi
6218,根基,6,,7,3,10,ㄍㄣ ㄐㄧ,gēn jī
6219,跟進,6,,6,5,11,ㄍㄣ ㄐㄧㄣˋ,gēn jìn
6220,跟前,6,,19,1,20,ㄍㄣ ㄑㄧㄢˊ,gēn qián
6221,跟蹤,6,,11,2,13,ㄍㄣ ㄗㄨㄥ,gēn zōng
6222,更新,6,,14,8,22,ㄍㄥ ㄒㄧㄣ,gēng xīn
6223,耕耘,6,,7,28,35,ㄍㄥ ㄩㄣˊ,gēng yún
6224,耕種,6,,9,76,85,ㄍㄥ ㄓㄨㄥˋ,gēng zhòng
6225,耕作,6,,8,71,79,ㄍㄥ ㄗㄨㄛˋ,gēng zuò
6226,公,6,,25,27,52,ㄍㄨㄥ,gōng
6227,弓,6,,23,10,33,ㄍㄨㄥ,gōng
6228,共產,6,,9,4,13,ㄍㄨㄥˋ ㄔㄢˇ,gòng chǎn
6229,功臣,6,,10,5,15,ㄍㄨㄥ ㄔㄣˊ,gōng chén
6230,共存,6,,8,10,18,ㄍㄨㄥˋ ㄘㄨㄣˊ,gòng cún
6231,工地,6,,5,13,18,ㄍㄨㄥ ㄉㄧˋ,gōng dì
6232,工讀,6,,1,1,2,ㄍㄨㄥ ㄉㄨˊ,gōng dú
6233,攻讀,6,,6,2,8,ㄍㄨㄥ ㄉㄨˊ,gōng dú
6234,供奉,6,,9,5,14,ㄍㄨㄥˋ ㄈㄥˋ,gòng fèng
6235,公告,6,,4,4,8,ㄍㄨㄥ ㄍㄠˋ,gōng gào
6236,鞏固,6,,15,8,23,ㄍㄨㄥˇ ㄍㄨˋ,gǒng gù
6237,公關,6,,9,2,11,ㄍㄨㄥ ㄍㄨㄢ,gōng guān
6238,共和,6,,8,4,12,ㄍㄨㄥˋ ㄏㄜˊ,gòng hé
6239,工匠,6,,8,5,13,ㄍㄨㄥ ㄐㄧㄤˋ,gōng jiàng
6240,恭敬,6,,7,6,13,ㄍㄨㄥ ㄐㄧㄥˋ,gōng jìng
6241,功利,6,,9,3,12,ㄍㄨㄥ ㄌㄧˋ,gōng lì
6242,共鳴,6,,14,8,22,ㄍㄨㄥˋ ㄇㄧㄥˊ,gòng míng
6243,功名,6,,8,2,10,ㄍㄨㄥ ㄇㄧㄥˊ,gōng míng
6244,公然,6,,10,4,14,ㄍㄨㄥ ㄖㄢˊ,gōng rán
6245,公認,6,,11,6,17,ㄍㄨㄥ ㄖㄣˋ,gōng rèn
6246,共事,6,,9,0,9,ㄍㄨㄥˋ ㄕˋ,gòng shì
6247,共識,6,,21,30,51,ㄍㄨㄥˋ ㄕˋ,gòng shì
6248,公式,6,,16,2,18,ㄍㄨㄥ ㄕˋ,gōng shì
6249,攻勢,6,,13,4,17,ㄍㄨㄥ ㄕˋ,gōng shì
6250,共通,6,,11,5,16,ㄍㄨㄥˋ ㄊㄨㄥ,gòng tōng
6251,公投,6,,2,27,29,ㄍㄨㄥ ㄊㄡˊ,gōng tóu
6252,恭維,6,,7,0,7,ㄍㄨㄥ ㄨㄟˊ,gōng wéi
6253,公務,6,,6,4,10,ㄍㄨㄥ ㄨˋ,gōng wù
6254,攻陷,6,,9,1,10,ㄍㄨㄥ ㄒㄧㄢˋ,gōng xiàn
6255,共享,6,,12,9,21,ㄍㄨㄥˋ ㄒㄧㄤˇ,gòng xiǎng
6256,公益,6,,10,25,35,ㄍㄨㄥ ㄧˋ,gōng yì
6257,工藝,6,,8,17,25,ㄍㄨㄥ ㄧˋ,gōng yì
6258,公正,6,,13,3,16,ㄍㄨㄥ ㄓㄥˋ,gōng zhèng
6259,公子,6,,19,1,20,ㄍㄨㄥ ㄗˇ,gōng zǐ
6260,勾,6,,7,9,16,ㄍㄡ / ㄍㄡˋ,gōu / gòu
6261,勾結,6,,7,1,8,ㄍㄡ ㄐㄧㄝˊ,gōu jié
6262,構思,6,,9,3,12,ㄍㄡˋ ㄙ,gòu sī
6263,故,6,,97,6,103,ㄍㄨˋ,gù
6264,穀,6,,15,7,22,ㄍㄨˇ,gǔ
6265,股,6,,113,54,167,ㄍㄨˇ,gǔ
6266,谷,6,,15,5,20,ㄍㄨˇ,gǔ
6267,鼓吹,6,,9,3,12,ㄍㄨˇ ㄔㄨㄟ,gǔ chuī
6268,鼓動,6,,6,1,7,ㄍㄨˇ ㄉㄨㄥˋ,gǔ dòng
6269,股東,6,,31,3,34,ㄍㄨˇ ㄉㄨㄥ,gǔ dōng
6270,股份,6,,17,1,18,ㄍㄨˇ ㄈㄣˋ,gǔ fèn
6271,辜負,6,,6,4,10,ㄍㄨ ㄈㄨˋ,gū fù
6272,骨骼,6,,11,28,39,ㄍㄨˇ ㄍㄜˊ,gǔ gé
6273,顧及,6,,7,5,12,ㄍㄨˋ ㄐㄧˊ,gù jí
6274,顧忌,6,,8,2,10,ㄍㄨˋ ㄐㄧˋ,gù jì
6275,滑稽,6,,11,1,12,ㄍㄨˇ ㄐㄧ,gǔ jī
6276,孤立,6,,18,8,26,ㄍㄨ ㄌㄧˋ,gū lì
6277,顧慮,6,,11,5,16,ㄍㄨˋ ㄌㄩˋ,gù lǜ
6278,鼓起,6,,10,4,14,ㄍㄨˇ ㄑㄧˇ,gǔ qǐ
6279,姑且,6,,9,1,10,ㄍㄨ ㄑㄧㄝˇ,gū qiě
6280,固然,6,,38,7,45,ㄍㄨˋ ㄖㄢˊ,gù rán
6281,骨肉,6,,6,2,8,ㄍㄨˇ ㄖㄡˋ,gǔ ròu
6282,估算,6,,8,4,12,ㄍㄨ ㄙㄨㄢˋ,gū suàn
6283,固體,6,,5,4,9,ㄍㄨˋ ㄊㄧˇ,gù tǐ
6284,鼓舞,6,,15,13,28,ㄍㄨˇ ㄨˇ,gǔ wǔ
6285,僱用,6,,6,3,9,ㄍㄨˋ ㄩㄥˋ,gù yòng
6286,雇用,6,,15,7,22,ㄍㄨˋ ㄩㄥˋ,gù yòng
6287,固有,6,,7,3,10,ㄍㄨˋ ㄧㄡˇ,gù yǒu
6288,鼓掌,6,,9,8,17,ㄍㄨˇ ㄓㄤˇ,gǔ zhǎng
6289,固執,6,,14,4,18,ㄍㄨˋ ㄓˊ,gù zhí
6290,雇主/僱主,6,,9,9,18,ㄍㄨˋ ㄓㄨˇ,gù zhǔ
6291,寡,6,,13,5,18,ㄍㄨㄚˇ,guǎ
6292,寡婦,6,,17,3,20,ㄍㄨㄚˇ ㄈㄨˋ,guǎ fù
6293,拐,6,,11,5,16,ㄍㄨㄞˇ,guǎi
6294,乖巧,6,,5,4,9,ㄍㄨㄞ ㄑㄧㄠˇ,guāi qiǎo
6295,怪異,6,,17,2,19,ㄍㄨㄞˋ ㄧˋ,guài yì
6296,拐杖,6,,7,5,12,ㄍㄨㄞˇ ㄓㄤˋ,guǎi zhàng
6297,怪罪,6,,8,1,9,ㄍㄨㄞˋ ㄗㄨㄟˋ,guài zuì
6298,灌,6,,10,27,37,ㄍㄨㄢˋ,guàn
6299,官,6,,72,16,88,ㄍㄨㄢ,guān
6300,關愛,6,,13,9,22,ㄍㄨㄢ ㄞˋ,guān ài
6301,官兵,6,,25,3,28,ㄍㄨㄢ ㄅㄧㄥ,guān bīng
6302,棺材/棺,6,,21,4,25,ㄍㄨㄢ ㄘㄞˊ/ㄍㄨㄢ,guān cái/guān
6303,官場,6,,17,0,17,ㄍㄨㄢ ㄔㄤˇ,guān chǎng
6304,貫徹,6,,8,4,12,ㄍㄨㄢˋ ㄔㄜˋ,guàn chè
6305,官方,6,,24,31,55,ㄍㄨㄢ ㄈㄤ,guān fāng
6306,觀感,6,,5,2,7,ㄍㄨㄢ ㄍㄢˇ,guān gǎn
6307,管家,6,,16,4,20,ㄍㄨㄢˇ ㄐㄧㄚ,guǎn jiā
6308,管教,6,,26,12,38,ㄍㄨㄢˇ ㄐㄧㄠˋ,guǎn jiào
6309,關節,6,,35,19,54,ㄍㄨㄢ ㄐㄧㄝˊ,guān jié
6310,關卡,6,,5,8,13,ㄍㄨㄢ ㄎㄚˇ,guān kǎ
6311,慣例,6,,12,3,15,ㄍㄨㄢˋ ㄌㄧˋ,guàn lì
6312,關連,6,,10,4,14,ㄍㄨㄢ ㄌㄧㄢˊ,guān lián
6313,官僚,6,,20,2,22,ㄍㄨㄢ ㄌㄧㄠˊ,guān liáo
6314,關切,6,,13,10,23,ㄍㄨㄢ ㄑㄧㄝˋ,guān qiè
6315,官司,6,,10,3,13,ㄍㄨㄢ ㄙ,guān sī
6316,關頭,6,,9,5,14,ㄍㄨㄢ ㄊㄡˊ,guān tóu
6317,觀望,6,,7,3,10,ㄍㄨㄢ ㄨㄤˋ,guān wàng
6318,管轄,6,,9,3,12,ㄍㄨㄢˇ ㄒㄧㄚˊ,guǎn xiá
6319,管用,6,,8,0,8,ㄍㄨㄢˇ ㄩㄥˋ,guǎn yòng
6320,關照,6,,7,6,13,ㄍㄨㄢ ㄓㄠˋ,guān zhào
6321,管制,6,,15,21,36,ㄍㄨㄢˇ ㄓˋ,guǎn zhì
6322,官職,6,,12,0,12,ㄍㄨㄢ ㄓˊ,guān zhí
6323,觀,6,,30,24,54,ㄍㄨㄢ/ㄍㄨㄢˋ,guān/guàn
6324,光彩,6,,13,4,17,ㄍㄨㄤ ㄘㄞˇ,guāng cǎi
6325,光顧,6,,5,1,6,ㄍㄨㄤ ㄍㄨˋ,guāng gù
6326,光滑,6,,9,5,14,ㄍㄨㄤ ㄏㄨㄚˊ,guāng huá
6327,光輝,6,,9,7,16,ㄍㄨㄤ ㄏㄨㄟ,guāng huī
6328,廣闊,6,,10,5,15,ㄍㄨㄤˇ ㄎㄨㄛˋ,guǎng kuò
6329,光亮,6,,8,4,12,ㄍㄨㄤ ㄌㄧㄤˋ,guāng liàng
6330,光榮,6,,12,8,20,ㄍㄨㄤ ㄖㄨㄥˊ,guāng róng
6331,廣為,6,,9,5,14,ㄍㄨㄤˇ ㄨㄟˊ,guǎng wéi
6332,廣義,6,,8,3,11,ㄍㄨㄤˇ ㄧˋ,guǎng yì
6333,光陰,6,,7,4,11,ㄍㄨㄤ ㄧㄣ,guāng yīn
6334,歸,6,,58,30,88,ㄍㄨㄟ,guī
6335,貴賓,6,,5,6,11,ㄍㄨㄟˋ ㄅㄧㄣ,guì bīn
6336,軌道,6,,19,18,37,ㄍㄨㄟˇ ㄉㄠˋ,guǐ dào
6337,規範,6,,39,19,58,ㄍㄨㄟ ㄈㄢˋ,guī fàn
6338,規格,6,,10,10,20,ㄍㄨㄟ ㄍㄜˊ,guī gé
6339,歸功,6,,9,4,13,ㄍㄨㄟ ㄍㄨㄥ,guī gōng
6340,規劃/規畫,6,,70,66,136,ㄍㄨㄟ ㄏㄨㄚˋ,guī huà
6341,歸還,6,,8,2,10,ㄍㄨㄟ ㄏㄨㄢˊ,guī huán
6342,詭計,6,,9,0,9,ㄍㄨㄟˇ ㄐㄧˋ,guǐ jì
6343,軌跡,6,,8,5,13,ㄍㄨㄟˇ ㄐㄧ,guǐ jī
6344,歸類,6,,5,4,9,ㄍㄨㄟ ㄌㄟˋ,guī lèi
6345,歸納,6,,12,3,15,ㄍㄨㄟ ㄋㄚˋ,guī nà
6346,詭異,6,,13,1,14,ㄍㄨㄟˇ ㄧˋ,guǐ yì
6347,裹,6,,14,3,17,ㄍㄨㄛˇ,guǒ
6348,過錯,6,,8,4,12,ㄍㄨㄛˋ ㄘㄨㄛˋ,guò cuò
6349,國度,6,,10,16,26,ㄍㄨㄛˊ ㄉㄨˋ,guó dù
6350,過渡,6,,6,13,19,ㄍㄨㄛˋ ㄉㄨˋ,guò dù
6351,果斷,6,,7,2,9,ㄍㄨㄛˇ ㄉㄨㄢˋ,guǒ duàn
6352,國防,6,,8,7,15,ㄍㄨㄛˊ ㄈㄤˊ,guó fáng
6353,過關,6,,5,8,13,ㄍㄨㄛˋ ㄍㄨㄢ,guò guān
6354,過活,6,,7,1,8,ㄍㄨㄛˋ ㄏㄨㄛˊ,guò huó
6355,過濾,6,,8,25,33,ㄍㄨㄛˋ ㄌㄩˋ,guò lǜ
6356,過人,6,,13,4,17,ㄍㄨㄛˋ ㄖㄣˊ,guò rén
6357,國事,6,,8,2,10,ㄍㄨㄛˊ ㄕˋ,guó shì
6358,過時,6,,8,2,10,ㄍㄨㄛˋ ㄕˊ,guò shí
6359,過失,6,,11,2,13,ㄍㄨㄛˋ ㄕ,guò shī
6360,果實,6,,15,40,55,ㄍㄨㄛˇ ㄕˊ,guǒ shí
6361,國土,6,,8,22,30,ㄍㄨㄛˊ ㄊㄨˇ,guó tǔ
6362,過往,6,,14,17,31,ㄍㄨㄛˋ ㄨㄤˇ,guò wǎng
6363,過問,6,,5,1,6,ㄍㄨㄛˋ ㄨㄣˋ,guò wèn
6364,果真,6,,14,2,16,ㄍㄨㄛˇ ㄓㄣ,guǒ zhēn
6365,海拔,6,,8,28,36,ㄏㄞˇ ㄅㄚˊ,hǎi bá
6366,海軍,6,,24,10,34,ㄏㄞˇ ㄐㄩㄣ,hǎi jūn
6367,漢朝,6,,9,7,16,ㄏㄢˋ ㄔㄠˊ,hàn cháo
6368,涵蓋,6,,16,8,24,ㄏㄢˊ ㄍㄞˋ,hán gài
6369,含糊,6,,13,1,14,ㄏㄢˊ ㄏㄨˊ,hán hú
6370,捍衛,6,,8,10,18,ㄏㄢˋ ㄨㄟˋ,hàn wèi
6371,含義/含意,6,,14,6,20,ㄏㄢˊ ㄧˋ,hán yì
6372,航海,6,,6,6,12,ㄏㄤˊ ㄏㄞˇ,háng hǎi
6373,行列,6,,13,30,43,ㄏㄤˊ ㄌㄧㄝˋ,háng liè
6374,行情,6,,12,3,15,ㄏㄤˊ ㄑㄧㄥˊ,háng qíng
6375,航行,6,,11,5,16,ㄏㄤˊ ㄒㄧㄥˊ,háng xíng
6376,號稱,6,,13,12,25,ㄏㄠˋ ㄔㄥ,hào chēng
6377,耗費,6,,11,11,22,ㄏㄠˋ ㄈㄟˋ,hào fèi
6378,好漢,6,,9,1,10,ㄏㄠˇ ㄏㄢˋ,hǎo hàn
6379,豪華,6,,16,8,24,ㄏㄠˊ ㄏㄨㄚˊ,háo huá
6380,豪傑,6,,9,1,10,ㄏㄠˊ ㄐㄧㄝˊ,háo jié
6381,耗盡,6,,7,3,10,ㄏㄠˋ ㄐㄧㄣˋ,hào jìn
6382,好評,6,,6,3,9,ㄏㄠˇ ㄆㄧㄥˊ,hǎo píng
6383,好似,6,,9,1,10,ㄏㄠˇ ㄙˋ,hǎo sì
6384,好惡,6,,5,0,5,ㄏㄠˋ ㄨˋ,hào wù
6385,好意思,6,,9,13,22,ㄏㄠˇ ㄧˋ ˙ㄙ,hǎo yì si
6386,豪宅,6,,7,5,12,ㄏㄠˊㄓㄞˊ,háo zhái
6387,號召,6,,12,17,29,ㄏㄠˋ ㄓㄠˋ,hào zhào
6388,號子/證券行,6,,2,0,2,ㄏㄠˋ ˙ㄗ / ㄓㄥˋ ㄑㄩㄢˋ ㄏㄤˊ,hào zi/zhèng quàn háng
6389,核,6,,15,30,45,ㄏㄜˊ,hé
6390,荷包,6,,6,5,11,ㄏㄜˊ ㄅㄠ,hé bāo
6391,合併,6,,17,5,22,ㄏㄜˊ ㄅㄧㄥˋ,hé bìng
6392,何嘗,6,,7,1,8,ㄏㄜˊ ㄔㄤˊ,hé cháng
6393,河川,6,,5,59,64,ㄏㄜˊ ㄔㄨㄢ,hé chuān
6394,何等,6,,13,1,14,ㄏㄜˊ ㄉㄥˇ,hé děng
6395,荷爾蒙,6,,17,22,39,ㄏㄜˊ ㄦˇ ㄇㄥˊ,hé ěr méng
6396,合格,6,,7,9,16,ㄏㄜˊ ㄍㄜˊ,hé gé
6397,合乎,6,,13,5,18,ㄏㄜˊ ㄏㄨ,hé hū
6398,呵護,6,,8,17,25,ㄏㄜ ㄏㄨˋ,hē hù
6399,和解,6,,9,10,19,ㄏㄜˊ ㄐㄧㄝˇ,hé jiě
6400,合力,6,,8,5,13,ㄏㄜˊ ㄌㄧˋ,hé lì
6401,和睦,6,,7,3,10,ㄏㄜˊ ㄇㄨˋ,hé mù
6402,和氣,6,,5,7,12,ㄏㄜˊ ㄑㄧˋ,hé qì
6403,合情合理,6,,4,1,5,ㄏㄜˊ ㄑㄧㄥˊ ㄏㄜˊ ㄌㄧˇ,hé qíng hé lǐ
6404,和善,6,,9,2,11,ㄏㄜˊ ㄕㄢˋ,hé shàn
6405,和尚,6,,66,10,76,ㄏㄜˊ ㄕㄤˋ,hé shàng
6406,合算,6,,1,0,1,ㄏㄜˊ ㄙㄨㄢˋ,hé suàn
6407,合同,6,,5,1,6,ㄏㄜˊ ㄊㄨㄥˊ,hé tóng
6408,何謂,6,,7,1,8,ㄏㄜˊ ㄨㄟˋ,hé wèi
6409,何以,6,,22,2,24,ㄏㄜˊ ㄧˇ,hé yǐ
6410,核子,6,,7,26,33,ㄏㄜˊ ㄗˇ,hé zǐ
6411,黑道,6,,4,2,6,ㄏㄟ ㄉㄠˋ,hēi dào
6412,黑名單,6,,2,1,3,ㄏㄟ ㄇㄧㄥˊ ㄉㄢ,hēi míng dān
6413,黑社會,6,,3,1,4,ㄏㄟ ㄕㄜˋ ㄏㄨㄟˋ,hēi shè huì
6414,恨不得,6,,9,1,10,ㄏㄣˋ ㄅㄨˋ ˙ㄉㄜ,hèn bù de
6415,橫2,6,,21,11,32,ㄏㄥˋ,hèng
6416,橫跨,6,,6,6,12,ㄏㄥˊ ㄎㄨㄚˋ,héng kuà
6417,衡量,6,,22,8,30,ㄏㄥˊ ㄌㄧㄤˊ,héng liáng
6418,橫行,6,,8,3,11,ㄏㄥˋ ㄒㄧㄥˊ,héng xíng
6419,橫越,6,,6,4,10,ㄏㄥˊ ㄩㄝˋ,héng yuè
6420,狠狠/狠,6,,28,6,34,ㄏㄣˇ ㄏㄣˇ/ㄏㄣˇ,hěnhěn/ hěn
6421,哄2,6,,11,4,15,ㄏㄨㄥˇ,hǒng
6422,哄1,6,,11,4,15,ㄏㄨㄥ,hōng
6423,轟動,6,,10,3,13,ㄏㄨㄥ ㄉㄨㄥˋ,hōng dòng
6424,洪水,6,,16,54,70,ㄏㄨㄥˊ ㄕㄨㄟˇ,hóng shuǐ
6425,轟炸,6,,8,7,15,ㄏㄨㄥ ㄓㄚˋ,hōng zhà
6426,吼,6,,12,2,14,ㄏㄡˇ,hǒu
6427,後人,6,,22,8,30,ㄏㄡˋ ㄖㄣˊ,hòu rén
6428,後續,6,,16,24,40,ㄏㄡˋ ㄒㄩˋ,hòu xù
6429,後遺症,6,,8,4,12,ㄏㄡˋ ㄧˊ ㄓㄥˋ,hòu yí zhèng
6430,後院,6,,12,4,16,ㄏㄡˋ ㄩㄢˋ,hòu yuàn
6431,互補,6,,7,2,9,ㄏㄨˋ ㄅㄨˇ,hù bǔ
6432,呼喊,6,,9,3,12,ㄏㄨ ㄏㄢˇ,hū hǎn
6433,呼喚,6,,16,6,22,ㄏㄨ ㄏㄨㄢˋ,hū huàn
6434,胡亂,6,,9,1,10,ㄏㄨˊ ㄌㄨㄢˋ,hú luàn
6435,胡鬧,6,,6,1,7,ㄏㄨˊ ㄋㄠˋ,hú nào
6436,胡說八道,6,,7,1,8,ㄏㄨˊ ㄕㄨㄛ ㄅㄚ ㄉㄠˋ,hú shuō bā dào
6437,胡思亂想,6,,6,1,7,ㄏㄨˊ ㄙ ㄌㄨㄢˋ ㄒㄧㄤˇ,hú sī luàn xiǎng
6438,呼嘯,6,,7,1,8,ㄏㄨ ㄒㄧㄠˋ,hū xiào
6439,鬍鬚,6,,9,1,10,ㄏㄨˊ ㄒㄩ,hú xū
6440,呼應,6,,14,8,22,ㄏㄨ ㄧㄥˋ,hū yìng
6441,呼籲,6,,14,51,65,ㄏㄨ ㄩˋ,hū yù
6442,划不來,6,,1,2,3,ㄏㄨㄚˊ ㄅㄨˋ ㄌㄞˊ,huá bù lái
6443,划得來,6,,1,1,2,ㄏㄨㄚˊ ˙ㄉㄜ ㄌㄞˊ,huá de lái
6444,畫分/劃分,6,,8,6,14,ㄏㄨㄚˋ ㄈㄣ ,huà fēn 
6445,化解,6,,15,18,33,ㄏㄨㄚˋ ㄐㄧㄝˇ,huà jiě
6446,華麗,6,,15,8,23,ㄏㄨㄚˊ ㄌㄧˋ,huá lì
6447,滑落,6,,6,2,8,ㄏㄨㄚˊ ㄌㄨㄛˋ,huá luò
6448,化身,6,,11,4,15,ㄏㄨㄚˋ ㄕㄣ,huà shēn
6449,話筒,6,,7,1,8,ㄏㄨㄚˋ ㄊㄨㄥˇ,huà tǒng
6450,花紋,6,,5,5,10,ㄏㄨㄚ ㄨㄣˊ,huā wén
6451,畫像,6,,13,1,14,ㄏㄨㄚˋ ㄒㄧㄤˋ,huà xiàng
6452,花樣,6,,10,5,15,ㄏㄨㄚ ㄧㄤˋ,huā yàng
6453,話語,6,,22,6,28,ㄏㄨㄚˋ ㄩˇ,huà yǔ
6454,畫作,6,,9,20,29,ㄏㄨㄚˋ ㄗㄨㄛˋ,huà zuò
6455,懷裡/懷裏,6,,20,3,23,ㄏㄨㄞˊ ㄌㄧˇ ,huái lǐ  
6456,環,6,,17,23,40,ㄏㄨㄢˊ,huán
6457,環顧,6,,11,1,12,ㄏㄨㄢˊ ㄍㄨˋ,huán gù
6458,緩和,6,,13,12,25,ㄏㄨㄢˇ ㄏㄜˊ,huǎn hé
6459,歡呼,6,,13,4,17,ㄏㄨㄢ ㄏㄨ,huān hū
6460,環節,6,,9,12,21,ㄏㄨㄢˊ ㄐㄧㄝˊ,huán jié
6461,緩解,6,,9,8,17,ㄏㄨㄢˇㄐㄧㄝˇ,huǎn jiě
6462,幻覺,6,,15,3,18,ㄏㄨㄢˋ ㄐㄩㄝˊ,huàn jué
6463,喚起,6,,10,7,17,ㄏㄨㄢˋ ㄑㄧˇ,huàn qǐ
6464,換取,6,,9,9,18,ㄏㄨㄢˋ ㄑㄩˇ,huàn qǔ
6465,環繞,6,,16,9,25,ㄏㄨㄢˊ ㄖㄠˋ,huán rào
6466,歡心,6,,7,2,9,ㄏㄨㄢ ㄒㄧㄣ,huān xīn
6467,喚醒,6,,14,7,21,ㄏㄨㄢˋ ㄒㄧㄥˇ,huàn xǐng
6468,換言之,6,,15,1,16,ㄏㄨㄢˋ ㄧㄢˊ ㄓ,huàn yán zhī
6469,患有,6,,13,10,23,ㄏㄨㄢˋ ㄧㄡˇ,huàn yǒu
6470,晃1,6,,21,7,28,ㄏㄨㄤˋ,huàng
6471,晃2,6,,21,7,28,ㄏㄨㄤˇ,huǎng
6472,慌,6,,11,8,19,ㄏㄨㄤ,huāng
6473,荒廢,6,,5,15,20,ㄏㄨㄤ ㄈㄟˋ,huāng fèi
6474,恍惚,6,,9,0,9,ㄏㄨㄤˇ ㄏㄨ,huǎng hū
6475,荒涼,6,,8,5,13,ㄏㄨㄤ ㄌㄧㄤˊ,huāng liáng
6476,慌亂,6,,8,2,10,ㄏㄨㄤ ㄌㄨㄢˋ,huāng luàn
6477,慌忙,6,,10,0,10,ㄏㄨㄤ ㄇㄤˊ,huāng máng
6478,荒謬,6,,19,2,21,ㄏㄨㄤ ㄇㄧㄡˋ,huāng miù
6479,恍然大悟,6,,11,3,14,ㄏㄨㄤˇ ㄖㄢˊ ㄉㄚˋ ㄨˋ,huǎng rán dà wù
6480,荒唐,6,,13,2,15,ㄏㄨㄤ ㄊㄤˊ,huāng táng
6481,謊言,6,,13,3,16,ㄏㄨㄤˇ ㄧㄢˊ,huǎng yán
6482,荒野,6,,13,6,19,ㄏㄨㄤ ㄧㄝˇ,huāng yě
6483,慌張,6,,8,6,14,ㄏㄨㄤ ㄓㄤ,huāng zhāng
6484,匯,6,,1,2,3,ㄏㄨㄟˋ,huì
6485,回報,6,,24,17,41,ㄏㄨㄟˊ ㄅㄠˋ,huí bào
6486,迴避,6,,11,1,12,ㄏㄨㄟˊ ㄅㄧˋ,huí bì
6487,灰塵,6,,12,13,25,ㄏㄨㄟ ㄔㄣˊ,huī chén
6488,回程,6,,6,3,9,ㄏㄨㄟˊ ㄔㄥˊ,huí chéng
6489,回顧,6,,22,15,37,ㄏㄨㄟˊ ㄍㄨˋ,huí gù
6490,回歸,6,,19,21,40,ㄏㄨㄟˊ ㄍㄨㄟ,huí guī
6491,回合,6,,8,2,10,ㄏㄨㄟˊ ㄏㄜˊ,huí hé
6492,會合,6,,11,2,13,ㄏㄨㄟˋ ㄏㄜˊ,huì hé
6493,輝煌,6,,13,7,20,ㄏㄨㄟ ㄏㄨㄤˊ,huī huáng
6494,回饋,6,,31,36,67,ㄏㄨㄟˊ ㄎㄨㄟˋ,huí kuì
6495,賄賂,6,,8,3,11,ㄏㄨㄟˋ ㄌㄨˋ,huì lù
6496,會面,6,,13,4,17,ㄏㄨㄟˋ ㄇㄧㄢˋ,huì miàn
6497,毀滅,6,,18,7,25,ㄏㄨㄟˇ ㄇㄧㄝˋ,huǐ miè
6498,回首,6,,5,4,9,ㄏㄨㄟˊ ㄕㄡˇ,huí shǒu
6499,會談,6,,12,28,40,ㄏㄨㄟˋ ㄊㄢˊ,huì tán
6500,揮舞,6,,10,3,13,ㄏㄨㄟ ㄨˇ,huī wǔ
6501,灰心,6,,6,4,10,ㄏㄨㄟ ㄒㄧㄣ,huī xīn
6502,回憶錄,6,,10,1,11,ㄏㄨㄟˊ ㄧˋ ㄌㄨˋ,huí yì lù
6503,回音,6,,6,2,8,ㄏㄨㄟˊ ㄧㄣ,huí yīn
6504,繪製,6,,6,7,13,ㄏㄨㄟˋ ㄓˋ,huì zhì
6505,魂,6,,14,2,16,ㄏㄨㄣˊ,hún
6506,昏暗,6,,10,3,13,ㄏㄨㄣ ㄢˋ,hūn àn
6507,混蛋,6,,9,0,9,ㄏㄨㄣˋ ㄉㄢˋ,hùn dàn
6508,渾身,6,,29,2,31,ㄏㄨㄣˊ ㄕㄣ,hún shēn
6509,混淆,6,,14,4,18,ㄏㄨㄣˋ ㄧㄠˊ,hùn yáo
6510,混雜,6,,7,3,10,ㄏㄨㄣˋ ㄗㄚˊ,hùn zá
6511,和2,6,,5437,2135,7572,ㄏㄨㄛˋ,huò
6512,夥,6,,9,2,11,ㄏㄨㄛˇ,huǒ
6513,火把,6,,6,3,9,ㄏㄨㄛˇ ㄅㄚˇ,huǒ bǎ
6514,火爆,6,,5,2,7,ㄏㄨㄛˇ ㄅㄠˋ,huǒ bào
6515,貨幣,6,,13,27,40,ㄏㄨㄛˋ ㄅㄧˋ,huò bì
6516,或多或少,6,,7,2,9,ㄏㄨㄛˋ ㄉㄨㄛ ㄏㄨㄛˋ ㄕㄠˇ,huò duō huò shǎo
6517,活化,6,,28,13,41,ㄏㄨㄛˊ ㄏㄨㄚˋ,huó huà
6518,火花,6,,8,6,14,ㄏㄨㄛˇ ㄏㄨㄚ,huǒ huā
6519,活活,6,,9,4,13,ㄏㄨㄛˊ ㄏㄨㄛˊ,huó huó
6520,火箭,6,,8,6,14,ㄏㄨㄛˇ ㄐㄧㄢˋ,huǒ jiàn
6521,活命,6,,5,1,6,ㄏㄨㄛˊ ㄇㄧㄥˋ,huó mìng
6522,活期,6,,1,0,1,ㄏㄨㄛˊ ㄑㄧˊ,huó qí
6523,火氣,6,,5,2,7,ㄏㄨㄛˇ ㄑㄧˋ,huǒ qì
6524,獲取,6,,10,6,16,ㄏㄨㄛˋ ㄑㄩˇ,huò qǔ
6525,活生生,6,,14,6,20,ㄏㄨㄛˊ ㄕㄥ ㄕㄥ,huó shēng shēng
6526,活性,6,,5,19,24,ㄏㄨㄛˊ ㄒㄧㄥˋ,huó xìng
6527,火焰,6,,12,2,14,ㄏㄨㄛˇ ㄧㄢˋ,huǒ yàn
6528,貨真價實,6,,3,1,4,ㄏㄨㄛˋ ㄓㄣ ㄐㄧㄚˋ ㄕˊ,huò zhēn jià shí
6529,獲准,6,,5,2,7,ㄏㄨㄛˋ ㄓㄨㄣˇ,huò zhǔn
6530,即,6,,343,22,365,ㄐㄧˊ,jí
6531,疾,6,,14,4,18,ㄐㄧˊ,jí
6532,集,6,,35,57,92,ㄐㄧˊ,jí
6533,劑,6,,8,21,29,ㄐㄧˋ,jì
6534,忌,6,,11,4,15,ㄐㄧˋ,jì
6535,暨,6,,13,5,18,ㄐㄧˋ,jì
6536,祭,6,,12,7,19,ㄐㄧˋ,jì
6537,繼,6,,20,11,31,ㄐㄧˋ,jì
6538,際,6,,52,15,67,ㄐㄧˋ,jì
6539,即便,6,,36,23,59,ㄐㄧˊ ㄅㄧㄢˋ,jí biàn
6540,基層,6,,10,6,16,ㄐㄧ ㄘㄥˊ,jī céng
6541,急促,6,,8,1,9,ㄐㄧˊ ㄘㄨˋ,jí cù
6542,激盪,6,,9,4,13,ㄐㄧ ㄉㄤˋ,jī dàng
6543,極點,6,,9,1,10,ㄐㄧˊ ㄉㄧㄢˇ,jí diǎn
6544,既定,6,,9,3,12,ㄐㄧˋ ㄉㄧㄥˋ,jì dìng
6545,極度,6,,25,5,30,ㄐㄧˊ ㄉㄨˋ,jí dù
6546,極端,6,,38,50,88,ㄐㄧˊ ㄉㄨㄢ,jí duān
6547,繼而,6,,7,1,8,ㄐㄧˋ ㄦˊ,jì ér
6548,激發,6,,30,10,40,ㄐㄧ ㄈㄚ,jī fā
6549,繼父,6,,4,1,5,ㄐㄧˋ ㄈㄨˋ,jì fù
6550,肌膚,6,,10,2,12,ㄐㄧ ㄈㄨ,jī fū
6551,機關,6,,30,13,43,ㄐㄧ ㄍㄨㄢ,jī guān
6552,集會,6,,9,6,15,ㄐㄧˊ ㄏㄨㄟˋ,jí huì
6553,忌諱,6,,6,4,10,ㄐㄧˋ ㄏㄨㄟˋ,jì huì
6554,即將,6,,64,61,125,ㄐㄧˊ ㄐㄧㄤ,jí jiāng
6555,計較,6,,10,12,22,ㄐㄧˋ ㄐㄧㄠˋ,jì jiào
6556,集結,6,,12,12,24,ㄐㄧˊ ㄐㄧㄝˊ,jí jié
6557,激進,6,,11,21,32,ㄐㄧ ㄐㄧㄣˋ,jī jìn
6558,寂靜,6,,16,9,25,ㄐㄧˊ ㄐㄧㄥˋ,jí jìng
6559,即刻,6,,12,4,16,ㄐㄧˊ ㄎㄜˋ,jí kè
6560,即可,6,,25,4,29,ㄐㄧˊ ㄎㄜˇ,jí kě
6561,吉利,6,,6,1,7,ㄐㄧˊ ㄌㄧˋ,jí lì
6562,極力,6,,19,6,25,ㄐㄧˊ ㄌㄧˋ,jí lì
6563,激勵,6,,25,10,35,ㄐㄧ ㄌㄧˋ,jī lì
6564,紀律,6,,21,5,26,ㄐㄧˋ ㄌㄩˋ,jì lǜ
6565,機密,6,,10,4,14,ㄐㄧ ㄇㄧˋ,jī mì
6566,計謀,6,,9,1,10,ㄐㄧˋ ㄇㄡˊ,jì móu
6567,繼母,6,,5,0,5,ㄐㄧˋ ㄇㄨˇ,jì mǔ
6568,機能,6,,19,9,28,ㄐㄧ ㄋㄥˊ,jī néng
6569,妓女,6,,14,1,15,ㄐㄧˋ ㄋㄩˇ,jì nǚ
6570,激怒,6,,10,2,12,ㄐㄧ ㄋㄨˋ,jī nù
6571,極其,6,,28,3,31,ㄐㄧˊ ㄑㄧˊ,jí qí
6572,激起,6,,14,4,18,ㄐㄧ ㄑㄧˇ,jī qǐ
6573,急切,6,,10,2,12,ㄐㄧˊ ㄑㄧㄝˋ,jí qiè
6574,激情,6,,14,1,15,ㄐㄧ ㄑㄧㄥˊ,jī qíng
6575,汲取,6,,10,4,14,ㄐㄧˊ ㄑㄩˇ,jí qǔ
6576,集權,6,,11,1,12,ㄐㄧˊ ㄑㄩㄢˊ,jí quán
6577,繼任,6,,10,2,12,ㄐㄧˋ ㄖㄣˋ,jì rèn
6578,即時,6,,16,10,26,ㄐㄧˊ ㄕˊ,jí shí
6579,及時,6,,27,17,44,ㄐㄧˊ ㄕˊ,jí shí
6580,棘手,6,,11,7,18,ㄐㄧˊ ㄕㄡˇ,jí shǒu
6581,記述,6,,8,2,10,ㄐㄧˋ ㄕㄨˋ,jì shù
6582,祭祀,6,,16,8,24,ㄐㄧˋ ㄙˋ,jì sì
6583,急速,6,,11,11,22,ㄐㄧˊ ㄙㄨˋ,jí sù
6584,寄宿,6,,5,2,7,ㄐㄧˋ ㄙㄨˋ,jì sù
6585,寄託,6,,8,7,15,ㄐㄧˋ ㄊㄨㄛ,jì tuō
6586,即位,6,,16,1,17,ㄐㄧˊ ㄨㄟˋ,jí wèi
6587,繼位,6,,17,2,19,ㄐㄧˋ ㄨㄟˋ,jì wèi
6588,極限,6,,18,10,28,ㄐㄧˊ ㄒㄧㄢˋ,jí xiàn
6589,跡象,6,,17,12,29,ㄐㄧ ㄒㄧㄤˋ,jī xiàng
6590,譏笑,6,,5,1,6,ㄐㄧ ㄒㄧㄠˋ,jī xiào
6591,機械,6,,28,23,51,ㄐㄧ ㄒㄧㄝˋ,jī xiè
6592,畸形,6,,5,3,8,ㄐㄧ ㄒㄧㄥˊ,jī xíng
6593,記敘,6,,2,0,2,ㄐㄧˋ ㄒㄩˋ,jì xù
6594,積蓄,6,,7,3,10,ㄐㄧ ㄒㄩˋ,jī xù
6595,技藝,6,,10,10,20,ㄐㄧˋ ㄧˋ,jì yì
6596,記憶體,6,,5,0,5,ㄐㄧˋ ㄧˋ ㄊㄧˇ,jì yì tǐ
6597,集郵,6,,1,0,1,ㄐㄧˊ ㄧㄡˊ,jí yóu
6598,急於,6,,12,2,14,ㄐㄧˊ ㄩˊ,jí yú
6599,給予,6,,67,40,107,ㄐㄧˇ ㄩˇ,jǐ yǔ
6600,基於,6,,43,12,55,ㄐㄧ ㄩˊ,jī yú
6601,機緣,6,,11,12,23,ㄐㄧ ㄩㄢˊ,jī yuán
6602,急躁,6,,8,3,11,ㄐㄧˊ ㄗㄠˋ,jí zào
6603,及早,6,,10,5,15,ㄐㄧˊ ㄗㄠˇ,jí zǎo
6604,極致,6,,9,4,13,ㄐㄧˊ ㄓˋ,jí zhì
6605,機制,6,,55,37,92,ㄐㄧ ㄓˋ,jī zhì
6606,機智,6,,9,2,11,ㄐㄧ ㄓˋ,jī zhì
6607,脊椎,6,,12,13,25,ㄐㄧˇ ㄓㄨㄟ,jǐ zhuī
6608,甲,6,,46,35,81,ㄐㄧㄚˇ,jiǎ
6609,甲板,6,,8,0,8,ㄐㄧㄚˇ ㄅㄢˇ,jiǎ bǎn
6610,家產,6,,9,2,11,ㄐㄧㄚ ㄔㄢˇ,jiā chǎn
6611,假定,6,,15,1,16,ㄐㄧㄚˇ ㄉㄧㄥˋ,jiǎ dìng
6612,加緊,6,,6,8,14,ㄐㄧㄚ ㄐㄧㄣˇ,jiā jǐn
6613,加碼,6,,2,3,5,ㄐㄧㄚ ㄇㄚˇ,jiā mǎ
6614,架設,6,,5,8,13,ㄐㄧㄚˋ ㄕㄜˋ,jià shè
6615,假設,6,,84,34,118,ㄐㄧㄚˇ ㄕㄜˋ,jiǎ shè
6616,加深,6,,11,11,22,ㄐㄧㄚ ㄕㄣ,jiā shēn
6617,家世,6,,5,1,6,ㄐㄧㄚ ㄕˋ,jiā shì
6618,家務,6,,11,8,19,ㄐㄧㄚ ㄨˋ,jiā wù
6619,假象,6,,6,1,7,ㄐㄧㄚˇ ㄒㄧㄤˋ,jiǎ xiàng
6620,假想,6,,5,1,6,ㄐㄧㄚˇ ㄒㄧㄤˇ,jiǎ xiǎng
6621,加以,6,,94,12,106,ㄐㄧㄚ ㄧˇ,jiā yǐ
6622,駕馭,6,,8,2,10,ㄐㄧㄚˋ ㄩˋ,jià yù
6623,夾雜,6,,8,4,12,ㄐㄧㄚˊ ㄗㄚˊ,jiá zá
6624,加重,6,,12,4,16,ㄐㄧㄚ ㄓㄨㄥˋ,jiā zhòng
6625,架子,6,,11,5,16,ㄐㄧㄚˋ ˙ㄗ,jià zi
6626,賤,6,,9,1,10,ㄐㄧㄢˋ,jiàn
6627,間2,6,,400,316,716,ㄐㄧㄢˋ,jiàn
6628,揀,6,,8,1,9,ㄐㄧㄢˇ,jiǎn
6629,兼,6,,61,16,77,ㄐㄧㄢ,jiān
6630,奸,6,,8,1,9,ㄐㄧㄢ,jiān
6631,煎熬,6,,10,8,18,ㄐㄧㄢ ㄠˊ,jiān áo
6632,檢測,6,,9,43,52,ㄐㄧㄢˇ ㄘㄜˋ,jiǎn cè
6633,檢察官,6,,10,1,11,ㄐㄧㄢˇ ㄔㄚˊ ㄍㄨㄢ,jiǎn chá guān
6634,間諜,6,,11,2,13,ㄐㄧㄢˋ ㄉㄧㄝˊ,jiàn dié
6635,鑑定,6,,6,10,16,ㄐㄧㄢˋ ㄉㄧㄥˋ,jiàn dìng
6636,尖端,6,,7,5,12,ㄐㄧㄢ ㄉㄨㄢ,jiān duān
6637,間隔,6,,8,3,11,ㄐㄧㄢˋ ㄍㄜˊ,jiàn gé
6638,建構,6,,49,11,60,ㄐㄧㄢˋ ㄍㄡˋ,jiàn gòu
6639,兼顧,6,,9,12,21,ㄐㄧㄢ ㄍㄨˋ,jiān gù
6640,簡化,6,,15,6,21,ㄐㄧㄢˇ ㄏㄨㄚˋ,jiǎn huà
6641,減緩,6,,8,21,29,ㄐㄧㄢˇ ㄏㄨㄢˇ,jiǎn huǎn
6642,簡潔,6,,8,3,11,ㄐㄧㄢˇ ㄐㄧㄝˊ,jiǎn jié
6643,剪接,6,,7,4,11,ㄐㄧㄢˇ ㄐㄧㄝ,jiǎn jiē
6644,漸進,6,,5,2,7,ㄐㄧㄢˋ ㄐㄧㄣˋ,jiàn jìn
6645,兼具,6,,8,6,14,ㄐㄧㄢ ㄐㄩˋ,jiān jù
6646,監控,6,,10,11,21,ㄐㄧㄢ ㄎㄨㄥˋ,jiān kòng
6647,艱苦,6,,11,13,24,ㄐㄧㄢ ㄎㄨˇ,jiān kǔ
6648,艱困,6,,5,8,13,ㄐㄧㄢ ㄎㄨㄣˋ,jiān kùn
6649,簡陋,6,,7,11,18,ㄐㄧㄢˇ ㄌㄡˋ,jiǎn lòu
6650,兼任,6,,7,1,8,ㄐㄧㄢ ㄖㄣˋ,jiān rèn
6651,尖銳,6,,15,4,19,ㄐㄧㄢ ㄖㄨㄟˋ,jiān ruì
6652,健身房,6,,5,3,8,ㄐㄧㄢˋ ㄕㄣ ㄈㄤˊ,jiàn shēn fáng
6653,檢視,6,,33,14,47,ㄐㄧㄢˇ ㄕˋ,jiǎn shì
6654,堅守,6,,13,5,18,ㄐㄧㄢ ㄕㄡˇ,jiān shǒu
6655,見聞,6,,6,2,8,ㄐㄧㄢˋ ㄨㄣˊ,jiàn wén
6656,堅信,6,,11,5,16,ㄐㄧㄢ ㄒㄧㄣˋ,jiān xìn
6657,艱辛,6,,9,18,27,ㄐㄧㄢ ㄒㄧㄣ,jiān xīn
6658,堅毅,6,,10,7,17,ㄐㄧㄢ ㄧˋ,jiān yì
6659,堅硬,6,,9,9,18,ㄐㄧㄢ ㄧㄥˋ,jiān yìng
6660,監獄,6,,35,30,65,ㄐㄧㄢ ㄩˋ,jiān yù
6661,見證,6,,18,35,53,ㄐㄧㄢˋ ㄓㄥˋ,jiàn zhèng
6662,僵,6,,5,1,6,ㄐㄧㄤ,jiāng
6663,江湖,6,,21,3,24,ㄐㄧㄤ ㄏㄨˊ,jiāng hú
6664,僵局,6,,5,7,12,ㄐㄧㄤ ㄐㄩˊ,jiāng jú
6665,將軍,6,,129,14,143,ㄐㄧㄤ ㄐㄩㄣ,jiāng jūn
6666,講理,6,,7,2,9,ㄐㄧㄤˇ ㄌㄧˇ,jiǎng lǐ
6667,降臨,6,,15,4,19,ㄐㄧㄤˋ ㄌㄧㄣˊ,jiàng lín
6668,將領,6,,33,2,35,ㄐㄧㄤˋ ㄌㄧㄥˇ,jiàng lǐng
6669,講求,6,,10,13,23,ㄐㄧㄤˇ ㄑㄧㄡˊ,jiǎng qiú
6670,江山,6,,12,2,14,ㄐㄧㄤ ㄕㄢ,jiāng shān
6671,獎賞,6,,10,2,12,ㄐㄧㄤˇ ㄕㄤˇ,jiǎng shǎng
6672,講師,6,,7,6,13,ㄐㄧㄤˇ ㄕ,jiǎng shī
6673,講述,6,,15,4,19,ㄐㄧㄤˇ ㄕㄨˋ,jiǎng shù
6674,獎項,6,,5,4,9,ㄐㄧㄤˇ ㄒㄧㄤˋ,jiǎng xiàng
6675,僵硬,6,,20,4,24,ㄐㄧㄤ ㄧㄥˋ,jiāng yìng
6676,講座,6,,9,11,20,ㄐㄧㄤˇ ㄗㄨㄛˋ,jiǎng zuò
6677,絞,6,,5,2,7,ㄐㄧㄠˇ,jiǎo
6678,繳,6,,12,19,31,ㄐㄧㄠˇ,jiǎo
6679,澆,6,,9,28,37,ㄐㄧㄠ,jiāo
6680,焦,6,,11,4,15,ㄐㄧㄠ,jiāo
6681,嚼,6,,13,7,20,ㄐㄧㄠˊ/ ㄐㄩㄝˊ,jiáo / jué
6682,交叉,6,,13,7,20,ㄐㄧㄠ ㄔㄚ,jiāo chā
6683,轎車,6,,12,4,16,ㄐㄧㄠˋ ㄔㄜ,jiào chē
6684,交錯,6,,10,8,18,ㄐㄧㄠ ㄘㄨㄛˋ,jiāo cuò
6685,交付,6,,6,3,9,ㄐㄧㄠ ㄈㄨˋ,jiāo fù
6686,叫喊,6,,8,0,8,ㄐㄧㄠˋ ㄏㄢˇ,jiào hǎn
6687,叫好,6,,7,2,9,ㄐㄧㄠˋ ㄏㄠˇ,jiào hǎo
6688,交互,6,,7,4,11,ㄐㄧㄠ ㄏㄨˋ,jiāo hù
6689,狡猾,6,,10,1,11,ㄐㄧㄠˇ ㄏㄨㄚˊ,jiǎo huá
6690,教誨,6,,9,6,15,ㄐㄧㄠˋ ㄏㄨㄟˋ,jiào huì
6691,交集,6,,7,4,11,ㄐㄧㄠ ㄐㄧˊ,jiāo jí
6692,焦急,6,,12,4,16,ㄐㄧㄠ ㄐㄧˊ,jiāo jí
6693,交際,6,,6,3,9,ㄐㄧㄠ ㄐㄧˋ,jiāo jì
6694,交接,6,,5,6,11,ㄐㄧㄠ ㄐㄧㄝ,jiāo jiē
6695,教科書,6,,15,7,22,ㄐㄧㄠˋ ㄎㄜ ㄕㄨ,jiào kē shū
6696,交情,6,,9,2,11,ㄐㄧㄠ ㄑㄧㄥˊ,jiāo qíng
6697,交涉,6,,10,2,12,ㄐㄧㄠ ㄕㄜˋ,jiāo shè
6698,交替,6,,9,10,19,ㄐㄧㄠ ㄊㄧˋ,jiāo tì
6699,教條,6,,9,2,11,ㄐㄧㄠˋ ㄊㄧㄠˊ,jiào tiáo
6700,嬌小,6,,4,6,10,ㄐㄧㄠ ㄒㄧㄠˇ,jiāo xiǎo
6701,僥倖,6,,7,2,9,ㄐㄧㄠˇ ㄒㄧㄥˋ,jiǎo xìng
6702,教養,6,,36,26,62,ㄐㄧㄠˋ ㄧㄤˇ,jiào yǎng
6703,教義,6,,9,10,19,ㄐㄧㄠˋ ㄧˋ,jiào yì
6704,焦躁,6,,9,1,10,ㄐㄧㄠ ㄗㄠˋ,jiāo zào
6705,交戰,6,,11,7,18,ㄐㄧㄠ ㄓㄢˋ,jiāo zhàn
6706,交織,6,,7,2,9,ㄐㄧㄠ ㄓ,jiāo zhī
6707,轎子/轎,6,,25,3,28,ㄐㄧㄠˋ ˙ㄗ/ㄐㄧㄠˋ,jiào zi/jiào
6708,劫,6,,10,11,21,ㄐㄧㄝˊ,jié
6709,截,6,,18,14,32,ㄐㄧㄝˊ,jié
6710,階,6,,5,9,14,ㄐㄧㄝ,jiē
6711,結巴,6,,3,1,4,ㄐㄧㄝ ˙ㄅㄚ,jiē ba
6712,潔白,6,,7,1,8,ㄐㄧㄝˊ ㄅㄞˊ,jié bái
6713,階層,6,,45,5,50,ㄐㄧㄝ ㄘㄥˊ,jiē céng
6714,界定,6,,16,3,19,ㄐㄧㄝˋ ㄉㄧㄥˋ,jiè dìng
6715,解讀,6,,20,14,34,ㄐㄧㄝˇ ㄉㄨˊ,jiě dú
6716,接二連三,6,,4,4,8,ㄐㄧㄝ ㄦˋ ㄌㄧㄢˊ ㄙㄢ,jiē èr lián sān
6717,揭發,6,,7,2,9,ㄐㄧㄝ ㄈㄚ,jiē fā
6718,解放,6,,22,9,31,ㄐㄧㄝˇ ㄈㄤˋ,jiě fàng
6719,接獲,6,,4,3,7,ㄐㄧㄝ ㄏㄨㄛˋ,jiē huò
6720,藉機,6,,5,3,8,ㄐㄧㄝˋ ㄐㄧ,jiè jī
6721,節儉,6,,7,8,15,ㄐㄧㄝˊ ㄐㄧㄢˇ,jié jiǎn
6722,接見,6,,8,2,10,ㄐㄧㄝ ㄐㄧㄢˋ,jiē jiàn
6723,結交,6,,13,4,17,ㄐㄧㄝˊ ㄐㄧㄠ,jié jiāo
6724,街角,6,,5,1,6,ㄐㄧㄝ ㄐㄧㄠˇ,jiē jiǎo
6725,捷徑,6,,9,4,13,ㄐㄧㄝˊ ㄐㄧㄥˋ,jié jìng
6726,結晶,6,,10,10,20,ㄐㄧㄝˊ ㄐㄧㄥ,jié jīng
6727,解救,6,,7,3,10,ㄐㄧㄝˇ ㄐㄧㄡˋ,jiě jiù
6728,揭開,6,,11,8,19,ㄐㄧㄝ ㄎㄞ,jiē kāi
6729,接連,6,,10,10,20,ㄐㄧㄝ ㄌㄧㄢˊ,jiē lián
6730,揭露,6,,14,5,19,ㄐㄧㄝ ㄌㄨˋ,jiē lù
6731,結盟,6,,10,7,17,ㄐㄧㄝˊ ㄇㄥˊ,jié méng
6732,介面,6,,14,3,17,ㄐㄧㄝˋ ㄇㄧㄢˋ,jiè miàn
6733,揭幕,6,,1,1,2,ㄐㄧㄝ ㄇㄨˋ,jiē mù
6734,接納,6,,34,17,51,ㄐㄧㄝ ㄋㄚˋ,jiē nà
6735,截然不同,6,,15,14,29,ㄐㄧㄝˊ ㄖㄢˊ ㄅㄨˋ ㄊㄨㄥˊ,jié rán bù tóng
6736,接任,6,,8,4,12,ㄐㄧㄝ ㄖㄣˋ,jiē rèn
6737,介入,6,,25,22,47,ㄐㄧㄝˋ ㄖㄨˋ,jiè rù
6738,解散,6,,9,5,14,ㄐㄧㄝˇ ㄙㄢˋ,jiě sàn
6739,結實1,6,,13,7,20,ㄐㄧㄝˊ ㄕˊ,jié shí
6740,結識,6,,8,2,10,ㄐㄧㄝˊ ㄕˋ,jié shì
6741,屆時,6,,9,4,13,ㄐㄧㄝˋ ㄕˊ,jiè shí
6742,結實2,6,,13,7,20,ㄐㄧㄝ ˙ㄕ,jiē shi
6743,接手,6,,11,15,26,ㄐㄧㄝ ㄕㄡˇ,jiē shǒu
6744,解體,6,,7,4,11,ㄐㄧㄝˇ ㄊㄧˇ,jiě tǐ
6745,接替,6,,6,2,8,ㄐㄧㄝ ㄊㄧˋ,jiē tì
6746,階梯,6,,11,7,18,ㄐㄧㄝ ㄊㄧ,jiē tī
6747,解脫,6,,17,6,23,ㄐㄧㄝˇ ㄊㄨㄛ,jiě tuō
6748,解析,6,,11,3,14,ㄐㄧㄝˇ ㄒㄧ,jiě xī
6749,界線,6,,13,6,19,ㄐㄧㄝˋ ㄒㄧㄢˋ,jiè xiàn
6750,界限,6,,12,1,13,ㄐㄧㄝˋ ㄒㄧㄢˋ,jiè xiàn
6751,戒心,6,,5,1,6,ㄐㄧㄝˋ ㄒㄧㄣ,jiè xīn
6752,結業,6,,1,1,2,ㄐㄧㄝˊ ㄧㄝˋ,jié yè
6753,介意,6,,15,4,19,ㄐㄧㄝˋ ㄧˋ,jiè yì
6754,藉由,6,,53,91,144,ㄐㄧㄝˋ ㄧㄡˊ,jiè yóu
6755,節約,6,,4,18,22,ㄐㄧㄝˊ ㄩㄝ,jié yuē
6756,解約,6,,1,1,2,ㄐㄧㄝˇ ㄩㄝ,jiě yuē
6757,結帳,6,,5,3,8,ㄐㄧㄝˊ ㄓㄤˋ,jié zhàng
6758,截至,6,,5,8,13,ㄐㄧㄝˊ ㄓˋ,jié zhì
6759,節制,6,,11,6,17,ㄐㄧㄝˊ ㄓˋ,jié zhì
6760,傑作,6,,9,3,12,ㄐㄧㄝˊ ㄗㄨㄛˋ,jié zuò
6761,藉,6,,51,26,77,ㄐㄧㄝˋ / ㄐㄧˊ,jiè/jí
6762,筋,6,,9,6,15,ㄐㄧㄣ,jīn
6763,緊繃,6,,14,7,21,ㄐㄧㄣˇ ㄅㄥ,jǐn bēng
6764,進程,6,,7,9,16,ㄐㄧㄣˋ ㄔㄥˊ,jìn chéng
6765,近代史,6,,6,4,10,ㄐㄧㄣˋ ㄉㄞˋ ㄕˇ,jìn dài shǐ
6766,金額,6,,14,15,29,ㄐㄧㄣ ㄜˊ,jīn é
6767,進而,6,,40,27,67,ㄐㄧㄣˋㄦˊ,jìn ér
6768,近乎,6,,14,1,15,ㄐㄧㄣˋ ㄏㄨ,jìn hū
6769,進化,6,,8,2,10,ㄐㄧㄣˋ ㄏㄨㄚˋ,jìn huà
6770,晉級,6,,2,1,3,ㄐㄧㄣˋ ㄐㄧˊ,jìn jí
6771,禁忌,6,,12,3,15,ㄐㄧㄣˋ ㄐㄧˋ,jìn jì
6772,津津有味,6,,5,2,7,ㄐㄧㄣ ㄐㄧㄣ ㄧㄡˇ ㄨㄟˋ,jīn jīn yǒu wèi
6773,進軍,6,,10,2,12,ㄐㄧㄣˋ ㄐㄩㄣ,jìn jūn
6774,近況,6,,3,2,5,ㄐㄧㄣˋ ㄎㄨㄤˋ,jìn kuàng
6775,浸泡/浸,6,,13,13,26,ㄐㄧㄣˋ ㄆㄠˋ / ㄐㄧㄣˋ,jìn pào / jìn
6776,緊迫,6,,4,3,7,ㄐㄧㄣˇ ㄆㄛˋ,jǐn pò
6777,盡情,6,,15,8,23,ㄐㄧㄣˋ ㄑㄧㄥˊ,jìn qíng
6778,進食,6,,9,4,13,ㄐㄧㄣˋ ㄕˊ,jìn shí
6779,近似,6,,7,1,8,ㄐㄧㄣˋ ㄙˋ,jìn sì
6780,津貼,6,,4,2,6,ㄐㄧㄣ ㄊㄧㄝ,jīn tiē
6781,盡頭,6,,18,9,27,ㄐㄧㄣˋ ㄊㄡˊ,jìn tóu
6782,盡心,6,,7,7,14,ㄐㄧㄣˋ ㄒㄧㄣ,jìn xīn
6783,進修,6,,10,4,14,ㄐㄧㄣˋ ㄒㄧㄡ,jìn xiū
6784,緊要,6,,5,2,7,ㄐㄧㄣˇ ㄧㄠˋ,jǐn yào
6785,僅有,6,,16,7,23,ㄐㄧㄣˇ ㄧㄡˇ,jǐn yǒu
6786,進駐,6,,8,12,20,ㄐㄧㄣˋ ㄓㄨˋ,jìn zhù
6787,精,6,,20,18,38,ㄐㄧㄥ,jīng
6788,警報,6,,6,15,21,ㄐㄧㄥˇ ㄅㄠˋ,jǐng bào
6789,經典,6,,38,117,155,ㄐㄧㄥ ㄉㄧㄢˇ,jīng diǎn
6790,景觀,6,,18,37,55,ㄐㄧㄥˇ ㄍㄨㄢ,jǐng guān
6791,警官,6,,37,1,38,ㄐㄧㄥˇ ㄍㄨㄢ,jǐng guān
6792,淨化,6,,12,23,35,ㄐㄧㄥˋ ㄏㄨㄚˋ,jìng huà
6793,精華,6,,9,7,16,ㄐㄧㄥ ㄏㄨㄚˊ,jīng huá
6794,驚慌,6,,14,4,18,ㄐㄧㄥ ㄏㄨㄤ,jīng huāng
6795,精簡,6,,5,3,8,ㄐㄧㄥ ㄐㄧㄢˇ,jīng jiǎn
6796,境界,6,,33,23,56,ㄐㄧㄥˋ ㄐㄧㄝˋ,jìng jiè
6797,精進,6,,11,14,25,ㄐㄧㄥ ㄐㄧㄣˋ,jīng jìn
6798,警覺,6,,18,7,25,ㄐㄧㄥˇ ㄐㄩㄝˊ,jǐng jué
6799,驚恐,6,,15,3,18,ㄐㄧㄥ ㄎㄨㄥˇ,jīng kǒng
6800,經理人,6,,33,1,34,ㄐㄧㄥ ㄌㄧˇ ㄖㄣˊ,jīng lǐ rén
6801,精美,6,,9,5,14,ㄐㄧㄥ ㄇㄟˇ,jīng měi
6802,精密,6,,10,9,19,ㄐㄧㄥ ㄇㄧˋ,jīng mì
6803,精明,6,,14,1,15,ㄐㄧㄥ ㄇㄧㄥˊ,jīng míng
6804,靜默,6,,8,3,11,ㄐㄧㄥˋ ㄇㄛˋ,jìng mò
6805,敬佩,6,,10,11,21,ㄐㄧㄥˋ ㄆㄟˋ,jìng pèi
6806,靜悄悄,6,,5,1,6,ㄐㄧㄥˋ ㄑㄧㄠˇ ㄑㄧㄠˇ,jìng qiǎo qiǎo
6807,精髓,6,,7,4,11,ㄐㄧㄥ ㄙㄨㄟˇ,jīng suǐ
6808,靜態,6,,6,4,10,ㄐㄧㄥˋ ㄊㄞˋ,jìng tài
6809,驚嘆/驚歎,6,,10,4,14,ㄐㄧㄥ ㄊㄢˋ,jīng tàn
6810,警惕,6,,8,8,16,ㄐㄧㄥˇ ㄊㄧˋ,jǐng tì
6811,精通,6,,12,3,15,ㄐㄧㄥ ㄊㄨㄥ,jīng tōng
6812,敬畏,6,,10,2,12,ㄐㄧㄥˋ ㄨㄟˋ,jìng wèi
6813,精細,6,,10,6,16,ㄐㄧㄥ ㄒㄧˋ,jīng xì
6814,驚嚇,6,,15,4,19,ㄐㄧㄥ ㄒㄧㄚˋ,jīng xià
6815,驚險,6,,5,4,9,ㄐㄧㄥ ㄒㄧㄢˇ,jīng xiǎn
6816,驚醒,6,,10,1,11,ㄐㄧㄥ ㄒㄧㄥˇ,jīng xǐng
6817,警訊,6,,7,10,17,ㄐㄧㄥˇ ㄒㄩㄣˋ,jǐng xùn
6818,敬意,6,,9,4,13,ㄐㄧㄥˋ ㄧˋ,jìng yì
6819,驚異,6,,8,1,9,ㄐㄧㄥ ㄧˋ,jīng yì
6820,精英,6,,6,3,9,ㄐㄧㄥ ㄧㄥ,jīng yīng
6821,菁英,6,,10,4,14,ㄐㄧㄥ ㄧㄥ,jīng yīng
6822,靜止,6,,10,7,17,ㄐㄧㄥˋ ㄓˇ,jìng zhǐ
6823,精緻,6,,17,21,38,ㄐㄧㄥ ㄓˋ,jīng zhì
6824,敬重,6,,12,4,16,ㄐㄧㄥˋ ㄓㄨㄥˋ,jìng zhòng
6825,精準,6,,14,16,30,ㄐㄧㄥ ㄓㄨㄣˇ,jīng zhǔn
6826,靜坐,6,,13,4,17,ㄐㄧㄥˋ ㄗㄨㄛˋ,jìng zuò
6827,頸/頸子,6,,22,8,30,ㄐㄧㄥˇ / ㄐㄧㄥˇ ˙ㄗ,jǐng/jǐng zi
6828,勁/勁兒,6,,17,8,25,ㄐㄧㄥˋ / ㄐㄧㄥˋㄦ,jìng/jìngr
6829,糾纏,6,,16,4,20,ㄐㄧㄡ ㄔㄢˊ,jiū chán
6830,就地,6,,7,6,13,ㄐㄧㄡˋ ㄉㄧˋ,jiù dì
6831,久而久之,6,,8,7,15,ㄐㄧㄡˇ ㄦˊ ㄐㄧㄡˇ ㄓ,jiǔ ér jiǔ zhī
6832,就近,6,,5,9,14,ㄐㄧㄡˋ ㄐㄧㄣˋ,jiù jìn
6833,酒精,6,,16,15,31,ㄐㄧㄡˇ ㄐㄧㄥ,jiǔ jīng
6834,就任,6,,8,3,11,ㄐㄧㄡˋ ㄖㄣˋ,jiù rèn
6835,救贖,6,,9,1,10,ㄐㄧㄡˋ ㄕㄨˊ,jiù shú
6836,酒席,6,,5,0,5,ㄐㄧㄡˇ ㄒㄧˊ,jiǔ xí
6837,就醫,6,,9,5,14,ㄐㄧㄡˋ ㄧ,jiù yī
6838,救援,6,,13,62,75,ㄐㄧㄡˋ ㄩㄢˊ,jiù yuán
6839,久遠,6,,7,4,11,ㄐㄧㄡˇ ㄩㄢˇ,jiǔ yuǎn
6840,糾正,6,,12,6,18,ㄐㄧㄡ ㄓㄥˋ,jiū zhèng
6841,就職,6,,6,3,9,ㄐㄧㄡˋ ㄓˊ,jiù zhí
6842,俱,6,,21,8,29,ㄐㄩˋ,jù
6843,具,6,,123,52,175,ㄐㄩˋ,jù
6844,局部,6,,13,18,31,ㄐㄩˊ ㄅㄨˋ,jú bù
6845,劇場,6,,16,14,30,ㄐㄩˋ ㄔㄤˊ,jù cháng
6846,據點,6,,12,10,22,ㄐㄩˋ ㄉㄧㄢˇ,jù diǎn
6847,鞠躬,6,,10,4,14,ㄐㄩˊ ㄍㄨㄥ,jú gōng
6848,居家,6,,8,17,25,ㄐㄩ ㄐㄧㄚ,jū jiā
6849,聚焦,6,,11,10,21,ㄐㄩˋ ㄐㄧㄠ,jù jiāo
6850,咀嚼,6,,9,6,15,ㄐㄩˇ ㄐㄩㄝˊ,jǔ jué
6851,局面,6,,28,11,39,ㄐㄩˊ ㄇㄧㄢˋ,jú miàn
6852,懼怕,6,,13,2,15,ㄐㄩˋ ㄆㄚˋ,jù pà
6853,沮喪,6,,55,12,67,ㄐㄩˇ ㄙㄤˋ,jǔ sàng
6854,局勢,6,,16,39,55,ㄐㄩˊ ㄕˋ,jú shì
6855,舉世,6,,5,5,10,ㄐㄩˇ ㄕˋ,jǔ shì
6856,拘束,6,,5,2,7,ㄐㄩ ㄕㄨˋ,jū shù
6857,侷限,6,,9,7,16,ㄐㄩˊ ㄒㄧㄢˋ,jú xiàn
6858,具有,6,,205,92,297,ㄐㄩˋ ㄧㄡˇ,jù yǒu
6859,居於,6,,7,1,8,ㄐㄩ ㄩˊ,jū yú
6860,劇院,6,,13,2,15,ㄐㄩˋ ㄩㄢˋ,jù yuàn
6861,舉止,6,,23,4,27,ㄐㄩˇ ㄓˇ,jǔ zhǐ
6862,舉足輕重,6,,5,7,12,ㄐㄩˇ ㄗㄨˊ ㄑㄧㄥ ㄓㄨㄥˋ,jǔ zú qīng zhòng
6863,捲入,6,,9,4,13,ㄐㄩㄢˇ ㄖㄨˋ,juǎn rù
6864,捐贈,6,,7,25,32,ㄐㄩㄢ ㄗㄥˋ,juān zèng
6865,絕,6,,26,11,37,ㄐㄩㄝˊ,jué
6866,覺察,6,,15,2,17,ㄐㄩㄝˊ ㄔㄚˊ,jué chá
6867,絕非,6,,16,2,18,ㄐㄩㄝˊ ㄈㄟ,jué fēi
6868,絕佳,6,,11,5,16,ㄐㄩㄝˊ ㄐㄧㄚ,jué jiā
6869,倔強,6,,9,3,12,ㄐㄩㄝˊ ㄐㄧㄤˋ,jué jiàng
6870,絕妙,6,,5,1,6,ㄐㄩㄝˊ ㄇㄧㄠˋ,jué miào
6871,崛起,6,,15,12,27,ㄐㄩㄝˊ ㄑㄧˇ,jué qǐ
6872,訣竅,6,,8,7,15,ㄐㄩㄝˊ ㄑㄧㄠˋ,jué qiào
6873,爵士,6,,48,1,49,ㄐㄩㄝˊ ㄕˋ,jué shì
6874,覺悟,6,,9,7,16,ㄐㄩㄝˊ ㄨˋ,jué wù
6875,覺醒,6,,15,31,46,ㄐㄩㄝˊ ㄒㄧㄥˇ,jué xǐng
6876,決議,6,,7,13,20,ㄐㄩㄝˊ ㄧˋ,jué yì
6877,抉擇,6,,18,4,22,ㄐㄩㄝˊ ㄗㄜˊ,jué zé
6878,決戰,6,,8,1,9,ㄐㄩㄝˊ ㄓㄢˋ,jué zhàn
6879,均,6,,84,28,112,ㄐㄩㄣ,jūn
6880,軍官,6,,25,3,28,ㄐㄩㄣ ㄍㄨㄢ,jūn guān
6881,均衡,6,,9,19,28,ㄐㄩㄣ ㄏㄥˊ,jūn héng
6882,軍師,6,,9,1,10,ㄐㄩㄣ ㄕ,jūn shī
6883,均勻,6,,6,21,27,ㄐㄩㄣ ㄩㄣˊ,jūn yún
6884,君主,6,,19,7,26,ㄐㄩㄣ ㄓㄨˇ,jūn zhǔ
6885,君子,6,,24,14,38,ㄐㄩㄣ ㄗˇ,jūn zǐ
6886,開辦,6,,6,6,12,ㄎㄞ ㄅㄢˋ,kāi bàn
6887,開場,6,,6,4,10,ㄎㄞ ㄔㄤˊ,kāi cháng
6888,開端,6,,8,2,10,ㄎㄞ ㄉㄨㄢ,kāi duān
6889,開懷,6,,7,2,9,ㄎㄞ ㄏㄨㄞˊ,kāi huái
6890,開闊,6,,11,8,19,ㄎㄞ ㄎㄨㄛˋ,kāi kuò
6891,開朗,6,,14,13,27,ㄎㄞ ㄌㄤˇ,kāi lǎng
6892,開明,6,,6,4,10,ㄎㄞ ㄇㄧㄥˊ,kāi míng
6893,開幕,6,,8,7,15,ㄎㄞ ㄇㄨˋ,kāi mù
6894,開盤,6,,1,1,2,ㄎㄞ ㄆㄢˊ,kāi pán
6895,開闢,6,,8,6,14,ㄎㄞ ㄆㄧˋ,kāi pì
6896,開啟,6,,27,28,55,ㄎㄞ ㄑㄧˇ,kāi qǐ
6897,開槍,6,,12,5,17,ㄎㄞ ㄑㄧㄤ,kāi qiāng
6898,開設,6,,11,8,19,ㄎㄞ ㄕㄜˋ,kāi shè
6899,開拓,6,,15,50,65,ㄎㄞ ㄊㄨㄛˋ,kāi tuò
6900,開銷,6,,7,13,20,ㄎㄞ ㄒㄧㄠ,kāi xiāo
6901,開業,6,,5,3,8,ㄎㄞ ㄧㄝˋ,kāi yè
6902,開戰,6,,8,7,15,ㄎㄞ ㄓㄢˋ,kāi zhàn
6903,開展,6,,17,6,23,ㄎㄞ ㄓㄢˇ,kāi zhǎn
6904,開張,6,,5,3,8,ㄎㄞ ㄓㄤ,kāi zhāng
6905,開支,6,,6,3,9,ㄎㄞ ㄓ,kāi zhī
6906,看板,6,,5,3,8,ㄎㄢˋ ㄅㄢˇ,kàn bǎn
6907,堪稱,6,,12,6,18,ㄎㄢ ㄔㄥ,kān chēng
6908,看穿,6,,6,1,7,ㄎㄢˋ ㄔㄨㄢ,kàn chuān
6909,看待,6,,43,28,71,ㄎㄢˋ ㄉㄞˋ,kàn dài
6910,看守,6,,9,3,12,ㄎㄢ ㄕㄡˇ,kān shǒu
6911,看透,6,,5,5,10,ㄎㄢˋ ㄊㄡˋ,kàn tòu
6912,刊載,6,,5,1,6,ㄎㄢ ㄗㄞˋ,kān zài
6913,看中,6,,6,3,9,ㄎㄢˋ ㄓㄨㄥˋ,kàn zhòng
6914,看重,6,,11,2,13,ㄎㄢˋ ㄓㄨㄥˋ,kàn zhòng
6915,扛,6,,18,19,37,ㄎㄤˊ,káng
6916,康復,6,,10,7,17,ㄎㄤ ㄈㄨˋ,kāng fù
6917,慷慨,6,,19,7,26,ㄎㄤ ㄎㄞˇ,kāng kǎi
6918,抗戰,6,,24,9,33,ㄎㄤˋ ㄓㄢˋ,kàng zhàn
6919,抗爭,6,,13,14,27,ㄎㄤˋ ㄓㄥ,kàng zhēng
6920,考察,6,,15,5,20,ㄎㄠˇ ㄔㄚˊ,kǎo chá
6921,考證,6,,9,4,13,ㄎㄠˇ ㄓㄥˋ,kǎo zhèng
6922,殼,6,,17,36,53,ㄎㄜˊ,ké
6923,刻板,6,,16,6,22,ㄎㄜˋ ㄅㄢˇ,kè bǎn
6924,可悲,6,,9,2,11,ㄎㄜˇ ㄅㄟ,kě bēi
6925,刻薄,6,,7,0,7,ㄎㄜˋ ㄅㄛˊ,kè bó
6926,可恥,6,,5,2,7,ㄎㄜˇ ㄔˇ,kě chǐ
6927,可觀,6,,13,7,20,ㄎㄜˇ ㄍㄨㄢ,kě guān
6928,可貴,6,,9,8,17,ㄎㄜˇ ㄍㄨㄟˋ,kě guì
6929,刻劃/刻畫,6,,8,4,12,ㄎㄜˋ ㄏㄨㄚˋ ,kè huà
6930,科幻,6,,10,2,12,ㄎㄜ ㄏㄨㄢˋ,kē huàn
6931,刻苦,6,,5,8,13,ㄎㄜˋ ㄎㄨˇ,kè kǔ
6932,科目,6,,9,8,17,ㄎㄜ ㄇㄨˋ,kē mù
6933,渴求,6,,8,2,10,ㄎㄜˇ ㄑㄧㄡˊ,kě qiú
6934,課題,6,,23,26,49,ㄎㄜˋ ㄊㄧˊ,kè tí
6935,渴望,6,,60,18,78,ㄎㄜˇ ㄨㄤˋ,kě wàng
6936,可謂,6,,7,0,7,ㄎㄜˇ ㄨㄟˋ,kě wèi
6937,可想而知,6,,8,1,9,ㄎㄜˇ ㄒㄧㄤˇ ㄦˊ ㄓ,kě xiǎng ér zhī
6938,可行,6,,18,9,27,ㄎㄜˇ ㄒㄧㄥˊ,kě xíng
6939,刻意,6,,39,22,61,ㄎㄜˋ ㄧˋ,kè yì
6940,可疑,6,,11,5,16,ㄎㄜˇ ㄧˊ,kě yí
6941,克制,6,,10,7,17,ㄎㄜˋ ㄓˋ,kè zhì
6942,啃,6,,8,6,14,ㄎㄣˇ,kěn
6943,懇求,6,,14,1,15,ㄎㄣˇ ㄑㄧㄡˊ,kěn qiú
6944,坑,6,,9,7,16,ㄎㄥ,kēng
6945,孔,6,,16,22,38,ㄎㄨㄥˇ,kǒng
6946,空檔1,6,,9,8,17,ㄎㄨㄥˋ ㄉㄤˇ,kòng dǎng
6947,空蕩蕩,6,,5,2,7,ㄎㄨㄥ ㄉㄤˋ ㄉㄤˋ,kōng dàng dàng
6948,空洞,6,,10,1,11,ㄎㄨㄥ ㄉㄨㄥˋ,kōng dòng
6949,控告,6,,5,1,6,ㄎㄨㄥˋ ㄍㄠˋ,kòng gào
6950,恐嚇,6,,9,5,14,ㄎㄨㄥˇ ㄏㄜˋ,kǒng hè
6951,恐慌,6,,14,13,27,ㄎㄨㄥˇ ㄏㄨㄤ,kǒng huāng
6952,空軍,6,,16,5,21,ㄎㄨㄥ ㄐㄩㄣ,kōng jūn
6953,空前,6,,11,4,15,ㄎㄨㄥ ㄑㄧㄢˊ,kōng qián
6954,孔雀,6,,8,7,15,ㄎㄨㄥˇ ㄑㄩㄝˋ,kǒng què
6955,控訴,6,,6,3,9,ㄎㄨㄥˋ ㄙㄨˋ,kòng sù
6956,空想,6,,9,0,9,ㄎㄨㄥ ㄒㄧㄤˇ,kōng xiǎng
6957,空虛,6,,20,4,24,ㄎㄨㄥ ㄒㄩ,kōng xū
6958,扣,6,,13,9,22,ㄎㄡˋ,kòu
6959,口碑,6,,6,5,11,ㄎㄡˇ ㄅㄟ,kǒu bēi
6960,口齒,6,,4,1,5,ㄎㄡˇ ㄔˇ,kǒu chǐ
6961,口腔,6,,8,5,13,ㄎㄡˇ ㄑㄧㄤ,kǒu qiāng
6962,口哨,6,,4,1,5,ㄎㄡˇ ㄕㄠˋ,kǒu shào
6963,口述,6,,10,4,14,ㄎㄡˇ ㄕㄨˋ,kǒu shù
6964,口吻,6,,14,1,15,ㄎㄡˇ ㄨㄣˇ,kǒu wěn
6965,酷,6,,11,25,36,ㄎㄨˋ,kù
6966,庫存,6,,11,4,15,ㄎㄨˋ ㄘㄨㄣˊ,kù cún
6967,苦練,6,,3,3,6,ㄎㄨˇ ㄌㄧㄢˋ,kǔ liàn
6968,苦悶,6,,6,2,8,ㄎㄨˇ ㄇㄣˋ,kǔ mèn
6969,苦難,6,,18,19,37,ㄎㄨˇ ㄋㄢˋ,kǔ nàn
6970,苦頭,6,,7,6,13,ㄎㄨˇ ㄊㄡˊ,kǔ tóu
6971,苦心,6,,7,5,12,ㄎㄨˇ ㄒㄧㄣ,kǔ xīn
6972,枯燥,6,,5,2,7,ㄎㄨ ㄗㄠˋ,kū zào
6973,誇大,6,,12,4,16,ㄎㄨㄚ ㄉㄚˋ,kuā dà
6974,跨越,6,,16,19,35,ㄎㄨㄚˋ ㄩㄝˋ,kuà yuè
6975,快感,6,,11,1,12,ㄎㄨㄞˋ ㄍㄢˇ,kuài gǎn
6976,快活,6,,10,2,12,ㄎㄨㄞˋ ㄏㄨㄛˊ,kuài huó
6977,會計,6,,12,4,16,ㄎㄨㄞˋ ㄐㄧˋ,kuài jì
6978,款,6,,18,28,46,ㄎㄨㄢˇ,kuǎn
6979,寬敞,6,,9,3,12,ㄎㄨㄢ ㄔㄤˇ,kuān chǎng
6980,寬大,6,,9,2,11,ㄎㄨㄢ ㄉㄚˋ,kuān dà
6981,款待,6,,7,1,8,ㄎㄨㄢˇ ㄉㄞˋ,kuǎn dài
6982,寬厚,6,,5,1,6,ㄎㄨㄢ ㄏㄡˋ,kuān hòu
6983,寬闊,6,,10,5,15,ㄎㄨㄢ ㄎㄨㄛˋ,kuān kuò
6984,寬容,6,,13,7,20,ㄎㄨㄢ ㄖㄨㄥˊ,kuān róng
6985,寬恕,6,,18,3,21,ㄎㄨㄢ ㄕㄨˋ,kuān shù
6986,框,6,,9,6,15,ㄎㄨㄤ,kuāng
6987,礦產,6,,1,5,6,ㄎㄨㄤˋ ㄔㄢˇ,kuàng chǎn
6988,狂風,6,,14,6,20,ㄎㄨㄤˊ ㄈㄥ,kuáng fēng
6989,狂歡,6,,6,1,7,ㄎㄨㄤˊ ㄏㄨㄢ,kuáng huān
6990,框架,6,,12,6,18,ㄎㄨㄤ ㄐㄧㄚˋ,kuāng jià
6991,況且,6,,16,6,22,ㄎㄨㄤˋ ㄑㄧㄝˇ,kuàng qiě
6992,狂熱,6,,14,2,16,ㄎㄨㄤˊ ㄖㄜˋ,kuáng rè
6993,虧,6,,11,7,18,ㄎㄨㄟ,kuī
6994,匱乏,6,,8,11,19,ㄎㄨㄟˋ ㄈㄚˊ,kuì fá
6995,虧損,6,,11,4,15,ㄎㄨㄟ ㄙㄨㄣˇ,kuī sǔn
6996,捆,6,,10,3,13,ㄎㄨㄣˇ,kǔn
6997,昆蟲,6,,15,37,52,ㄎㄨㄣ ㄔㄨㄥˊ,kūn chóng
6998,困惑,6,,35,6,41,ㄎㄨㄣˋ ㄏㄨㄛˋ,kùn huò
6999,困苦,6,,6,8,14,ㄎㄨㄣˋ ㄎㄨˇ,kùn kǔ
7000,擴充,6,,10,3,13,ㄎㄨㄛˋ ㄔㄨㄥ,kuò chōng
7001,擴散,6,,57,28,85,ㄎㄨㄛˋ ㄙㄢˋ,kuò sàn
7002,擴展,6,,13,7,20,ㄎㄨㄛˋ ㄓㄢˇ,kuò zhǎn
7003,蠟,6,,8,9,17,ㄌㄚˋ,là
7004,拉扯,6,,8,3,11,ㄌㄚ ㄔㄜˇ,lā chě
7005,拉票,6,,1,1,2,ㄌㄚ ㄆㄧㄠˋ,lā piào
7006,賴,6,,27,25,52,ㄌㄞˋ,lài
7007,來賓,6,,4,47,51,ㄌㄞˊ ㄅㄧㄣ,lái bīn
7008,來歷,6,,9,1,10,ㄌㄞˊ ㄌㄧˋ,lái lì
7009,來往1,6,,17,7,24,ㄌㄞˊ ㄨㄤˇ,lái wǎng
7010,來往2,6,,17,7,24,ㄌㄞˊ ㄨㄤˇ,lái wǎng
7011,來意,6,,4,0,4,ㄌㄞˊ ㄧˋ,lái yì
7012,欄,6,,14,3,17,ㄌㄢˊ,lán
7013,欄杆,6,,9,4,13,ㄌㄢˊ ㄍㄢ,lán gān
7014,懶散,6,,5,1,6,ㄌㄢˇ ㄙㄢˇ,lǎn sǎn
7015,藍圖,6,,8,6,14,ㄌㄢˊ ㄊㄨˊ,lán tú
7016,濫用,6,,11,4,15,ㄌㄢˋ ㄩㄥˋ,làn yòng
7017,狼狽,6,,8,3,11,ㄌㄤˊ ㄅㄟˋ,láng bèi
7018,浪潮,6,,7,4,11,ㄌㄤˋ ㄔㄠˊ,làng cháo
7019,朗讀,6,,5,2,7,ㄌㄤˇ ㄉㄨˊ,lǎng dú
7020,牢,6,,14,4,18,ㄌㄠˊ,láo
7021,撈,6,,9,10,19,ㄌㄠ,lāo
7022,老百姓/百姓,6,,102,55,157,ㄌㄠˇ ㄅㄞˇ ㄒㄧㄥˋ/ㄅㄞˇ ㄒㄧㄥˋ,lǎo bǎi xìng/bǎi xìng
7023,老爹,6,,19,4,23,ㄌㄠˇ ㄉㄧㄝ,lǎo diē
7024,牢記,6,,6,3,9,ㄌㄠˊ ㄐㄧˋ,láo jì
7025,勞累,6,,7,3,10,ㄌㄠˊ ㄌㄟˋ,láo lèi
7026,牢騷,6,,5,1,6,ㄌㄠˊ ㄙㄠ,láo sāo
7027,老手,6,,5,0,5,ㄌㄠˇ ㄕㄡˇ,lǎo shǒu
7028,老爺,6,,69,9,78,ㄌㄠˇ ㄧㄝˊ,lǎo yé
7029,老子,6,,19,1,20,ㄌㄠˇ ㄗˇ/ㄌㄠˇ ˙ㄗ,lǎo zǐ/lǎo zi
7030,勒索,6,,7,1,8,ㄌㄜˋ ㄙㄨㄛˇ,lè suǒ
7031,樂於,6,,15,8,23,ㄌㄜˋ ㄩˊ,lè yú
7032,累計,6,,2,3,5,ㄌㄟˇ ㄐㄧˋ,lěi jì
7033,雷射,6,,8,4,12,ㄌㄟˊ ㄕㄜˋ,léi shè
7034,愣,6,,6,1,7,ㄌㄥˋ,lèng
7035,冷汗,6,,7,2,9,ㄌㄥˇ ㄏㄢˋ,lěng hàn
7036,冷酷,6,,11,2,13,ㄌㄥˇ ㄎㄨˋ,lěng kù
7037,冷落,6,,6,1,7,ㄌㄥˇ ㄌㄨㄛˋ,lěng luò
7038,冷卻,6,,9,18,27,ㄌㄥˇ ㄑㄩㄝˋ,lěng què
7039,冷戰,6,,6,11,17,ㄌㄥˇ ㄓㄢˋ ,lěng zhàn 
7040,里,6,,80,43,123,ㄌㄧˇ,lǐ
7041,籬笆,6,,8,2,10,ㄌㄧˊ ㄅㄚ,lí bā
7042,離別,6,,4,3,7,ㄌㄧˊ ㄅㄧㄝˊ,lí bié
7043,理財,6,,8,5,13,ㄌㄧˇ ㄘㄞˊ,lǐ cái
7044,歷程,6,,57,19,76,ㄌㄧˋ ㄔㄥˊ,lì chéng
7045,里程碑,6,,5,5,10,ㄌㄧˇ ㄔㄥˊ ㄅㄟ,lǐ chéng bēi
7046,歷代,6,,20,4,24,ㄌㄧˋ ㄉㄞˋ,lì dài
7047,力道,6,,13,12,25,ㄌㄧˋ ㄉㄠˋ,lì dào
7048,立法,6,,10,6,16,ㄌㄧˋ ㄈㄚˇ,lì fǎ
7049,利害,6,,11,1,12,ㄌㄧˋ ㄏㄞˋ,lì hài
7050,罹患,6,,29,43,72,ㄌㄧˊ ㄏㄨㄢˋ,lí huàn
7051,理會,6,,20,2,22,ㄌㄧˇ ㄏㄨㄟˋ,lǐ huì
7052,歷屆,6,,1,3,4,ㄌㄧˋ ㄐㄧㄝˋ,lì jiè
7053,禮節,6,,7,3,10,ㄌㄧˇ ㄐㄧㄝˊ,lǐ jié
7054,歷經,6,,23,38,61,ㄌㄧˋ ㄐㄧㄥ,lì jīng
7055,歷練,6,,8,6,14,ㄌㄧˋ ㄌㄧㄢˋ,lì liàn
7056,俐落,6,,9,7,16,ㄌㄧˋ ㄌㄨㄛˋ,lì luò
7057,黎明,6,,11,7,18,ㄌㄧˊ ㄇㄧㄥˊ,lí míng
7058,罹難,6,,2,14,16,ㄌㄧˊ ㄋㄢˋ,lí nàn
7059,歷年,6,,2,3,5,ㄌㄧˋ ㄋㄧㄢˊ,lì nián
7060,理念,6,,49,77,126,ㄌㄧˇ ㄋㄧㄢˋ,lǐ niàn
7061,離譜,6,,8,3,11,ㄌㄧˊ ㄆㄨˇ,lí pǔ
7062,離奇,6,,6,1,7,ㄌㄧˊ ㄑㄧˊ,lí qí
7063,利器,6,,5,3,8,ㄌㄧˋ ㄑㄧˋ,lì qì
7064,力求,6,,6,2,8,ㄌㄧˋ ㄑㄧㄡˊ,lì qiú
7065,歷任,6,,12,3,15,ㄌㄧˋ ㄖㄣˋ,lì rèn
7066,厲聲,6,,8,0,8,ㄌㄧˋ ㄕㄥ,lì shēng
7067,歷時,6,,6,2,8,ㄌㄧˋ ㄕˊ,lì shí
7068,隸屬,6,,5,2,7,ㄌㄧˋ ㄕㄨˇ,lì shǔ
7069,立體,6,,9,10,19,ㄌㄧˋ ㄊㄧˇ,lì tǐ
7070,例行,6,,11,8,19,ㄌㄧˋ ㄒㄧㄥˊ,lì xíng
7071,立志,6,,6,8,14,ㄌㄧˋ ㄓˋ,lì zhì
7072,立足,6,,8,4,12,ㄌㄧˋ ㄗㄨˊ,lì zú
7073,聯邦,6,,19,24,43,ㄌㄧㄢˊ ㄅㄤ,lián bāng
7074,連帶,6,,9,10,19,ㄌㄧㄢˊ ㄉㄞˋ,lián dài
7075,連貫/聯貫,6,,6,2,8,ㄌㄧㄢˊ ㄍㄨㄢˋ,lián guàn
7076,蓮花,6,,13,7,20,ㄌㄧㄢˊ ㄏㄨㄚ,lián huā
7077,廉價,6,,11,9,20,ㄌㄧㄢˊ ㄐㄧㄚˋ,lián jià
7078,連結/聯結,6,,87,40,127,ㄌㄧㄢˊ ㄐㄧㄝˊ,lián jié
7079,連連,6,,15,2,17,ㄌㄧㄢˊ ㄌㄧㄢˊ,lián lián
7080,憐憫,6,,11,4,15,ㄌㄧㄢˊ ㄇㄧㄣˇ,lián mǐn
7081,臉龐,6,,13,4,17,ㄌㄧㄢˇ ㄆㄤˊ,liǎn páng
7082,臉皮,6,,5,1,6,ㄌㄧㄢˇ ㄆㄧˊ,liǎn pí
7083,臉譜,6,,1,2,3,ㄌㄧㄢˇ ㄆㄨˇ,liǎn pǔ
7084,戀情,6,,7,1,8,ㄌㄧㄢˋ ㄑㄧㄥˊ,liàn qíng
7085,連任,6,,3,6,9,ㄌㄧㄢˊ ㄖㄣˋ,lián rèn
7086,連聲,6,,8,1,9,ㄌㄧㄢˊ ㄕㄥ,lián shēng
7087,聯手,6,,9,7,16,ㄌㄧㄢˊ ㄕㄡˇ,lián shǒu
7088,連署,6,,1,3,4,ㄌㄧㄢˊ ㄕㄨˋ,lián shù
7089,連鎖,6,,10,10,20,ㄌㄧㄢˊ ㄙㄨㄛˇ,lián suǒ
7090,連同,6,,10,2,12,ㄌㄧㄢˊ ㄊㄨㄥˊ,lián tóng
7091,連夜,6,,9,3,12,ㄌㄧㄢˊ ㄧㄝˋ,lián yè
7092,糧草,6,,7,1,8,ㄌㄧㄤˊ ㄘㄠˇ,liáng cǎo
7093,亮光,6,,8,2,10,ㄌㄧㄤˋ ㄍㄨㄤ,liàng guāng
7094,量化,6,,8,6,14,ㄌㄧㄤˋ ㄏㄨㄚˋ,liàng huà
7095,兩極,6,,3,2,5,ㄌㄧㄤˇ ㄐㄧˊ,liǎng jí
7096,諒解,6,,9,7,16,ㄌㄧㄤˋ ㄐㄧㄝˇ,liàng jiě
7097,亮晶晶,6,,3,3,6,ㄌㄧㄤˋ ㄐㄧㄥ ㄐㄧㄥ,liàng jīng jīng
7098,亮麗,6,,8,11,19,ㄌㄧㄤˋ ㄌㄧˋ,liàng lì
7099,兩難,6,,8,2,10,ㄌㄧㄤˇ ㄋㄢˊ,liǎng nán
7100,亮眼,6,,3,2,5,ㄌㄧㄤˋ ㄧㄢˇ,liàng yǎn
7101,料到,6,,14,2,16,ㄌㄧㄠˋ ㄉㄠˋ,liào dào
7102,遼闊,6,,8,4,12,ㄌㄧㄠˊ ㄎㄨㄛˋ,liáo kuò
7103,療效,6,,13,5,18,ㄌㄧㄠˊ ㄒㄧㄠˋ,liáo xiào
7104,列,6,,38,14,52,ㄌㄧㄝˋ,liè
7105,烈,6,,15,8,23,ㄌㄧㄝˋ,liè
7106,列車,6,,14,15,29,ㄌㄧㄝˋ ㄔㄜ,liè chē
7107,裂縫,6,,6,10,16,ㄌㄧㄝˋ ㄈㄥˋ,liè fèng
7108,列舉,6,,8,0,8,ㄌㄧㄝˋ ㄐㄩˇ,liè jǔ
7109,列強,6,,10,1,11,ㄌㄧㄝˋ ㄑㄧㄤˊ,liè qiáng
7110,列入,6,,12,11,23,ㄌㄧㄝˋ ㄖㄨˋ,liè rù
7111,劣勢,6,,5,4,9,ㄌㄧㄝˋ ㄕˋ,liè shì
7112,臨,6,,36,12,48,ㄌㄧㄣˊ,lín
7113,臨床,6,,39,16,55,ㄌㄧㄣˊ ㄔㄨㄤˊ,lín chuáng
7114,鄰近,6,,14,28,42,ㄌㄧㄣˊ ㄐㄧㄣˋ,lín jìn
7115,吝嗇,6,,6,4,10,ㄌㄧㄣˋ ㄙㄜˋ,lìn sè
7116,臨終,6,,12,4,16,ㄌㄧㄣˊ ㄓㄨㄥ,lín zhōng
7117,鈴,6,,12,15,27,ㄌㄧㄥˊ,líng
7118,靈,6,,23,21,44,ㄌㄧㄥˊ,líng
7119,拎,6,,7,4,11,ㄌㄧㄥ,līng
7120,凌晨,6,,12,10,22,ㄌㄧㄥˊ ㄔㄣˊ,líng chén
7121,領隊,6,,4,2,6,ㄌㄧㄥˇ ㄉㄨㄟˋ,lǐng duì
7122,領會,6,,8,1,9,ㄌㄧㄥˇ ㄏㄨㄟˋ,lǐng huì
7123,靈魂,6,,67,16,83,ㄌㄧㄥˊ ㄏㄨㄣˊ,líng hún
7124,領軍,6,,7,3,10,ㄌㄧㄥˇ ㄐㄩㄣ,lǐng jūn
7125,另類,6,,10,8,18,ㄌㄧㄥˋ ㄌㄟˋ,lìng lèi
7126,靈敏,6,,5,5,10,ㄌㄧㄥˊ ㄇㄧㄣˇ,líng mǐn
7127,靈巧,6,,7,1,8,ㄌㄧㄥˊ ㄑㄧㄠˇ,líng qiǎo
7128,聆聽,6,,35,10,45,ㄌㄧㄥˊ ㄊㄧㄥ,líng tīng
7129,領土,6,,13,13,26,ㄌㄧㄥˇ ㄊㄨˇ,lǐng tǔ
7130,領悟,6,,15,4,19,ㄌㄧㄥˇ ㄨˋ,lǐng wù
7131,靈性,6,,17,5,22,ㄌㄧㄥˊ ㄒㄧㄥˋ,líng xìng
7132,零星,6,,6,4,10,ㄌㄧㄥˊ ㄒㄧㄥ,líng xīng
7133,領域,6,,149,41,190,ㄌㄧㄥˇ ㄩˋ,lǐng yù
7134,柳,6,,10,5,15,ㄌㄧㄡˇ,liǔ
7135,溜,6,,9,4,13,ㄌㄧㄡ / ㄌㄧㄡˋ,liū / liù
7136,流暢,6,,10,4,14,ㄌㄧㄡˊ ㄔㄤˋ,liú chàng
7137,瀏覽,6,,9,1,10,ㄌㄧㄡˊ ㄌㄢˇ,liú lǎn
7138,流浪漢,6,,5,3,8,ㄌㄧㄡˊ ㄌㄤˋ ㄏㄢˋ,liú làng hàn
7139,流氓,6,,10,3,13,ㄌㄧㄡˊ ㄇㄤˊ,liú máng
7140,流逝,6,,7,3,10,ㄌㄧㄡˊ ㄕˋ,liú shì
7141,流失,6,,11,26,37,ㄌㄧㄡˊ ㄕ,liú shī
7142,流水,6,,10,8,18,ㄌㄧㄡˊ ㄕㄨㄟˇ,liú shuǐ
7143,流通,6,,12,12,24,ㄌㄧㄡˊ ㄊㄨㄥ,liú tōng
7144,留心,6,,9,1,10,ㄌㄧㄡˊ ㄒㄧㄣ,liú xīn
7145,流言,6,,5,2,7,ㄌㄧㄡˊ ㄧㄢˊ,liú yán
7146,流域,6,,8,28,36,ㄌㄧㄡˊ ㄩˋ,liú yù
7147,陸,6,,11,27,38,ㄌㄧㄡˋ/ㄌㄨˋ,liù/lù
7148,弄2,6,,62,76,138,ㄌㄨㄥˋ,lòng
7149,壟斷,6,,12,2,14,ㄌㄨㄥˇ ㄉㄨㄢˋ,lǒng duàn
7150,龍頭,6,,11,4,15,ㄌㄨㄥˊ ㄊㄡˊ,lóng tóu
7151,籠罩,6,,15,11,26,ㄌㄨㄥˊ ㄓㄠˋ,lóng zhào
7152,隆重,6,,11,4,15,ㄌㄨㄥˊ ㄓㄨㄥˋ,lóng zhòng
7153,籠子,6,,12,5,17,ㄌㄨㄥˊ ˙ㄗ,lóng zi
7154,漏,6,,12,14,26,ㄌㄡˋ,lòu
7155,摟,6,,9,1,10,ㄌㄡ / ㄌㄡˊ / ㄌㄡˇ,lōu / lóu / lǒu
7156,漏洞,6,,7,4,11,ㄌㄡˋ ㄉㄨㄥˋ,lòu dòng
7157,露面,6,,5,3,8,ㄌㄡˋ ㄇㄧㄢˋ,lòu miàn
7158,驢,6,,13,5,18,ㄌㄩˊ,lǘ
7159,率,6,,17,14,31,ㄌㄩˋ / ㄕㄨㄞˋ,lǜ / shuài
7160,路程,6,,11,13,24,ㄌㄨˋ ㄔㄥˊ,lù chéng
7161,屢次,6,,7,2,9,ㄌㄩˇ ㄘˋ,lǚ cì
7162,路徑,6,,21,16,37,ㄌㄨˋ ㄐㄧㄥˋ,lù jìng
7163,陸軍,6,,20,2,22,ㄌㄨˋ ㄐㄩㄣ,lù jūn
7164,露天,6,,5,8,13,ㄌㄨˋ ㄊㄧㄢ,lù tiān
7165,路途,6,,8,9,17,ㄌㄨˋ ㄊㄨˊ,lù tú
7166,履行,6,,8,3,11,ㄌㄩˇ ㄒㄧㄥˊ,lǚ xíng
7167,爐子/爐,6,,21,12,33,ㄌㄨˊ ˙ㄗ/ㄌㄨˊ,lú zi/lú
7168,卵,6,,14,12,26,ㄌㄨㄢˇ,luǎn
7169,亂世,6,,13,2,15,ㄌㄨㄢˋ ㄕˋ,luàn shì
7170,略,6,,40,7,47,ㄌㄩㄝˋ,lüè
7171,掠過,6,,9,2,11,ㄌㄩㄝˋ ㄍㄨㄛˋ,lüè guò
7172,輪船,6,,6,3,9,ㄌㄨㄣˊ ㄔㄨㄢˊ,lún chuán
7173,論點,6,,18,3,21,ㄌㄨㄣˋ ㄉㄧㄢˇ,lùn diǎn
7174,輪廓,6,,11,4,15,ㄌㄨㄣˊ ㄎㄨㄛˋ,lún kuò
7175,倫理,6,,29,12,41,ㄌㄨㄣˊ ㄌㄧˇ,lún lǐ
7176,論述,6,,36,2,38,ㄌㄨㄣˋ ㄕㄨˋ,lùn shù
7177,淪為,6,,8,9,17,ㄌㄨㄣˊㄨㄟˊ,lún wéi
7178,蘿蔔,6,,11,62,73,ㄌㄨㄛˊ ˙ㄅㄛ,luó bo
7179,落差,6,,8,15,23,ㄌㄨㄛˋ ㄔㄚ,luò chā
7180,落地窗,6,,3,1,4,ㄌㄨㄛˋ ㄉㄧˋ ㄔㄨㄤ,luò dì chuāng
7181,落空,6,,7,2,9,ㄌㄨㄛˋ ㄎㄨㄥ,luò kōng
7182,落實,6,,16,28,44,ㄌㄨㄛˋ ㄕˊ,luò shí
7183,裸體,6,,6,1,7,ㄌㄨㄛˇ ㄊㄧˇ,luǒ tǐ
7184,麻,6,,14,19,33,ㄇㄚˊ,má
7185,碼,6,,9,2,11,ㄇㄚˇ,mǎ
7186,麻痺,6,,9,8,17,ㄇㄚˊ ㄅㄧˋ,má bì
7187,馬虎,6,,4,7,11,ㄇㄚˇ ㄏㄨ,mǎ hū
7188,麻木,6,,7,2,9,ㄇㄚˊ ㄇㄨˋ,má mù
7189,馬匹,6,,8,3,11,ㄇㄚˇ ㄆㄧ,mǎ pī
7190,麻雀,6,,9,4,13,ㄇㄚˊ ㄑㄩㄝˋ,má què
7191,碼頭,6,,15,5,20,ㄇㄚˇ ˙ㄊㄡ,mǎ tou
7192,麻醉,6,,12,8,20,ㄇㄚˊ ㄗㄨㄟˋ,má zuì
7193,脈搏,6,,5,2,7,ㄇㄞˋ ㄅㄛˊ,mài bó
7194,埋藏,6,,5,5,10,ㄇㄞˊ ㄘㄤˊ,mái cáng
7195,埋伏,6,,21,1,22,ㄇㄞˊ ㄈㄨˊ,mái fú
7196,脈絡,6,,19,5,24,ㄇㄞˋ ㄌㄨㄛˋ,mài luò
7197,賣命,6,,4,1,5,ㄇㄞˋ ㄇㄧㄥˋ,mài mìng
7198,埋葬/葬,6,,26,12,38,ㄇㄞˊ ㄗㄤˋ / ㄗㄤˋ,mái zàng/zàng
7199,買主,6,,4,1,5,ㄇㄞˇ ㄓㄨˇ,mǎi zhǔ
7200,瞞,6,,14,5,19,ㄇㄢˊ,mán
7201,蠻,6,,31,223,254,ㄇㄢˊ,mán
7202,漫步,6,,10,2,12,ㄇㄢˋ ㄅㄨˋ,màn bù
7203,漫長,6,,23,17,40,ㄇㄢˋ ㄔㄤˊ,màn cháng
7204,滿懷,6,,14,3,17,ㄇㄢˇ ㄏㄨㄞˊ,mǎn huái
7205,滿頭大汗,6,,3,3,6,ㄇㄢˇ ㄊㄡˊ ㄉㄚˋ ㄏㄢˋ,mǎn tóu dà hàn
7206,滿心,6,,9,4,13,ㄇㄢˇ ㄒㄧㄣ,mǎn xīn
7207,蔓延,6,,8,14,22,ㄇㄢˋ ㄧㄢˊ,màn yán
7208,埋怨,6,,11,6,17,ㄇㄢˊ ㄩㄢˋ,mán yuàn
7209,滿月,6,,4,3,7,ㄇㄢˇ ㄩㄝˋ,mǎn yuè
7210,盲,6,,8,7,15,ㄇㄤˊ,máng
7211,盲從,6,,3,0,3,ㄇㄤˊ ㄘㄨㄥˊ,máng cóng
7212,盲點,6,,5,5,10,ㄇㄤˊ ㄉㄧㄢˇ,máng diǎn
7213,茫茫,6,,6,4,10,ㄇㄤˊ ㄇㄤˊ,máng máng
7214,盲目,6,,15,5,20,ㄇㄤˊ ㄇㄨˋ,máng mù
7215,茫然,6,,15,5,20,ㄇㄤˊ ㄖㄢˊ,máng rán
7216,冒充,6,,4,0,4,ㄇㄠˋ ㄔㄨㄥ,mào chōng
7217,冒犯,6,,8,1,9,ㄇㄠˋ ㄈㄢˋ,mào fàn
7218,冒煙,6,,4,3,7,ㄇㄠˋ ㄧㄢ,mào yān
7219,枚,6,,20,11,31,ㄇㄟˊ,méi
7220,煤,6,,6,9,15,ㄇㄟˊ,méi
7221,美德,6,,14,5,19,ㄇㄟˇ ㄉㄜˊ,měi dé
7222,美觀,6,,6,11,17,ㄇㄟˇ ㄍㄨㄢ,měi guān
7223,媒介,6,,12,10,22,ㄇㄟˊ ㄐㄧㄝˋ,méi jiè
7224,美貌,6,,11,2,13,ㄇㄟˇ ㄇㄠˋ,měi mào
7225,每每,6,,9,3,12,ㄇㄟˇ ㄇㄟˇ,měi měi
7226,媒人,6,,5,2,7,ㄇㄟˊ ㄖㄣˊ,méi rén
7227,美術,6,,12,10,22,ㄇㄟˇ ㄕㄨˋ,měi shù
7228,美術館,6,,15,5,20,ㄇㄟˇ ㄕㄨˋ ㄍㄨㄢˇ,měi shù guǎn
7229,悶2,6,,17,11,28,ㄇㄣˋ,mèn
7230,門戶,6,,8,4,12,ㄇㄣˊ ㄏㄨˋ,mén hù
7231,門檻,6,,12,10,22,ㄇㄣˊ ㄎㄢˇ,mén kǎn
7232,悶悶不樂,6,,6,1,7,ㄇㄣˋ ㄇㄣˋ ㄅㄨˊ ㄌㄜˋ,mèn mèn bú lè
7233,夢幻,6,,12,6,18,ㄇㄥˋ ㄏㄨㄢˋ,mèng huàn
7234,夢境,6,,15,4,19,ㄇㄥˋ ㄐㄧㄥˋ,mèng jìng
7235,猛烈,6,,13,6,19,ㄇㄥˇ ㄌㄧㄝˋ,měng liè
7236,朦朧,6,,8,1,9,ㄇㄥˊ ㄌㄨㄥˊ,méng lóng
7237,盟友,6,,5,16,21,ㄇㄥˊ ㄧㄡˇ,méng yǒu
7238,密,6,,13,16,29,ㄇㄧˋ,mì
7239,瞇,6,,8,1,9,ㄇㄧ,mī
7240,彌補,6,,20,13,33,ㄇㄧˊ ㄅㄨˇ,mí bǔ
7241,密不可分,6,,5,4,9,ㄇㄧˋ ㄅㄨˋ ㄎㄜˇ ㄈㄣ,mì bù kě fēn
7242,密度,6,,13,23,36,ㄇㄧˋ ㄉㄨˋ,mì dù
7243,迷宮,6,,9,3,12,ㄇㄧˊ ㄍㄨㄥ,mí gōng
7244,迷惑,6,,14,4,18,ㄇㄧˊ ㄏㄨㄛˋ,mí huò
7245,密集,6,,11,15,26,ㄇㄧˋ ㄐㄧˊ,mì jí
7246,祕訣/秘訣,6,,15,13,28,ㄇㄧˋ ㄐㄩㄝˊ,mì jué
7247,迷戀,6,,9,1,10,ㄇㄧˊ ㄌㄧㄢˋ,mí liàn
7248,瀰漫/彌漫,6,,15,10,25,ㄇㄧˊ ㄇㄢˋ,mí màn
7249,迷失,6,,15,7,22,ㄇㄧˊ ㄕ,mí shī
7250,迷思,6,,12,6,18,ㄇㄧˊ ㄙ,mí sī
7251,免不了,6,,11,3,14,ㄇㄧㄢˇ ㄅㄨˋ ㄌㄧㄠˇ,miǎn bù liǎo
7252,免除,6,,8,3,11,ㄇㄧㄢˇ ㄔㄨˊ,miǎn chú
7253,面孔,6,,18,4,22,ㄇㄧㄢˋ ㄎㄨㄥˇ,miàn kǒng
7254,面目,6,,9,3,12,ㄇㄧㄢˋ ㄇㄨˋ,miàn mù
7255,面容,6,,9,2,11,ㄇㄧㄢˋ ㄖㄨㄥˊ,miàn róng
7256,面色,6,,7,2,9,ㄇㄧㄢˋ ㄙㄜˋ,miàn sè
7257,免疫,6,,22,27,49,ㄇㄧㄢˇ ㄧˋ,miǎn yì
7258,免於,6,,13,6,19,ㄇㄧㄢˇ ㄩˊ,miǎn yú
7259,瞄,6,,13,2,15,ㄇㄧㄠˊ,miáo
7260,苗,6,,8,48,56,ㄇㄧㄠˊ,miáo
7261,渺小,6,,6,4,10,ㄇㄧㄠˇ ㄒㄧㄠˇ,miǎo xiǎo
7262,廟宇,6,,7,4,11,ㄇㄧㄠˋ ㄩˇ,miào yǔ
7263,滅絕,6,,8,14,22,ㄇㄧㄝˋ ㄐㄩㄝˊ,miè jué
7264,敏捷,6,,9,1,10,ㄇㄧㄣˇ ㄐㄧㄝˊ,mǐn jié
7265,民生,6,,9,26,35,ㄇㄧㄣˊ ㄕㄥ,mín shēng
7266,民俗,6,,10,10,20,ㄇㄧㄣˊ ㄙㄨˊ,mín sú
7267,民心,6,,8,6,14,ㄇㄧㄣˊ ㄒㄧㄣ,mín xīn
7268,民意,6,,9,10,19,ㄇㄧㄣˊ ㄧˋ,mín yì
7269,鳴,6,,21,7,28,ㄇㄧㄥˊ,míng
7270,命案,6,,8,2,10,ㄇㄧㄥˋ ㄢˋ,mìng àn
7271,名利,6,,9,4,13,ㄇㄧㄥˊ ㄌㄧˋ,míng lì
7272,明瞭,6,,13,2,15,ㄇㄧㄥˊ ㄌㄧㄠˇ,míng liǎo
7273,名氣,6,,11,4,15,ㄇㄧㄥˊ ㄑㄧˋ,míng qì
7274,名人,6,,17,6,23,ㄇㄧㄥˊ ㄖㄣˊ,míng rén
7275,名堂,6,,5,1,6,ㄇㄧㄥˊ ㄊㄤˊ,míng táng
7276,冥想,6,,10,1,11,ㄇㄧㄥˊ ㄒㄧㄤˇ,míng xiǎng
7277,名言,6,,10,4,14,ㄇㄧㄥˊ ㄧㄢˊ,míng yán
7278,名義,6,,22,6,28,ㄇㄧㄥˊ ㄧˋ,míng yì
7279,名譽,6,,10,1,11,ㄇㄧㄥˊ ㄩˋ,míng yù
7280,明智,6,,14,4,18,ㄇㄧㄥˊ ㄓˋ,míng zhì
7281,明知,6,,12,1,13,ㄇㄧㄥˊ ㄓ,míng zhī
7282,名著,6,,7,1,8,ㄇㄧㄥˊ ㄓㄨˋ,míng zhù
7283,莫,6,,43,14,57,ㄇㄛˋ,mò
7284,摩擦,6,,15,10,25,ㄇㄛˊ ㄘㄚ,mó cā
7285,莫大,6,,11,5,16,ㄇㄛˋ ㄉㄚˋ,mò dà
7286,末端,6,,5,7,12,ㄇㄛˋ ㄉㄨㄢ,mò duān
7287,魔法,6,,9,6,15,ㄇㄛˊ ㄈㄚˇ,mó fǎ
7288,模範,6,,7,8,15,ㄇㄛˊ ㄈㄢˋ,mó fàn
7289,莫非,6,,8,1,9,ㄇㄛˋ ㄈㄟ,mò fēi
7290,磨練,6,,11,11,22,ㄇㄛˊ ㄌㄧㄢˋ,mó liàn
7291,沒落,6,,7,13,20,ㄇㄛˋ ㄌㄨㄛˋ,mò luò
7292,莫名,6,,14,6,20,ㄇㄛˋ ㄇㄧㄥˊ,mò míng
7293,莫名其妙,6,,14,7,21,ㄇㄛˋ ㄇㄧㄥˊ ㄑㄧˊ ㄇㄧㄠˋ,mò míng qí miào
7294,模擬,6,,14,31,45,ㄇㄛˊ ㄋㄧˇ,mó nǐ
7295,默契,6,,9,13,22,ㄇㄛˋ ㄑㄧˋ,mò qì
7296,末日,6,,7,8,15,ㄇㄛˋ ㄖˋ,mò rì
7297,模式,6,,125,63,188,ㄇㄛˊ ㄕˋ,mó shì
7298,沒收,6,,8,3,11,ㄇㄛˋ ㄕㄡ,mò shōu
7299,墨水,6,,7,3,10,ㄇㄛˋ ㄕㄨㄟˇ,mò shuǐ
7300,摸索,6,,15,18,33,ㄇㄛ ㄙㄨㄛˇ,mō suǒ
7301,謀略,6,,10,2,12,ㄇㄡˊ ㄌㄩㄝˋ,móu lüè
7302,謀殺,6,,37,2,39,ㄇㄡˊ ㄕㄚ,móu shā
7303,謀生,6,,9,10,19,ㄇㄡˊ ㄕㄥ,móu shēng
7304,幕,6,,42,16,58,ㄇㄨˋ,mù
7305,木板,6,,13,9,22,ㄇㄨˋ ㄅㄢˇ,mù bǎn
7306,墓碑,6,,8,2,10,ㄇㄨˋ ㄅㄟ,mù bēi
7307,目不轉睛,6,,5,1,6,ㄇㄨˋ ㄅㄨˋ ㄓㄨㄢˇ ㄐㄧㄥ,mù bù zhuǎn jīng
7308,木材,6,,11,19,30,ㄇㄨˋ ㄘㄞˊ,mù cái
7309,目瞪口呆,6,,9,1,10,ㄇㄨˋ ㄉㄥˋ ㄎㄡˇ ㄉㄞ,mù dèng kǒu dāi
7310,墓地,6,,9,1,10,ㄇㄨˋ ㄉㄧˋ,mù dì
7311,目睹,6,,21,8,29,ㄇㄨˋ ㄉㄨˇ,mù dǔ
7312,幕後,6,,8,7,15,ㄇㄨˋ ㄏㄡˋ,mù hòu
7313,目擊,6,,7,5,12,ㄇㄨˋ ㄐㄧˊ,mù jí
7314,募款,6,,7,17,24,ㄇㄨˋ ㄎㄨㄢˇ,mù kuǎn
7315,幕僚,6,,8,1,9,ㄇㄨˋ ㄌㄧㄠˊ,mù liáo
7316,目錄,6,,10,2,12,ㄇㄨˋ ㄌㄨˋ,mù lù
7317,牧師,6,,40,26,66,ㄇㄨˋ ㄕ,mù shī
7318,沐浴,6,,7,4,11,ㄇㄨˋ ㄩˋ,mù yù
7319,拇指,6,,8,4,12,ㄇㄨˇ ㄓˇ,mǔ zhǐ
7320,吶喊,6,,9,3,12,ㄋㄚˋ ㄏㄢˇ,nà hǎn
7321,納悶,6,,13,3,16,ㄋㄚˋ ㄇㄣˋ,nà mèn
7322,乃是/乃,6,,185,11,196,ㄋㄞˇ ㄕˋ/ㄋㄞˇ,nǎi shì/nǎi
7323,乃至,6,,24,2,26,ㄋㄞˇ ㄓˋ,nǎi zhì
7324,難2,6,,307,415,722,ㄋㄢˋ,nàn
7325,難關,6,,13,12,25,ㄋㄢˊ ㄍㄨㄢ,nán guān
7326,難堪,6,,13,3,16,ㄋㄢˊ ㄎㄢ,nán kān
7327,難民,6,,7,122,129,ㄋㄢˋ ㄇㄧㄣˊ,nàn mín
7328,喃喃,6,,16,1,17,ㄋㄢˊ ㄋㄢˊ,nán nán
7329,喃喃自語,6,,8,1,9,ㄋㄢˊ ㄋㄢˊ ㄗˋ ㄩˇ,nán nán zì yǔ
7330,難以置信,6,,10,1,11,ㄋㄢˊ ㄧˇ ㄓˋ ㄒㄧㄣˋ,nán yǐ zhì xìn
7331,男子漢,6,,6,4,10,ㄋㄢˊ ㄗˇ ㄏㄢˋ,nán zǐ hàn
7332,腦海,6,,33,10,43,ㄋㄠˇ ㄏㄞˇ,nǎo hǎi
7333,鬧劇,6,,5,0,5,ㄋㄠˋ ㄐㄩˋ,nào jù
7334,惱怒,6,,8,1,9,ㄋㄠˇ ㄋㄨˋ,nǎo nù
7335,鬧事,6,,5,0,5,ㄋㄠˋ ㄕˋ,nào shì
7336,內側,6,,10,3,13,ㄋㄟˋ ㄘㄜˋ,nèi cè
7337,內地,6,,9,4,13,ㄋㄟˋ ㄉㄧˋ,nèi dì
7338,內閣,6,,29,7,36,ㄋㄟˋ ㄍㄜˊ,nèi gé
7339,內涵,6,,23,12,35,ㄋㄟˋ ㄏㄢˊ,nèi hán
7340,內建,6,,3,1,4,ㄋㄟˋ ㄐㄧㄢˋ,nèi jiàn
7341,內幕,6,,6,0,6,ㄋㄟˋ ㄇㄨˋ,nèi mù
7342,內情,6,,6,1,7,ㄋㄟˋ ㄑㄧㄥˊ,nèi qíng
7343,內臟,6,,9,5,14,ㄋㄟˋ ㄗㄤˋ,nèi zàng
7344,內戰,6,,11,91,102,ㄋㄟˋ ㄓㄢˋ,nèi zhàn
7345,嫩,6,,11,18,29,ㄋㄣˋ,nèn
7346,能耐,6,,8,0,8,ㄋㄥˊ ㄋㄞˋ,néng nài
7347,逆,6,,16,8,24,ㄋㄧˋ,nì
7348,擬,6,,20,2,22,ㄋㄧˇ,nǐ
7349,溺愛,6,,5,2,7,ㄋㄧˋ ㄞˋ,nì ài
7350,擬定,6,,14,3,17,ㄋㄧˇ ㄉㄧㄥˋ,nǐ dìng
7351,匿名,6,,5,0,5,ㄋㄧˋ ㄇㄧㄥˊ,nì míng
7352,逆轉,6,,8,5,13,ㄋㄧˋ ㄓㄨㄢˇ,nì zhuǎn
7353,年度,6,,15,14,29,ㄋㄧㄢˊ ㄉㄨˋ,nián dù
7354,年間,6,,15,1,16,ㄋㄧㄢˊ ㄐㄧㄢ,nián jiān
7355,年齡層,6,,6,4,10,ㄋㄧㄢˊ ㄌㄧㄥˊ ㄘㄥˊ,nián líng céng
7356,年邁,6,,5,5,10,ㄋㄧㄢˊ ㄇㄞˋ,nián mài
7357,念念不忘,6,,5,2,7,ㄋㄧㄢˋ ㄋㄧㄢˋ ㄅㄨˊ ㄨㄤˋ,niàn niàn bú wàng
7358,年少,6,,9,3,12,ㄋㄧㄢˊ ㄕㄠˋ,nián shào
7359,年頭,6,,12,9,21,ㄋㄧㄢˊ ㄊㄡˊ,nián tóu
7360,念頭,6,,51,27,78,ㄋㄧㄢˋ ˙ㄊㄡ,niàn tou
7361,捏,6,,14,12,26,ㄋㄧㄝ,niē
7362,捏造,6,,5,1,6,ㄋㄧㄝ ㄗㄠˋ,niē zào
7363,凝聚,6,,11,21,32,ㄋㄧㄥˊ ㄐㄩˋ,níng jù
7364,凝視,6,,23,1,24,ㄋㄧㄥˊ ㄕˋ,níng shì
7365,扭,6,,11,2,13,ㄋㄧㄡˇ,niǔ
7366,扭曲,6,,26,8,34,ㄋㄧㄡˇ ㄑㄩ,niǔ qū
7367,扭轉,6,,15,9,24,ㄋㄧㄡˇ ㄓㄨㄢˇ,niǔ zhuǎn
7368,濃厚,6,,13,13,26,ㄋㄨㄥˊ ㄏㄡˋ,nóng hòu
7369,濃密,6,,7,4,11,ㄋㄨㄥˊ ㄇㄧˋ,nóng mì
7370,濃縮,6,,5,10,15,ㄋㄨㄥˊ ㄙㄨㄛ,nóng suō
7371,濃郁,6,,6,4,10,ㄋㄨㄥˊ ㄩˋ,nóng yù
7372,怒吼,6,,6,1,7,ㄋㄨˋ ㄏㄡˇ,nù hǒu
7373,怒火,6,,11,3,14,ㄋㄨˋ ㄏㄨㄛˇ,nù huǒ
7374,女郎,6,,9,1,10,ㄋㄩˇ ㄌㄤˊ,nǚ láng
7375,奴隸,6,,28,3,31,ㄋㄨˊ ㄌㄧˋ,nú lì
7376,怒氣,6,,17,3,20,ㄋㄨˋ ㄑㄧˋ,nù qì
7377,女神,6,,13,6,19,ㄋㄩˇ ㄕㄣˊ,nǚ shén
7378,暖身,6,,3,2,5,ㄋㄨㄢˇ ㄕㄣ,nuǎn shēn
7379,挪,6,,5,2,7,ㄋㄨㄛˊ,nuó
7380,懦弱,6,,7,1,8,ㄋㄨㄛˋ ㄖㄨㄛˋ,nuò ruò
7381,諾言,6,,6,2,8,ㄋㄨㄛˋ ㄧㄢˊ,nuò yán
7382,毆打,6,,7,1,8,ㄡ ㄉㄚˇ,ōu dǎ
7383,嘔吐,6,,12,4,16,ㄡˇ ㄊㄨˋ,ǒu tù
7384,派兵,6,,7,3,10,ㄆㄞˋ ㄅㄧㄥ,pài bīng
7385,排行,6,,6,7,13,ㄆㄞˊ ㄏㄤˊ,pái háng
7386,徘徊,6,,11,6,17,ㄆㄞˊ ㄏㄨㄞˊ,pái huái
7387,排擠,6,,7,5,12,ㄆㄞˊ ㄐㄧˇ,pái jǐ
7388,拍馬屁,6,,3,1,4,ㄆㄞ ㄇㄚˇ ㄆㄧˋ,pāi mǎ pì
7389,拍賣,6,,8,8,16,ㄆㄞ ㄇㄞˋ,pāi mài
7390,排名,6,,15,17,32,ㄆㄞˊ ㄇㄧㄥˊ,pái míng
7391,派上用場,6,,5,4,9,ㄆㄞˋ ㄕㄤˋ ㄩㄥˋ ㄔㄤˊ,pài shàng yòng cháng
7392,派系,6,,8,7,15,ㄆㄞˋ ㄒㄧˋ,pài xì
7393,攀,6,,9,4,13,ㄆㄢ,pān
7394,叛變,6,,11,2,13,ㄆㄢˋ ㄅㄧㄢˋ,pàn biàn
7395,判定,6,,9,7,16,ㄆㄢˋ ㄉㄧㄥˋ,pàn dìng
7396,判決,6,,14,5,19,ㄆㄢˋ ㄐㄩㄝˊ,pàn jué
7397,叛亂,6,,11,3,14,ㄆㄢˋ ㄌㄨㄢˋ,pàn luàn
7398,叛逆,6,,15,6,21,ㄆㄢˋ ㄋㄧˋ,pàn nì
7399,盤算,6,,11,2,13,ㄆㄢˊ ㄙㄨㄢˋ,pán suàn
7400,盤旋,6,,10,3,13,ㄆㄢˊ ㄒㄩㄢˊ,pán xuán
7401,龐大,6,,41,37,78,ㄆㄤˊ ㄉㄚˋ,páng dà
7402,旁觀,6,,11,2,13,ㄆㄤˊ ㄍㄨㄢ,páng guān
7403,徬徨,6,,7,4,11,ㄆㄤˊ ㄏㄨㄤˊ,páng huáng
7404,旁人,6,,14,3,17,ㄆㄤˊ ㄖㄣˊ,páng rén
7405,旁聽,6,,4,0,4,ㄆㄤˊ ㄊㄧㄥ,páng tīng
7406,砲,6,,8,4,12,ㄆㄠˋ,pào
7407,拋,6,,15,6,21,ㄆㄠ,pāo
7408,炮,6,,9,3,12,ㄆㄠˊ / ㄅㄠ / ㄆㄠˋ,páo / bāo / pào
7409,泡沫,6,,12,7,19,ㄆㄠˋ ㄇㄛˋ,pào mò
7410,咆哮,6,,10,2,12,ㄆㄠˊ ㄒㄧㄠ,páo xiāo
7411,配備,6,,9,9,18,ㄆㄟˋ ㄅㄟˋ,pèi bèi
7412,賠償,6,,8,3,11,ㄆㄟˊ ㄔㄤˊ,péi cháng
7413,配對,6,,13,2,15,ㄆㄟˋ ㄉㄨㄟˋ,pèi duì
7414,培訓,6,,7,19,26,ㄆㄟˊ ㄒㄩㄣˋ,péi xùn
7415,配音,6,,2,1,3,ㄆㄟˋ ㄧㄣ,pèi yīn
7416,培育,6,,11,19,30,ㄆㄟˊ ㄩˋ,péi yù
7417,配樂,6,,8,1,9,ㄆㄟˋ ㄩㄝˋ,pèi yuè
7418,捧,6,,26,7,33,ㄆㄥˇ,pěng
7419,砰,6,,9,4,13,ㄆㄥ,pēng
7420,蓬勃,6,,8,10,18,ㄆㄥˊ ㄅㄛˊ,péng bó
7421,碰觸/觸碰,6,,16,6,22,ㄆㄥˋ ㄔㄨˋ,pèng chù
7422,抨擊,6,,9,5,14,ㄆㄥ ㄐㄧˊ,pēng jí
7423,烹飪,6,,6,7,13,ㄆㄥ ㄖㄣˋ,pēng rèn
7424,烹調,6,,6,17,23,ㄆㄥ ㄊㄧㄠˊ,pēng tiáo
7425,膨脹,6,,15,7,22,ㄆㄥˊ ㄓㄤˋ,péng zhàng
7426,碰撞,6,,7,15,22,ㄆㄥˋ ㄓㄨㄤˋ,pèng zhuàng
7427,劈,6,,10,3,13,ㄆㄧ,pī
7428,疲憊,6,,17,7,24,ㄆㄧˊ ㄅㄟˋ,pí bèi
7429,疲累,6,,9,4,13,ㄆㄧˊ ㄌㄟˋ,pí lèi
7430,批判,6,,35,3,38,ㄆㄧ ㄆㄢˋ,pī pàn
7431,批准,6,,11,9,20,ㄆㄧ ㄓㄨㄣˇ,pī zhǔn
7432,偏愛,6,,8,1,9,ㄆㄧㄢ ㄞˋ,piān ài
7433,偏差,6,,13,8,21,ㄆㄧㄢ ㄔㄚ,piān chā
7434,片段,6,,17,9,26,ㄆㄧㄢˋ ㄉㄨㄢˋ,piàn duàn
7435,篇幅,6,,12,7,19,ㄆㄧㄢ ㄈㄨˊ,piān fú
7436,偏好,6,,16,3,19,ㄆㄧㄢ ㄏㄠˋ,piān hào
7437,偏離,6,,9,2,11,ㄆㄧㄢ ㄌㄧˊ,piān lí
7438,偏僻,6,,7,9,16,ㄆㄧㄢ ㄆㄧˋ,piān pì
7439,偏偏,6,,26,10,36,ㄆㄧㄢ ㄆㄧㄢ,piān piān
7440,偏食,6,,2,4,6,ㄆㄧㄢ ㄕˊ,piān shí
7441,偏向,6,,9,7,16,ㄆㄧㄢ ㄒㄧㄤˋ,piān xiàng
7442,偏遠,6,,9,31,40,ㄆㄧㄢ ㄩㄢˇ,piān yuǎn
7443,漂,6,,4,12,16,ㄆㄧㄠ / ㄆㄧㄠˇ / ㄆㄧㄠˋ,piāo / piǎo / piào
7444,票房,6,,4,5,9,ㄆㄧㄠˋ ㄈㄤˊ,piào fáng
7445,漂浮,6,,5,5,10,ㄆㄧㄠ ㄈㄨˊ,piāo fú
7446,瞥見,6,,8,0,8,ㄆㄧㄝ ㄐㄧㄢˋ,piē jiàn
7447,品,6,,8,19,27,ㄆㄧㄣˇ,pǐn
7448,拼,6,,8,24,32,ㄆㄧㄣ,pīn
7449,頻道,6,,8,5,13,ㄆㄧㄣˊ ㄉㄠˋ,pín dào
7450,品德,6,,13,5,18,ㄆㄧㄣˇ ㄉㄜˊ,pǐn dé
7451,貧乏,6,,6,3,9,ㄆㄧㄣˊ ㄈㄚˊ,pín fá
7452,品格,6,,9,6,15,ㄆㄧㄣˇ ㄍㄜˊ,pǐn gé
7453,貧苦,6,,6,7,13,ㄆㄧㄣˊ ㄎㄨˇ,pín kǔ
7454,貧困,6,,10,39,49,ㄆㄧㄣˊ ㄎㄨㄣˋ,pín kùn
7455,頻頻,6,,11,8,19,ㄆㄧㄣˊ ㄆㄧㄣˊ,pín pín
7456,聘請,6,,10,5,15,ㄆㄧㄣˋ ㄑㄧㄥˇ,pìn qǐng
7457,品行,6,,5,1,6,ㄆㄧㄣˇ ㄒㄧㄥˋ,pǐn xìng
7458,聘用,6,,5,2,7,ㄆㄧㄣˋ ㄩㄥˋ,pìn yòng
7459,平淡,6,,6,3,9,ㄆㄧㄥˊ ㄉㄢˋ,píng dàn
7460,評斷,6,,7,3,10,ㄆㄧㄥˊ ㄉㄨㄢˋ,píng duàn
7461,平和,6,,10,8,18,ㄆㄧㄥˊ ㄏㄜˊ,píng hé
7462,憑藉,6,,11,7,18,ㄆㄧㄥˊ ㄐㄧㄝˋ,píng jiè
7463,瓶頸,6,,6,15,21,ㄆㄧㄥˊ ㄐㄧㄥˇ,píng jǐng
7464,平面,6,,12,9,21,ㄆㄧㄥˊ ㄇㄧㄢˋ,píng miàn
7465,平民,6,,16,12,28,ㄆㄧㄥˊ ㄇㄧㄣˊ,píng mín
7466,平台,6,,23,26,49,ㄆㄧㄥˊ ㄊㄞˊ,píng tái
7467,平坦,6,,12,9,21,ㄆㄧㄥˊ ㄊㄢˇ,píng tǎn
7468,平穩,6,,9,7,16,ㄆㄧㄥˊ ㄨㄣˇ,píng wěn
7469,平息,6,,11,8,19,ㄆㄧㄥˊ ㄒㄧˊ,píng xí
7470,平行,6,,12,6,18,ㄆㄧㄥˊ ㄒㄧㄥˊ,píng xíng
7471,評語,6,,10,2,12,ㄆㄧㄥˊ ㄩˇ,píng yǔ
7472,頗,6,,80,8,88,ㄆㄛˇ,pǒ
7473,迫不及待,6,,11,9,20,ㄆㄛˋ ㄅㄨˋ ㄐㄧˊ ㄉㄞˋ,pò bù jí dài
7474,破除,6,,5,3,8,ㄆㄛˋ ㄔㄨˊ,pò chú
7475,迫害,6,,12,7,19,ㄆㄛˋ ㄏㄞˋ,pò hài
7476,破解,6,,6,2,8,ㄆㄛˋ ㄐㄧㄝˇ,pò jiě
7477,破爛,6,,8,2,10,ㄆㄛˋ ㄌㄢˋ,pò làn
7478,魄力,6,,5,1,6,ㄆㄛˋ ㄌㄧˋ,pò lì
7479,破裂,6,,12,10,22,ㄆㄛˋ ㄌㄧㄝˋ,pò liè
7480,迫切,6,,13,5,18,ㄆㄛˋ ㄑㄧㄝˋ,pò qiè
7481,迫使,6,,16,10,26,ㄆㄛˋ ㄕˇ,pò shǐ
7482,破碎,6,,10,12,22,ㄆㄛˋ ㄙㄨㄟˋ,pò suì
7483,鋪2/舖2,6,,32,26,58,ㄆㄨˋ,pù
7484,譜,6,,15,9,24,ㄆㄨˇ,pǔ
7485,撲,6,,21,5,26,ㄆㄨ,pū
7486,鋪1/舖1,6,,32,26,58,ㄆㄨ ,pū
7487,曝光,6,,6,5,11,ㄆㄨˋ ㄍㄨㄤ,pù guāng
7488,普及,6,,15,16,31,ㄆㄨˇ ㄐㄧˊ,pǔ jí
7489,僕人,6,,23,1,24,ㄆㄨˊ ㄖㄣˊ,pú rén
7490,菩薩,6,,21,71,92,ㄆㄨˊ ㄙㄚˋ,pú sà
7491,樸實,6,,7,6,13,ㄆㄨˊ ㄕˊ,pú shí
7492,樸素,6,,5,3,8,ㄆㄨˊ ㄙㄨˋ,pú sù
7493,其,6,,886,93,979,ㄑㄧˊ,qí
7494,迄,6,,14,3,17,ㄑㄧˋ,qì
7495,豈,6,,15,0,15,ㄑㄧˇ,qǐ
7496,漆,6,,10,4,14,ㄑㄧ,qī
7497,起步,6,,9,9,18,ㄑㄧˇ ㄅㄨˋ,qǐ bù
7498,奇才,6,,5,1,6,ㄑㄧˊ ㄘㄞˊ,qí cái
7499,器材,6,,13,17,30,ㄑㄧˋ ㄘㄞˊ,qì cái
7500,啟程,6,,7,4,11,ㄑㄧˇ ㄔㄥˊ,qǐ chéng
7501,氣喘,6,,14,8,22,ㄑㄧˋ ㄔㄨㄢˇ,qì chuǎn
7502,祈禱,6,,28,28,56,ㄑㄧˊ ㄉㄠˇ,qí dǎo
7503,啟發,6,,36,39,75,ㄑㄧˇ ㄈㄚ,qǐ fā
7504,氣憤,6,,15,1,16,ㄑㄧˋ ㄈㄣˋ,qì fèn
7505,起伏,6,,21,12,33,ㄑㄧˇ ㄈㄨˊ,qǐ fú
7506,氣概,6,,8,1,9,ㄑㄧˋ ㄍㄞˋ,qì gài
7507,乞丐,6,,11,7,18,ㄑㄧˇ ㄍㄞˋ,qǐ gài
7508,漆黑,6,,14,3,17,ㄑㄧ ㄏㄟ,qī hēi
7509,其後,6,,20,2,22,ㄑㄧˊ ㄏㄡˋ,qí hòu
7510,氣呼呼,6,,3,1,4,ㄑㄧˋ ㄏㄨ ㄏㄨ,qì hū hū
7511,企畫/企劃,6,,10,10,20,ㄑㄧˋ ㄏㄨㄚˋ,qì huà
7512,起火,6,,5,5,10,ㄑㄧˇ ㄏㄨㄛˇ,qǐ huǒ
7513,契機,6,,11,11,22,ㄑㄧˋ ㄐㄧ,qì jī
7514,其間,6,,10,1,11,ㄑㄧˊ ㄐㄧㄢ,qí jiān
7515,起勁,6,,7,2,9,ㄑㄧˇ ㄐㄧㄣˋ,qǐ jìn
7516,起居,6,,9,7,16,ㄑㄧˇ ㄐㄩ,qǐ jū
7517,淒涼,6,,7,2,9,ㄑㄧ ㄌㄧㄤˊ,qī liáng
7518,啟蒙,6,,13,5,18,ㄑㄧˇ ㄇㄥˊ,qǐ méng
7519,氣餒,6,,6,3,9,ㄑㄧˋ ㄋㄟˇ,qì něi
7520,氣派,6,,5,2,7,ㄑㄧˋ ㄆㄞˋ,qì pài
7521,期盼,6,,12,18,30,ㄑㄧˊ ㄆㄢˋ,qí pàn
7522,祈求,6,,14,19,33,ㄑㄧˊ ㄑㄧㄡˊ,qí qiú
7523,齊全,6,,5,2,7,ㄑㄧˊ ㄑㄩㄢˊ,qí quán
7524,棄權,6,,1,1,2,ㄑㄧˋ ㄑㄩㄢˊ,qì quán
7525,氣色,6,,4,1,5,ㄑㄧˋ ㄙㄜˋ,qì sè
7526,騎士,6,,14,4,18,ㄑㄧˊ ㄕˋ,qí shì
7527,氣勢,6,,15,6,21,ㄑㄧˋ ㄕˋ,qì shì
7528,啟示,6,,18,9,27,ㄑㄧˇ ㄕˋ,qǐ shì
7529,起訴,6,,6,2,8,ㄑㄧˇ ㄙㄨˋ,qǐ sù
7530,氣體,6,,11,47,58,ㄑㄧˋ ㄊㄧˇ,qì tǐ
7531,企圖,6,,47,16,63,ㄑㄧˋ ㄊㄨˊ,qì tú
7532,欺侮,6,,5,0,5,ㄑㄧ ㄨˇ,qī wǔ
7533,氣息,6,,22,14,36,ㄑㄧˋ ㄒㄧˊ,qì xí
7534,旗下,6,,11,4,15,ㄑㄧˊ ㄒㄧㄚˋ,qí xià
7535,起先,6,,9,3,12,ㄑㄧˇ ㄒㄧㄢ,qǐ xiān
7536,期許,6,,9,17,26,ㄑㄧˊ ㄒㄩˇ,qí xǔ
7537,起源,6,,13,9,22,ㄑㄧˇ ㄩㄢˊ,qǐ yuán
7538,契約,6,,15,3,18,ㄑㄧˋ ㄩㄝ,qì yuē
7539,旗幟,6,,9,5,14,ㄑㄧˊ ㄓˋ,qí zhì
7540,棋子,6,,5,1,6,ㄑㄧˊ ㄗˇ,qí zǐ
7541,七嘴八舌,6,,4,1,5,ㄑㄧ ㄗㄨㄟˇ ㄅㄚ ㄕㄜˊ,qī zuǐ bā shé
7542,齊,6,,33,22,55,ㄑㄧˊ/ㄗ,qí/zī
7543,恰到好處,6,,5,1,6,ㄑㄧㄚˋ ㄉㄠˋ ㄏㄠˇ ㄔㄨˋ,qià dào hǎo chù
7544,恰好,6,,16,3,19,ㄑㄧㄚˋ ㄏㄠˇ,qià hǎo
7545,恰恰,6,,13,1,14,ㄑㄧㄚˋ ㄑㄧㄚˋ,qià qià
7546,恰巧,6,,8,1,9,ㄑㄧㄚˋ ㄑㄧㄠˇ,qià qiǎo
7547,洽商,6,,1,1,2,ㄑㄧㄚˋ ㄕㄤ,qià shāng
7548,洽談,6,,2,1,3,ㄑㄧㄚˋ ㄊㄢˊ,qià tán
7549,千變萬化,6,,3,2,5,ㄑㄧㄢ ㄅㄧㄢˋ ㄨㄢˋ ㄏㄨㄚˋ,qiān biàn wàn huà
7550,潛藏,6,,9,4,13,ㄑㄧㄢˊ ㄘㄤˊ,qián cáng
7551,前程,6,,10,1,11,ㄑㄧㄢˊ ㄔㄥˊ,qián chéng
7552,虔誠,6,,15,26,41,ㄑㄧㄢˊ ㄔㄥˊ,qián chéng
7553,簽訂,6,,12,9,21,ㄑㄧㄢ ㄉㄧㄥˋ,qiān dìng
7554,前額,6,,14,2,16,ㄑㄧㄢˊ ㄜˊ,qián é
7555,千古,6,,12,3,15,ㄑㄧㄢ ㄍㄨˇ,qiān gǔ
7556,千金,6,,7,3,10,ㄑㄧㄢ ㄐㄧㄣ,qiān jīn
7557,前景,6,,11,6,17,ㄑㄧㄢˊ ㄐㄧㄥˇ,qián jǐng
7558,前科,6,,2,1,3,ㄑㄧㄢˊ ㄎㄜ,qián kē
7559,牽連,6,,9,3,12,ㄑㄧㄢ ㄌㄧㄢˊ,qiān lián
7560,潛能,6,,27,10,37,ㄑㄧㄢˊ ㄋㄥˊ,qián néng
7561,前傾,6,,8,0,8,ㄑㄧㄢˊ ㄑㄧㄥ,qián qīng
7562,欠缺,6,,16,8,24,ㄑㄧㄢˋ ㄑㄩㄝ,qiàn quē
7563,前人,6,,8,7,15,ㄑㄧㄢˊ ㄖㄣˊ,qián rén
7564,牽涉,6,,7,3,10,ㄑㄧㄢ ㄕㄜˋ,qiān shè
7565,前身,6,,7,1,8,ㄑㄧㄢˊ ㄕㄣ,qián shēn
7566,前述,6,,15,1,16,ㄑㄧㄢˊ ㄕㄨˋ,qián shù
7567,簽署,6,,6,16,22,ㄑㄧㄢ ㄕㄨˋ,qiān shù
7568,潛水,6,,6,16,22,ㄑㄧㄢˊ ㄕㄨㄟˇ,qián shuǐ
7569,前提,6,,23,13,36,ㄑㄧㄢˊ ㄊㄧˊ,qián tí
7570,前夕,6,,11,7,18,ㄑㄧㄢˊ ㄒㄧˋ,qián xì
7571,前線,6,,16,4,20,ㄑㄧㄢˊ ㄒㄧㄢˋ,qián xiàn
7572,千辛萬苦,6,,3,6,9,ㄑㄧㄢ ㄒㄧㄣ ㄨㄢˋ ㄎㄨˇ,qiān xīn wàn kǔ
7573,前言,6,,8,1,9,ㄑㄧㄢˊ ㄧㄢˊ,qián yán
7574,歉意,6,,7,1,8,ㄑㄧㄢˋ ㄧˋ,qiàn yì
7575,潛意識,6,,25,2,27,ㄑㄧㄢˊ ㄧˋ ㄕˋ,qián yì shì
7576,潛在,6,,26,10,36,ㄑㄧㄢˊ ㄗㄞˋ,qián zài
7577,譴責,6,,12,14,26,ㄑㄧㄢˇ ㄗㄜˊ,qiǎn zé
7578,前者,6,,26,1,27,ㄑㄧㄢˊ ㄓㄜˇ,qián zhě
7579,牽制,6,,7,4,11,ㄑㄧㄢ ㄓˋ,qiān zhì
7580,腔,6,,12,7,19,ㄑㄧㄤ,qiāng
7581,腔調,6,,5,2,7,ㄑㄧㄤ ㄉㄧㄠˋ,qiāng diào
7582,強悍,6,,7,4,11,ㄑㄧㄤˊ ㄏㄢˋ,qiáng hàn
7583,搶劫,6,,10,4,14,ㄑㄧㄤˇ ㄐㄧㄝˊ,qiǎng jié
7584,搶救,6,,7,33,40,ㄑㄧㄤˇ ㄐㄧㄡˋ,qiǎng jiù
7585,強力,6,,12,10,22,ㄑㄧㄤˊ ㄌㄧˋ,qiáng lì
7586,強盛,6,,5,3,8,ㄑㄧㄤˊ ㄕㄥˋ,qiáng shèng
7587,強勢,6,,11,9,20,ㄑㄧㄤˊ ㄕˋ,qiáng shì
7588,搶先,6,,8,2,10,ㄑㄧㄤˇ ㄒㄧㄢ,qiǎng xiān
7589,強行,6,,8,3,11,ㄑㄧㄤˇ ㄒㄧㄥˊ,qiǎng xíng
7590,強硬,6,,8,16,24,ㄑㄧㄤˊ ㄧㄥˋ,qiáng yìng
7591,強制,6,,13,8,21,ㄑㄧㄤˇ ㄓˋ,qiǎng zhì
7592,瞧不起,6,,8,3,11,ㄑㄧㄠˊ ㄅㄨˋ ㄑㄧˇ,qiáo bù qǐ
7593,憔悴,6,,7,2,9,ㄑㄧㄠˊ ㄘㄨㄟˋ,qiáo cuì
7594,敲打,6,,8,4,12,ㄑㄧㄠ ㄉㄚˇ,qiāo dǎ
7595,巧合,6,,16,7,23,ㄑㄧㄠˇ ㄏㄜˊ,qiǎo hé
7596,翹課,6,,2,4,6,ㄑㄧㄠˋㄎㄜˋ,qiào kè
7597,俏麗,6,,1,1,2,ㄑㄧㄠˋ ㄌㄧˋ,qiào lì
7598,橋樑/橋梁,6,,11,39,50,ㄑㄧㄠˊ ㄌㄧㄤˊ,qiáo liáng
7599,翹,6,,11,6,17,ㄑㄧㄠˊ/ㄑㄧㄠˋ,qiáo/qiào
7600,切除,6,,8,4,12,ㄑㄧㄝ ㄔㄨˊ,qiē chú
7601,切斷,6,,12,7,19,ㄑㄧㄝ ㄉㄨㄢˋ,qiē duàn
7602,切記,6,,5,2,7,ㄑㄧㄝˋ ㄐㄧˋ,qiè jì
7603,切片,6,,7,6,13,ㄑㄧㄝ ㄆㄧㄢˋ,qiē piàn
7604,親筆,6,,6,2,8,ㄑㄧㄣ ㄅㄧˇ,qīn bǐ
7605,侵犯,6,,17,8,25,ㄑㄧㄣ ㄈㄢˋ,qīn fàn
7606,勤奮,6,,13,7,20,ㄑㄧㄣˊ ㄈㄣˋ,qín fèn
7607,侵害,6,,8,4,12,ㄑㄧㄣ ㄏㄞˋ,qīn hài
7608,勤快,6,,5,3,8,ㄑㄧㄣˊ ㄎㄨㄞˋ,qín kuài
7609,勤勞,6,,14,10,24,ㄑㄧㄣˊ ㄌㄠˊ,qín láo
7610,侵略,6,,16,9,25,ㄑㄧㄣ ㄌㄩㄝˋ,qīn lüè
7611,欽佩,6,,8,2,10,ㄑㄧㄣ ㄆㄟˋ,qīn pèi
7612,侵入,6,,8,4,12,ㄑㄧㄣ ㄖㄨˋ,qīn rù
7613,親生,6,,13,5,18,ㄑㄧㄣ ㄕㄥ,qīn shēng
7614,親吻,6,,12,3,15,ㄑㄧㄣ ㄨㄣˇ,qīn wěn
7615,侵襲,6,,5,39,44,ㄑㄧㄣ ㄒㄧˊ,qīn xí
7616,親信,6,,10,2,12,ㄑㄧㄣ ㄒㄧㄣˋ,qīn xìn
7617,青,6,,27,31,58,ㄑㄧㄥ,qīng
7618,清白,6,,8,1,9,ㄑㄧㄥ ㄅㄞˊ,qīng bái
7619,情操,6,,8,3,11,ㄑㄧㄥˊ ㄘㄠ,qíng cāo
7620,清澈,6,,8,11,19,ㄑㄧㄥ ㄔㄜˋ,qīng chè
7621,清除,6,,13,16,29,ㄑㄧㄥ ㄔㄨˊ,qīng chú
7622,請辭,6,,2,2,4,ㄑㄧㄥˇ ㄘˊ,qǐng cí
7623,清脆,6,,6,4,10,ㄑㄧㄥ ㄘㄨㄟˋ,qīng cuì
7624,清單,6,,15,4,19,ㄑㄧㄥ ㄉㄢ,qīng dān
7625,慶典,6,,6,10,16,ㄑㄧㄥˋ ㄉㄧㄢˇ,qìng diǎn
7626,輕而易舉,6,,6,1,7,ㄑㄧㄥ ㄦˊ ㄧˋ ㄐㄩˇ,qīng ér yì jǔ
7627,慶賀,6,,5,1,6,ㄑㄧㄥˋ ㄏㄜˋ,qìng hè
7628,情結,6,,9,1,10,ㄑㄧㄥˊ ㄐㄧㄝˊ,qíng jié
7629,情境,6,,92,16,108,ㄑㄧㄥˊ ㄐㄧㄥˋ,qíng jìng
7630,清淨,6,,9,25,34,ㄑㄧㄥ ㄐㄧㄥˋ,qīng jìng
7631,清靜,6,,5,2,7,ㄑㄧㄥ ㄐㄧㄥˋ,qīng jìng
7632,輕快,6,,10,2,12,ㄑㄧㄥ ㄎㄨㄞˋ,qīng kuài
7633,青睞,6,,7,5,12,ㄑㄧㄥ ㄌㄞˋ,qīng lài
7634,情趣,6,,8,2,10,ㄑㄧㄥˊ ㄑㄩˋ,qíng qù
7635,輕柔,6,,9,3,12,ㄑㄧㄥ ㄖㄡˊ,qīng róu
7636,青山,6,,8,4,12,ㄑㄧㄥ ㄕㄢ,qīng shān
7637,輕視,6,,10,1,11,ㄑㄧㄥ ㄕˋ,qīng shì
7638,情書,6,,4,4,8,ㄑㄧㄥˊ ㄕㄨ,qíng shū
7639,輕率,6,,5,1,6,ㄑㄧㄥ ㄕㄨㄞˋ,qīng shuài
7640,清爽,6,,6,7,13,ㄑㄧㄥ ㄕㄨㄤˇ,qīng shuǎng
7641,傾訴,6,,9,1,10,ㄑㄧㄥ ㄙㄨˋ,qīng sù
7642,傾聽,6,,47,11,58,ㄑㄧㄥ ㄊㄧㄥ,qīng tīng
7643,清晰,6,,36,7,43,ㄑㄧㄥ ㄒㄧ,qīng xī
7644,傾向,6,,48,10,58,ㄑㄧㄥ ㄒㄧㄤˋ,qīng xiàng
7645,清香,6,,6,8,14,ㄑㄧㄥ ㄒㄧㄤ,qīng xiāng
7646,傾斜,6,,9,12,21,ㄑㄧㄥ ㄒㄧㄝˊ,qīng xié
7647,清新,6,,10,7,17,ㄑㄧㄥ ㄒㄧㄣ,qīng xīn
7648,慶幸,6,,12,5,17,ㄑㄧㄥˋ ㄒㄧㄥˋ,qìng xìng
7649,情誼,6,,9,6,15,ㄑㄧㄥˊ ㄧˋ,qíng yì
7650,輕易,6,,39,15,54,ㄑㄧㄥ ㄧˋ,qīng yì
7651,情願,6,,11,3,14,ㄑㄧㄥˊ ㄩㄢˋ,qíng yuàn
7652,輕重,6,,6,1,7,ㄑㄧㄥ ㄓㄨㄥˋ,qīng zhòng
7653,窮苦,6,,8,4,12,ㄑㄩㄥˊ ㄎㄨˇ,qióng kǔ
7654,窮困,6,,8,9,17,ㄑㄩㄥˊ ㄎㄨㄣˋ,qióng kùn
7655,囚犯,6,,12,3,15,ㄑㄧㄡˊ ㄈㄢˋ,qiú fàn
7656,囚禁,6,,9,2,11,ㄑㄧㄡˊ ㄐㄧㄣˋ,qiú jìn
7657,求救,6,,9,5,14,ㄑㄧㄡˊ ㄐㄧㄡˋ,qiú jiù
7658,求情,6,,5,1,6,ㄑㄧㄡˊ ㄑㄧㄥˊ,qiú qíng
7659,求生,6,,11,9,20,ㄑㄧㄡˊ ㄕㄥ,qiú shēng
7660,求援,6,,6,2,8,ㄑㄧㄡˊ ㄩㄢˊ,qiú yuán
7661,求助,6,,15,9,24,ㄑㄧㄡˊ ㄓㄨˋ,qiú zhù
7662,趨,6,,10,4,14,ㄑㄩ,qū
7663,去除,6,,16,14,30,ㄑㄩˋ ㄔㄨˊ,qù chú
7664,取締,6,,5,1,6,ㄑㄩˇ ㄉㄧˋ,qǔ dì
7665,驅動,6,,7,5,12,ㄑㄩ ㄉㄨㄥˋ,qū dòng
7666,取而代之,6,,7,3,10,ㄑㄩˇ ㄦˊ ㄉㄞˋ ㄓ,qǔ ér dài zhī
7667,屈服,6,,11,2,13,ㄑㄩ ㄈㄨˊ,qū fú
7668,區隔,6,,7,5,12,ㄑㄩ ㄍㄜˊ,qū gé
7669,取決,6,,17,5,22,ㄑㄩˇ ㄐㄩㄝˊ,qǔ jué
7670,去路,6,,5,0,5,ㄑㄩˋ ㄌㄨˋ,qù lù
7671,取名,6,,9,6,15,ㄑㄩˇ ㄇㄧㄥˊ,qǔ míng
7672,區區,6,,5,2,7,ㄑㄩ ㄑㄩ,qū qū
7673,取捨,6,,6,3,9,ㄑㄩˇ ㄕㄜˇ,qǔ shě
7674,取勝,6,,9,1,10,ㄑㄩˇ ㄕㄥˋ,qǔ shèng
7675,趨勢,6,,38,40,78,ㄑㄩ ㄕˋ,qū shì
7676,驅使,6,,12,2,14,ㄑㄩ ㄕˇ,qū shǐ
7677,軀體,6,,8,1,9,ㄑㄩ ㄊㄧˇ,qū tǐ
7678,趣味,6,,14,9,23,ㄑㄩˋ ㄨㄟˋ,qù wèi
7679,曲線,6,,21,4,25,ㄑㄩ ㄒㄧㄢˋ,qū xiàn
7680,取向,6,,21,3,24,ㄑㄩˇ ㄒㄧㄤˋ,qǔ xiàng
7681,取笑,6,,7,3,10,ㄑㄩˇ ㄒㄧㄠˋ,qǔ xiào
7682,取悅,6,,7,1,8,ㄑㄩˇ ㄩㄝˋ,qǔ yuè
7683,曲折,6,,11,4,15,ㄑㄩ ㄓㄜˊ,qū zhé
7684,驅逐,6,,9,6,15,ㄑㄩ ㄓㄨˊ,qū zhú
7685,取自,6,,5,2,7,ㄑㄩˇ ㄗˋ,qǔ zì
7686,犬,6,,23,15,38,ㄑㄩㄢˇ,quǎn
7687,全方位,6,,5,4,9,ㄑㄩㄢˊ ㄈㄤ ㄨㄟˋ,quán fāng wèi
7688,全集,6,,10,1,11,ㄑㄩㄢˊ ㄐㄧˊ,quán jí
7689,全盤,6,,6,1,7,ㄑㄩㄢˊ ㄆㄢˊ,quán pán
7690,全權,6,,7,1,8,ㄑㄩㄢˊ ㄑㄩㄢˊ,quán quán
7691,全神貫注,6,,9,2,11,ㄑㄩㄢˊ ㄕㄣˊ ㄍㄨㄢˋ ㄓㄨˋ,quán shén guàn zhù
7692,詮釋,6,,33,37,70,ㄑㄩㄢˊ ㄕˋ,quán shì
7693,泉水/泉,6,,22,12,34,ㄑㄩㄢˊ ㄕㄨㄟˇ/ㄑㄩㄢˊ,quán shuǐ/quán
7694,勸說,6,,8,4,12,ㄑㄩㄢˋ ㄕㄨㄛ,quàn shuō
7695,權威,6,,41,8,49,ㄑㄩㄢˊ ㄨㄟ,quán wēi
7696,權益,6,,12,11,23,ㄑㄩㄢˊ ㄧˋ,quán yì
7697,痊癒,6,,27,5,32,ㄑㄩㄢˊ ㄩˋ,quán yù
7698,圈子,6,,13,1,14,ㄑㄩㄢ ˙ㄗ,quān zi
7699,勸阻,6,,6,2,8,ㄑㄩㄢˋ ㄗㄨˇ,quàn zǔ
7700,確切,6,,20,8,28,ㄑㄩㄝˋ ㄑㄧㄝˋ,què qiè
7701,燃料,6,,7,34,41,ㄖㄢˊ ㄌㄧㄠˋ,rán liào
7702,燃起,6,,7,4,11,ㄖㄢˊ ㄑㄧˇ,rán qǐ
7703,嚷,6,,12,0,12,ㄖㄤˇ,rǎng
7704,讓步,6,,11,7,18,ㄖㄤˋ ㄅㄨˋ,ràng bù
7705,饒,6,,10,3,13,ㄖㄠˊ,ráo
7706,擾亂,6,,8,4,12,ㄖㄠˇ ㄌㄨㄢˋ,rǎo luàn
7707,惹,6,,25,7,32,ㄖㄜˇ,rě
7708,熱潮,6,,6,5,11,ㄖㄜˋ ㄔㄠˊ,rè cháo
7709,熱忱,6,,10,11,21,ㄖㄜˋ ㄔㄣˊ,rè chén
7710,熱切,6,,12,2,14,ㄖㄜˋ ㄑㄧㄝˋ,rè qiè
7711,熱血,6,,8,7,15,ㄖㄜˋ ㄒㄧㄝˇ,rè xiě
7712,熱中/熱衷,6,,14,6,20,ㄖㄜˋ ㄓㄨㄥ,rè zhōng
7713,仁,6,,9,7,16,ㄖㄣˊ,rén
7714,仁慈,6,,12,1,13,ㄖㄣˊ ㄘˊ,rén cí
7715,人次,6,,3,9,12,ㄖㄣˊ ㄘˋ,rén cì
7716,人道,6,,9,37,46,ㄖㄣˊ ㄉㄠˋ,rén dào
7717,任教,6,,14,6,20,ㄖㄣˋ ㄐㄧㄠˋ,rèn jiào
7718,認可,6,,15,5,20,ㄖㄣˋ ㄎㄜˇ,rèn kě
7719,人馬,6,,17,5,22,ㄖㄣˊ ㄇㄚˇ,rén mǎ
7720,人脈,6,,9,3,12,ㄖㄣˊ ㄇㄞˋ,rén mài
7721,人命,6,,7,4,11,ㄖㄣˊ ㄇㄧㄥˋ,rén mìng
7722,任命,6,,21,5,26,ㄖㄣˋ ㄇㄧㄥˋ,rèn mìng
7723,任憑,6,,8,2,10,ㄖㄣˋ ㄆㄧㄥˊ,rèn píng
7724,任期,6,,4,9,13,ㄖㄣˋ ㄑㄧˊ,rèn qí
7725,人情,6,,15,4,19,ㄖㄣˊ ㄑㄧㄥˊ,rén qíng
7726,認清,6,,15,1,16,ㄖㄣˋ ㄑㄧㄥ,rèn qīng
7727,人群,6,,38,17,55,ㄖㄣˊ ㄑㄩㄣˊ,rén qún
7728,人身,6,,5,3,8,ㄖㄣˊ ㄕㄣ,rén shēn
7729,人世,6,,14,7,21,ㄖㄣˊ ㄕˋ,rén shì
7730,人手,6,,7,8,15,ㄖㄣˊ ㄕㄡˇ,rén shǒu
7731,認輸,6,,4,2,6,ㄖㄣˋ ㄕㄨ,rèn shū
7732,忍痛,6,,3,2,5,ㄖㄣˇ ㄊㄨㄥˋ,rěn tòng
7733,人頭,6,,9,1,10,ㄖㄣˊ ㄊㄡˊ,rén tóu
7734,人為,6,,12,34,46,ㄖㄣˊ ㄨㄟˊ,rén wéi
7735,人文,6,,25,92,117,ㄖㄣˊ ㄨㄣˊ,rén wén
7736,忍無可忍,6,,4,1,5,ㄖㄣˇ ㄨˊ ㄎㄜˇ ㄖㄣˇ,rěn wú kě rěn
7737,忍心,6,,9,10,19,ㄖㄣˇ ㄒㄧㄣ,rěn xīn
7738,任性,6,,9,3,12,ㄖㄣˋ ㄒㄧㄥˋ,rèn xìng
7739,韌性,6,,5,7,12,ㄖㄣˋ ㄒㄧㄥˋ,rèn xìng
7740,仁義,6,,8,3,11,ㄖㄣˊ ㄧˋ,rén yì
7741,任意,6,,14,1,15,ㄖㄣˋ ㄧˋ,rèn yì
7742,人影,6,,13,1,14,ㄖㄣˊ ㄧㄥˇ,rén yǐng
7743,任用,6,,9,1,10,ㄖㄣˋ ㄩㄥˋ,rèn yòng
7744,任由,6,,9,3,12,ㄖㄣˋ ㄧㄡˊ,rèn yóu
7745,人造,6,,10,18,28,ㄖㄣˊ ㄗㄠˋ,rén zào
7746,人質,6,,10,4,14,ㄖㄣˊ ㄓˋ,rén zhì
7747,任職,6,,16,7,23,ㄖㄣˋ ㄓˊ,rèn zhí
7748,認知,6,,104,26,130,ㄖㄣˋ ㄓ,rèn zhī
7749,日漸,6,,15,8,23,ㄖˋ ㄐㄧㄢˋ,rì jiàn
7750,日趨,6,,6,2,8,ㄖˋ ㄑㄩ,rì qū
7751,冗長,6,,6,2,8,ㄖㄨㄥˇ ㄔㄤˊ,rǒng cháng
7752,容貌,6,,9,2,11,ㄖㄨㄥˊ ㄇㄠˋ,róng mào
7753,容納,6,,10,11,21,ㄖㄨㄥˊ ㄋㄚˋ,róng nà
7754,容器,6,,8,13,21,ㄖㄨㄥˊ ㄑㄧˋ,róng qì
7755,融洽,6,,8,6,14,ㄖㄨㄥˊ ㄑㄧㄚˋ,róng qià
7756,容忍,6,,18,3,21,ㄖㄨㄥˊ ㄖㄣˇ,róng rěn
7757,榮幸,6,,7,15,22,ㄖㄨㄥˊ ㄒㄧㄥˋ,róng xìng
7758,容許,6,,16,4,20,ㄖㄨㄥˊ ㄒㄩˇ,róng xǔ
7759,榮耀,6,,15,8,23,ㄖㄨㄥˊ ㄧㄠˋ,róng yào
7760,榮譽,6,,16,8,24,ㄖㄨㄥˊ ㄩˋ,róng yù
7761,柔和,6,,12,3,15,ㄖㄡˊ ㄏㄜˊ,róu hé
7762,入超,6,,1,0,1,ㄖㄨˋ ㄔㄠ,rù chāo
7763,入關,6,,14,0,14,ㄖㄨˋ ㄍㄨㄢ,rù guān
7764,儒家,6,,29,4,33,ㄖㄨˊ ㄐㄧㄚ,rú jiā
7765,入門,6,,7,7,14,ㄖㄨˋ ㄇㄣˊ,rù mén
7766,如期,6,,4,5,9,ㄖㄨˊ ㄑㄧˊ,rú qí
7767,入侵,6,,17,28,45,ㄖㄨˋ ㄑㄧㄣ,rù qīn
7768,入睡,6,,18,3,21,ㄖㄨˋ ㄕㄨㄟˋ,rù shuì
7769,入圍,6,,2,2,4,ㄖㄨˋ ㄨㄟˊ,rù wéi
7770,入獄,6,,9,3,12,ㄖㄨˋ ㄩˋ,rù yù
7771,如願,6,,5,3,8,ㄖㄨˊ ㄩㄢˋ,rú yuàn
7772,瑞典,6,,10,30,40,ㄖㄨㄟˋ ㄉㄧㄢˇ,ruì diǎn
7773,銳利,6,,9,2,11,ㄖㄨㄟˋ ㄌㄧˋ,ruì lì
7774,若非,6,,7,2,9,ㄖㄨㄛˋ ㄈㄟ,ruò fēi
7775,若干,6,,25,3,28,ㄖㄨㄛˋ ㄍㄢ,ruò gān
7776,弱勢,6,,13,39,52,ㄖㄨㄛˋ ㄕˋ,ruò shì
7777,若無其事,6,,5,0,5,ㄖㄨㄛˋ ㄨˊ ㄑㄧˊ ㄕˋ,ruò wú qí shì
7778,若有所思,6,,9,0,9,ㄖㄨㄛˋ ㄧㄡˇ ㄙㄨㄛˇ ㄙ,ruò yǒu suǒ sī
7779,撒1,6,,23,22,45,ㄙㄚˇ,sǎ
7780,灑,6,,16,50,66,ㄙㄚˇ,sǎ
7781,撒2,6,,23,22,45,ㄙㄚ,sā
7782,撒謊,6,,8,1,9,ㄙㄚ ㄏㄨㄤˇ,sā huǎng
7783,散2,6,,29,20,49,ㄙㄢˇ,sǎn
7784,散播,6,,6,12,18,ㄙㄢˋ ㄅㄛˋ,sàn bò
7785,散布/散佈,6,,12,8,20,ㄙㄢˋ ㄅㄨˋ,sàn bù
7786,三更半夜,6,,3,4,7,ㄙㄢ ㄍㄥ ㄅㄢˋ ㄧㄝˋ,sān gēng bàn yè
7787,散落,6,,7,4,11,ㄙㄢˋ ㄌㄨㄛˋ,sàn luò
7788,散文,6,,11,4,15,ㄙㄢˇ ㄨㄣˊ,sǎn wén
7789,三言兩語,6,,3,1,4,ㄙㄢ ㄧㄢˊ ㄌㄧㄤˇ ㄩˇ,sān yán liǎng yǔ
7790,喪禮,6,,6,1,7,ㄙㄤ ㄌㄧˇ,sāng lǐ
7791,嗓門,6,,8,1,9,ㄙㄤˇ ㄇㄣˊ,sǎng mén
7792,喪生,6,,5,12,17,ㄙㄤˋ ㄕㄥ,sàng shēng
7793,喪失,6,,32,14,46,ㄙㄤˋ ㄕ,sàng shī
7794,喪事,6,,5,2,7,ㄙㄤ ㄕˋ,sāng shì
7795,嗓音,6,,9,2,11,ㄙㄤˇ ㄧㄣ,sǎng yīn
7796,嗓子,6,,10,3,13,ㄙㄤˇ ˙ㄗ,sǎng zi
7797,騷動,6,,13,1,14,ㄙㄠ ㄉㄨㄥˋ,sāo dòng
7798,掃描,6,,15,13,28,ㄙㄠˇ ㄇㄧㄠˊ,sǎo miáo
7799,騷擾,6,,8,1,9,ㄙㄠ ㄖㄠˇ,sāo rǎo
7800,啥,6,,67,7,74,ㄕㄚˊ,shá
7801,煞車,6,,8,9,17,ㄕㄚ ㄔㄜ,shā chē
7802,殺手,6,,13,10,23,ㄕㄚ ㄕㄡˇ,shā shǒu
7803,傻笑,6,,3,1,4,ㄕㄚˇ ㄒㄧㄠˋ,shǎ xiào
7804,沙啞,6,,5,2,7,ㄕㄚ ㄧㄚˇ,shā yǎ
7805,篩選,6,,8,11,19,ㄕㄞ ㄒㄩㄢˇ,shāi xuǎn
7806,擅長,6,,29,10,39,ㄕㄢˋ ㄔㄤˊ,shàn cháng
7807,刪除,6,,7,3,10,ㄕㄢ ㄔㄨˊ,shān chú
7808,閃電,6,,14,8,22,ㄕㄢˇ ㄉㄧㄢˋ,shǎn diàn
7809,山洞,6,,11,3,14,ㄕㄢ ㄉㄨㄥˋ,shān dòng
7810,善惡,6,,6,2,8,ㄕㄢˋ ㄜˋ,shàn è
7811,山峰,6,,9,3,12,ㄕㄢ ㄈㄥ,shān fēng
7812,閃光,6,,7,1,8,ㄕㄢˇ ㄍㄨㄤ,shǎn guāng
7813,閃亮,6,,10,5,15,ㄕㄢˇ ㄌㄧㄤˋ,shǎn liàng
7814,山林,6,,14,18,32,ㄕㄢ ㄌㄧㄣˊ,shān lín
7815,山脈,6,,13,32,45,ㄕㄢ ㄇㄞˋ,shān mài
7816,山丘,6,,10,5,15,ㄕㄢ ㄑㄧㄡ,shān qiū
7817,閃閃,6,,16,4,20,ㄕㄢˇ ㄕㄢˇ,shǎn shǎn
7818,閃閃發光,6,,7,1,8,ㄕㄢˇ ㄕㄢˇ ㄈㄚ ㄍㄨㄤ,shǎn shǎn fā guāng
7819,山水,6,,7,8,15,ㄕㄢ ㄕㄨㄟˇ,shān shuǐ
7820,閃爍,6,,16,4,20,ㄕㄢˇ ㄕㄨㄛˋ,shǎn shuò
7821,山頭,6,,11,10,21,ㄕㄢ ㄊㄡˊ,shān tóu
7822,山羊,6,,10,3,13,ㄕㄢ ㄧㄤˊ,shān yáng
7823,閃耀,6,,8,5,13,ㄕㄢˇ ㄧㄠˋ,shǎn yào
7824,善意,6,,15,12,27,ㄕㄢˋ ㄧˋ,shàn yì
7825,善於,6,,25,3,28,ㄕㄢˋ ㄩˊ,shàn yú
7826,山莊,6,,8,4,12,ㄕㄢ ㄓㄨㄤ,shān zhuāng
7827,擅自,6,,7,2,9,ㄕㄢˋ ㄗˋ,shàn zì
7828,尚,6,,87,14,101,ㄕㄤˋ,shàng
7829,商標,6,,7,3,10,ㄕㄤ ㄅㄧㄠ,shāng biāo
7830,商場,6,,12,6,18,ㄕㄤ ㄔㄤˊ,shāng cháng
7831,傷感,6,,6,1,7,ㄕㄤ ㄍㄢˇ,shāng gǎn
7832,上好,6,,5,4,9,ㄕㄤˋ ㄏㄠˇ,shàng hǎo
7833,上級,6,,10,0,10,ㄕㄤˋ ㄐㄧˊ,shàng jí
7834,商機,6,,9,14,23,ㄕㄤ ㄐㄧ,shāng jī
7835,商家,6,,7,6,13,ㄕㄤ ㄐㄧㄚ,shāng jiā
7836,上進,6,,7,4,11,ㄕㄤˋ ㄐㄧㄣˋ,shàng jìn
7837,上空,6,,11,9,20,ㄕㄤˋ ㄎㄨㄥ,shàng kōng
7838,上流,6,,8,1,9,ㄕㄤˋ ㄌㄧㄡˊ,shàng liú
7839,上路,6,,13,9,22,ㄕㄤˋ ㄌㄨˋ,shàng lù
7840,上門,6,,13,3,16,ㄕㄤˋ ㄇㄣˊ,shàng mén
7841,上任,6,,11,21,32,ㄕㄤˋ ㄖㄣˋ,shàng rèn
7842,上上下下,6,,4,2,6,ㄕㄤˋ ㄕㄤˋ ㄒㄧㄚˋ ㄒㄧㄚˋ,shàng shàng xià xià
7843,賞識,6,,8,3,11,ㄕㄤˇ ㄕˋ,shǎng shì
7844,傷勢,6,,5,2,7,ㄕㄤ ㄕˋ,shāng shì
7845,上訴,6,,7,1,8,ㄕㄤˋ ㄙㄨˋ,shàng sù
7846,上天,6,,20,14,34,ㄕㄤˋ ㄊㄧㄢ,shàng tiān
7847,傷痛,6,,14,15,29,ㄕㄤ ㄊㄨㄥˋ,shāng tòng
7848,傷亡,6,,7,22,29,ㄕㄤ ㄨㄤˊ,shāng wáng
7849,商務,6,,15,3,18,ㄕㄤ ㄨˋ,shāng wù
7850,上揚,6,,5,3,8,ㄕㄤˋ ㄧㄤˊ,shàng yáng
7851,商議,6,,15,1,16,ㄕㄤ ㄧˋ,shāng yì
7852,上映,6,,3,1,4,ㄕㄤˋ ㄧㄥˋ,shàng yìng
7853,上游,6,,11,32,43,ㄕㄤˋ ㄧㄡˊ,shàng yóu
7854,少許,6,,8,4,12,ㄕㄠˇ ㄒㄩˇ,shǎo xǔ
7855,少爺,6,,9,1,10,ㄕㄠˋ ㄧㄝˊ,shào yé
7856,奢侈,6,,9,5,14,ㄕㄜ ㄔˇ,shē chǐ
7857,奢華,6,,7,4,11,ㄕㄜ ㄏㄨㄚˊ,shē huá
7858,射擊,6,,9,4,13,ㄕㄜˋ ㄐㄧˊ,shè jí
7859,涉及,6,,27,5,32,ㄕㄜˋ ㄐㄧˊ,shè jí
7860,捨棄,6,,9,5,14,ㄕㄜˇ ㄑㄧˋ,shě qì
7861,攝取,6,,14,28,42,ㄕㄜˋ ㄑㄩˇ,shè qǔ
7862,涉入,6,,6,2,8,ㄕㄜˋ ㄖㄨˋ,shè rù
7863,設施,6,,17,42,59,ㄕㄜˋ ㄕ,shè shī
7864,設想,6,,13,4,17,ㄕㄜˋ ㄒㄧㄤˇ,shè xiǎng
7865,設置,6,,23,18,41,ㄕㄜˋ ㄓˋ,shè zhì
7866,甚,6,,78,10,88,ㄕㄣˊ / ㄕㄣˋ,shén / shèn
7867,審查,6,,14,5,19,ㄕㄣˇ ㄔㄚˊ,shěn chá
7868,深沉,6,,11,1,12,ㄕㄣ ㄔㄣˊ,shēn chén
7869,身處,6,,15,7,22,ㄕㄣ ㄔㄨˇ,shēn chǔ
7870,神父,6,,29,19,48,ㄕㄣˊ ㄈㄨˋ,shén fù
7871,審核,6,,5,4,9,ㄕㄣˇ ㄏㄜˊ,shěn hé
7872,深厚,6,,13,9,22,ㄕㄣ ㄏㄡˋ,shēn hòu
7873,神經質,6,,8,1,9,ㄕㄣˊ ㄐㄧㄥ ㄓˊ,shén jīng zhí
7874,神明,6,,12,7,19,ㄕㄣˊ ㄇㄧㄥˊ,shén míng
7875,審判,6,,17,4,21,ㄕㄣˇ ㄆㄢˋ,shěn pàn
7876,深切,6,,9,5,14,ㄕㄣ ㄑㄧㄝˋ,shēn qiè
7877,神情,6,,31,7,38,ㄕㄣˊ ㄑㄧㄥˊ,shén qíng
7878,深情,6,,9,1,10,ㄕㄣ ㄑㄧㄥˊ,shēn qíng
7879,身軀,6,,13,5,18,ㄕㄣ ㄑㄩ,shēn qū
7880,神色,6,,13,1,14,ㄕㄣˊ ㄙㄜˋ,shén sè
7881,深山,6,,13,9,22,ㄕㄣ ㄕㄢ,shēn shān
7882,審視,6,,12,2,14,ㄕㄣˇ ㄕˋ,shěn shì
7883,紳士,6,,13,1,14,ㄕㄣ ㄕˋ,shēn shì
7884,身世,6,,9,2,11,ㄕㄣ ㄕˋ,shēn shì
7885,深思,6,,11,5,16,ㄕㄣ ㄙ,shēn sī
7886,神態,6,,7,1,8,ㄕㄣˊ ㄊㄞˋ,shén tài
7887,身亡,6,,10,8,18,ㄕㄣ ㄨㄤˊ,shēn wáng
7888,身為,6,,65,53,118,ㄕㄣ ㄨㄟˊ,shēn wéi
7889,深信,6,,16,5,21,ㄕㄣ ㄒㄧㄣˋ,shēn xìn
7890,身形,6,,6,1,7,ㄕㄣ ㄒㄧㄥˊ,shēn xíng
7891,呻吟,6,,11,1,12,ㄕㄣ ㄧㄣˊ,shēn yín
7892,深淵,6,,9,3,12,ㄕㄣ ㄩㄢ,shēn yuān
7893,伸展,6,,30,6,36,ㄕㄣ ㄓㄢˇ,shēn zhǎn
7894,深知,6,,15,2,17,ㄕㄣ ㄓ,shēn zhī
7895,慎重,6,,12,4,16,ㄕㄣˋ ㄓㄨㄥˋ,shèn zhòng
7896,聲稱,6,,13,4,17,ㄕㄥ ㄔㄥ,shēng chēng
7897,牲畜,6,,8,12,20,ㄕㄥ ㄔㄨˋ,shēng chù
7898,盛大,6,,9,8,17,ㄕㄥˋ ㄉㄚˋ,shèng dà
7899,勝負,6,,10,4,14,ㄕㄥˋ ㄈㄨˋ,shèng fù
7900,升高,6,,15,25,40,ㄕㄥ ㄍㄠ,shēng gāo
7901,升官,6,,6,2,8,ㄕㄥ ㄍㄨㄢ,shēng guān
7902,勝過,6,,15,5,20,ㄕㄥˋ ㄍㄨㄛˋ,shèng guò
7903,生計,6,,7,14,21,ㄕㄥ ㄐㄧˋ,shēng jì
7904,生機,6,,9,19,28,ㄕㄥ ㄐㄧ,shēng jī
7905,聖經,6,,28,6,34,ㄕㄥˋ ㄐㄧㄥ,shèng jīng
7906,盛開,6,,8,7,15,ㄕㄥˋ ㄎㄞ,shèng kāi
7907,聲明,6,,18,16,34,ㄕㄥ ㄇㄧㄥˊ,shēng míng
7908,生母,6,,15,1,16,ㄕㄥ ㄇㄨˇ,shēng mǔ
7909,生平,6,,14,5,19,ㄕㄥ ㄆㄧㄥˊ,shēng píng
7910,生前,6,,18,7,25,ㄕㄥ ㄑㄧㄢˊ,shēng qián
7911,升遷,6,,13,2,15,ㄕㄥ ㄑㄧㄢ,shēng qiān
7912,聖人,6,,21,3,24,ㄕㄥˋ ㄖㄣˊ,shèng rén
7913,勝任,6,,10,3,13,ㄕㄥ ㄖㄣˋ,shēng rèn
7914,聲勢,6,,11,6,17,ㄕㄥ ㄕˋ,shēng shì
7915,生死,6,,22,19,41,ㄕㄥ ㄙˇ,shēng sǐ
7916,繩索,6,,14,4,18,ㄕㄥˊ ㄙㄨㄛˇ,shéng suǒ
7917,聲望,6,,11,4,15,ㄕㄥ ㄨㄤˋ,shēng wàng
7918,生效,6,,3,5,8,ㄕㄥ ㄒㄧㄠˋ,shēng xiào
7919,盛行,6,,13,9,22,ㄕㄥˋ ㄒㄧㄥˊ,shèng xíng
7920,生涯,6,,50,16,66,ㄕㄥ ㄧㄚˊ,shēng yá
7921,生育,6,,12,5,17,ㄕㄥ ㄩˋ,shēng yù
7922,聲譽,6,,8,3,11,ㄕㄥ ㄩˋ,shēng yù
7923,生殖,6,,8,7,15,ㄕㄥ ㄓˊ,shēng zhí
7924,升值,6,,2,1,3,ㄕㄥ ㄓˊ,shēng zhí
7925,拾,6,,7,1,8,ㄕˊ,shí
7926,視,6,,52,18,70,ㄕˋ,shì
7927,屎,6,,13,1,14,ㄕˇ,shǐ
7928,石碑,6,,8,2,10,ㄕˊ ㄅㄟ,shí bēi
7929,勢必,6,,19,14,33,ㄕˋ ㄅㄧˋ,shì bì
7930,事變,6,,13,1,14,ㄕˋ ㄅㄧㄢˋ,shì biàn
7931,失常,6,,16,1,17,ㄕ ㄔㄤˊ,shī cháng
7932,時辰,6,,12,2,14,ㄕˊ ㄔㄣˊ,shí chén
7933,實地,6,,10,7,17,ㄕˊ ㄉㄧˋ,shí dì
7934,適度,6,,10,9,19,ㄕˋ ㄉㄨˋ,shì dù
7935,時段,6,,11,7,18,ㄕˊ ㄉㄨㄢˋ,shí duàn
7936,時而,6,,15,4,19,ㄕˊ ㄦˊ,shí ér
7937,視而不見,6,,7,1,8,ㄕˋ ㄦˊ ㄅㄨˋ ㄐㄧㄢˋ,shì ér bù jiàn
7938,師範,6,,11,5,16,ㄕ ㄈㄢˋ,shī fàn
7939,釋放,6,,26,27,53,ㄕˋ ㄈㄤˋ,shì fàng
7940,時分,6,,18,5,23,ㄕˊ ㄈㄣˋ,shí fèn
7941,詩歌,6,,11,3,14,ㄕ ㄍㄜ,shī gē
7942,施工,6,,6,11,17,ㄕ ㄍㄨㄥ,shī gōng
7943,嗜好,6,,13,4,17,ㄕˋ ㄏㄠˋ,shì hào
7944,失衡,6,,8,6,14,ㄕ ㄏㄥˊ,shī héng
7945,失火,6,,4,3,7,ㄕ ㄏㄨㄛˇ,shī huǒ
7946,事蹟,6,,15,5,20,ㄕˋ ㄐㄧ,shì jī
7947,世家,6,,8,3,11,ㄕˋ ㄐㄧㄚ,shì jiā
7948,施加,6,,7,2,9,ㄕ ㄐㄧㄚ,shī jiā
7949,世間,6,,19,13,32,ㄕˋ ㄐㄧㄢ,shì jiān
7950,時節,6,,11,37,48,ㄕˊ ㄐㄧㄝˊ,shí jié
7951,使節,6,,10,2,12,ㄕˇ ㄐㄧㄝˊ,shǐ jié
7952,使勁,6,,11,2,13,ㄕˇ ㄐㄧㄣˋ,shǐ jìn
7953,詩句,6,,9,2,11,ㄕ ㄐㄩˋ,shī jù
7954,失控,6,,14,9,23,ㄕ ㄎㄨㄥˋ,shī kòng
7955,石塊,6,,9,10,19,ㄕˊ ㄎㄨㄞˋ,shí kuài
7956,實況,6,,4,2,6,ㄕˊ ㄎㄨㄤˋ,shí kuàng
7957,實例,6,,15,2,17,ㄕˊ ㄌㄧˋ,shí lì
7958,失利,6,,5,1,6,ㄕ ㄌㄧˋ,shī lì
7959,失禮,6,,5,1,6,ㄕ ㄌㄧˇ,shī lǐ
7960,史料,6,,26,9,35,ㄕˇ ㄌㄧㄠˋ,shǐ liào
7961,失落,6,,16,14,30,ㄕ ㄌㄨㄛˋ,shī luò
7962,時髦,6,,10,4,14,ㄕˊ ㄇㄠˊ,shí máo
7963,市面,6,,10,22,32,ㄕˋ ㄇㄧㄢˋ,shì miàn
7964,失眠,6,,15,19,34,ㄕ ㄇㄧㄢˊ,shī mián
7965,使命,6,,20,21,41,ㄕˇ ㄇㄧㄥˋ,shǐ mìng
7966,失明,6,,5,7,12,ㄕ ㄇㄧㄥˊ,shī míng
7967,實情,6,,11,1,12,ㄕˊ ㄑㄧㄥˊ,shí qíng
7968,世人,6,,25,19,44,ㄕˋ ㄖㄣˊ,shì rén
7969,時日,6,,8,2,10,ㄕˊ ㄖˋ,shí rì
7970,時尚,6,,10,12,22,ㄕˊ ㄕㄤˋ,shí shàng
7971,時勢,6,,5,1,6,ㄕˊ ㄕˋ,shí shì
7972,實施,6,,42,24,66,ㄕˊ ㄕ,shí shī
7973,適時,6,,15,12,27,ㄕˋ ㄕˊ,shì shí
7974,世事,6,,8,3,11,ㄕˋ ㄕˋ,shì shì
7975,逝世,6,,12,2,14,ㄕˋ ㄕˋ,shì shì
7976,史實,6,,8,1,9,ㄕˇ ㄕˊ,shǐ shí
7977,世俗,6,,15,12,27,ㄕˋ ㄙㄨˊ,shì sú
7978,試探,6,,11,2,13,ㄕˋ ㄊㄢˋ,shì tàn
7979,實體,6,,11,9,20,ㄕˊ ㄊㄧˇ,shí tǐ
7980,屍體,6,,47,11,58,ㄕ ㄊㄧˇ,shī tǐ
7981,失調,6,,14,4,18,ㄕ ㄊㄧㄠˊ,shī tiáo
7982,視聽,6,,4,3,7,ㄕˋ ㄊㄧㄥ,shì tīng
7983,試圖,6,,57,22,79,ㄕˋ ㄊㄨˊ,shì tú
7984,示威,6,,8,32,40,ㄕˋ ㄨㄟ,shì wēi
7985,實務,6,,26,10,36,ㄕˊ ㄨˋ,shí wù
7986,時下,6,,5,4,9,ㄕˊ ㄒㄧㄚˋ,shí xià
7987,時效,6,,2,0,2,ㄕˊ ㄒㄧㄠˋ,shí xiào
7988,實行,6,,31,15,46,ㄕˊ ㄒㄧㄥˊ,shí xíng
7989,施行,6,,12,8,20,ㄕ ㄒㄧㄥˊ,shī xíng
7990,誓言,6,,7,6,13,ㄕˋ ㄧㄢˊ,shì yán
7991,飾演,6,,11,2,13,ㄕˋ ㄧㄢˇ,shì yǎn
7992,事宜,6,,10,2,12,ㄕˋ ㄧˊ,shì yí
7993,適宜,6,,5,4,9,ㄕˋ ㄧˊ,shì yí
7994,示意,6,,14,1,15,ㄕˋ ㄧˋ,shì yì
7995,失意,6,,5,2,7,ㄕ ㄧˋ,shī yì
7996,詩意,6,,5,2,7,ㄕ ㄧˋ,shī yì
7997,食用,6,,15,28,43,ㄕˊ ㄩㄥˋ,shí yòng
7998,食慾/食欲,6,,8,4,12,ㄕˊ ㄩˋ,shí yù
7999,實戰,6,,19,1,20,ㄕˊ ㄓㄢˋ,shí zhàn
8000,施展,6,,10,2,12,ㄕ ㄓㄢˇ,shī zhǎn
8001,使者,6,,18,2,20,ㄕˇ ㄓㄜˇ,shǐ zhě
8002,實證,6,,11,2,13,ㄕˊ ㄓㄥˋ,shí zhèng
8003,實質,6,,25,16,41,ㄕˊ ㄓˊ,shí zhí
8004,食指,6,,9,4,13,ㄕˊ ㄓˇ,shí zhǐ
8005,適中,6,,3,3,6,ㄕˋ ㄓㄨㄥ,shì zhōng
8006,十字架,6,,8,4,12,ㄕˊ ㄗˋ ㄐㄧㄚˋ,shí zì jià
8007,收成,6,,10,112,122,ㄕㄡ ㄔㄥˊ,shōu chéng
8008,受挫,6,,6,1,7,ㄕㄡˋ ㄘㄨㄛˋ,shòu cuò
8009,守法,6,,4,2,6,ㄕㄡˇ ㄈㄚˇ,shǒu fǎ
8010,手法,6,,37,15,52,ㄕㄡˇ ㄈㄚˇ,shǒu fǎ
8011,收復,6,,7,1,8,ㄕㄡ ㄈㄨˋ,shōu fù
8012,手稿,6,,10,2,12,ㄕㄡˇ ㄍㄠˇ,shǒu gǎo
8013,收購,6,,14,8,22,ㄕㄡ ㄍㄡˋ,shōu gòu
8014,手腳,6,,23,15,38,ㄕㄡˇ ㄐㄧㄠˇ,shǒu jiǎo
8015,守舊,6,,4,1,5,ㄕㄡˇ ㄐㄧㄡˋ,shǒu jiù
8016,授課,6,,6,3,9,ㄕㄡˋ ㄎㄜˋ,shòu kè
8017,首領,6,,17,2,19,ㄕㄡˇ ㄌㄧㄥˇ,shǒu lǐng
8018,收留,6,,5,3,8,ㄕㄡ ㄌㄧㄡˊ,shōu liú
8019,收錄,6,,10,4,14,ㄕㄡ ㄌㄨˋ,shōu lù
8020,收買,6,,6,1,7,ㄕㄡ ㄇㄞˇ,shōu mǎi
8021,手帕,6,,11,10,21,ㄕㄡˇ ㄆㄚˋ,shǒu pà
8022,手槍,6,,12,2,14,ㄕㄡˇ ㄑㄧㄤ,shǒu qiāng
8023,授權,6,,14,8,22,ㄕㄡˋ ㄑㄩㄢˊ,shòu quán
8024,收容,6,,5,28,33,ㄕㄡ ㄖㄨㄥˊ,shōu róng
8025,首飾,6,,6,2,8,ㄕㄡˇ ㄕˋ,shǒu shì
8026,受損,6,,15,12,27,ㄕㄡˋ ㄙㄨㄣˇ,shòu sǔn
8027,收縮,6,,12,5,17,ㄕㄡ ㄙㄨㄛ,shōu suō
8028,手頭,6,,5,2,7,ㄕㄡˇ ㄊㄡˊ,shǒu tóu
8029,守衛,6,,8,2,10,ㄕㄡˇ ㄨㄟˋ,shǒu wèi
8030,首席,6,,10,4,14,ㄕㄡˇ ㄒㄧˊ,shǒu xí
8031,受限,6,,5,4,9,ㄕㄡˋ ㄒㄧㄢˋ,shòu xiàn
8032,首相,6,,8,16,24,ㄕㄡˇ ㄒㄧㄤˋ,shǒu xiàng
8033,壽星,6,,1,2,3,ㄕㄡˋ ㄒㄧㄥ,shòu xīng
8034,受訓,6,,7,6,13,ㄕㄡˋ ㄒㄩㄣˋ,shòu xùn
8035,收養,6,,10,8,18,ㄕㄡ ㄧㄤˇ,shōu yǎng
8036,首要,6,,12,9,21,ㄕㄡˇ ㄧㄠˋ,shǒu yào
8037,受益,6,,9,6,15,ㄕㄡˋ ㄧˋ,shòu yì
8038,手藝,6,,9,8,17,ㄕㄡˇ ㄧˋ,shǒu yì
8039,收益,6,,9,10,19,ㄕㄡ ㄧˋ,shōu yì
8040,手肘,6,,12,3,15,ㄕㄡˇ ㄓㄡˇ,shǒu zhǒu
8041,手足,6,,11,3,14,ㄕㄡˇ ㄗㄨˊ,shǒu zú
8042,豎,6,,9,3,12,ㄕㄨˋ,shù
8043,舒暢,6,,5,3,8,ㄕㄨ ㄔㄤˋ,shū chàng
8044,輸出,6,,20,7,27,ㄕㄨ ㄔㄨ,shū chū
8045,樹叢,6,,9,2,11,ㄕㄨˋ ㄘㄨㄥˊ,shù cóng
8046,束縛,6,,16,4,20,ㄕㄨˋ ㄈㄨˊ,shù fú
8047,樹幹,6,,14,10,24,ㄕㄨˋ ㄍㄢˋ,shù gàn
8048,疏忽,6,,12,5,17,ㄕㄨ ㄏㄨ,shū hū
8049,舒緩,6,,7,6,13,ㄕㄨ ㄏㄨㄢˇ,shū huǎn
8050,紓解,6,,11,7,18,ㄕㄨ ㄐㄧㄝˇ,shū jiě
8051,樹立,6,,9,4,13,ㄕㄨˋ ㄌㄧˋ,shù lì
8052,疏離,6,,14,4,18,ㄕㄨ ㄌㄧˊ,shū lí
8053,熟練,6,,13,11,24,ㄕㄨˊ ㄌㄧㄢˋ,shú liàn
8054,署名,6,,5,1,6,ㄕㄨˋ ㄇㄧㄥˊ,shù míng
8055,淑女,6,,5,1,6,ㄕㄨˊ ㄋㄩˇ,shú nǚ
8056,輸入,6,,23,7,30,ㄕㄨ ㄖㄨˋ,shū rù
8057,疏散,6,,2,9,11,ㄕㄨ ㄙㄢˋ,shū sàn
8058,熟識,6,,6,3,9,ㄕㄨˊ ㄕˋ,shú shì
8059,束手無策,6,,8,4,12,ㄕㄨˋ ㄕㄡˇ ㄨˊ ㄘㄜˋ,shù shǒu wú cè
8060,述說,6,,9,4,13,ㄕㄨˋ ㄕㄨㄛ,shù shuō
8061,屬下,6,,10,0,10,ㄕㄨˇ ㄒㄧㄚˋ,shǔ xià
8062,輸血,6,,3,1,4,ㄕㄨ ㄒㄧㄝˇ,shū xiě
8063,屬性,6,,12,3,15,ㄕㄨˇ ㄒㄧㄥˋ,shǔ xìng
8064,樹蔭,6,,6,2,8,ㄕㄨˋ ㄧㄣˋ,shù yìn
8065,術語,6,,12,3,15,ㄕㄨˋ ㄩˇ,shù yǔ
8066,疏遠,6,,9,1,10,ㄕㄨ ㄩㄢˇ,shū yuǎn
8067,熟知,6,,9,7,16,ㄕㄨˊ ㄓ,shú zhī
8068,數值,6,,8,7,15,ㄕㄨˋ ㄓˊ,shù zhí
8069,耍,6,,17,7,24,ㄕㄨㄚˇ,shuǎ
8070,甩,6,,13,6,19,ㄕㄨㄞˇ,shuǎi
8071,衰老,6,,6,2,8,ㄕㄨㄞ ㄌㄠˇ,shuāi lǎo
8072,帥氣,6,,3,3,6,ㄕㄨㄞˋ ㄑㄧˋ,shuài qì
8073,衰弱,6,,10,3,13,ㄕㄨㄞ ㄖㄨㄛˋ,shuāi ruò
8074,衰退,6,,14,14,28,ㄕㄨㄞ ㄊㄨㄟˋ,shuāi tuì
8075,率先,6,,11,7,18,ㄕㄨㄞˋ ㄒㄧㄢ,shuài xiān
8076,霜,6,,7,20,27,ㄕㄨㄤ,shuāng
8077,雙重,6,,16,6,22,ㄕㄨㄤ ㄔㄨㄥˊ,shuāng chóng
8078,爽快,6,,5,2,7,ㄕㄨㄤˇ ㄎㄨㄞˋ,shuǎng kuài
8079,水流,6,,9,19,28,ㄕㄨㄟˇ ㄌㄧㄡˊ,shuǐ liú
8080,水泥,6,,14,28,42,ㄕㄨㄟˇ ㄋㄧˊ,shuǐ ní
8081,稅收,6,,8,4,12,ㄕㄨㄟˋ ㄕㄡ,shuì shōu
8082,水手,6,,10,1,11,ㄕㄨㄟˇ ㄕㄡˇ,shuǐ shǒu
8083,水桶,6,,8,10,18,ㄕㄨㄟˇ ㄊㄨㄥˇ,shuǐ tǒng
8084,水域,6,,5,7,12,ㄕㄨㄟˇ ㄩˋ,shuǐ yù
8085,水源,6,,7,52,59,ㄕㄨㄟˇ ㄩㄢˊ,shuǐ yuán
8086,順暢,6,,13,9,22,ㄕㄨㄣˋ ㄔㄤˋ,shùn chàng
8087,順從,6,,12,3,15,ㄕㄨㄣˋ ㄘㄨㄥˊ,shùn cóng
8088,瞬間,6,,28,24,52,ㄕㄨㄣˋ ㄐㄧㄢ,shùn jiān
8089,順勢,6,,10,3,13,ㄕㄨㄣˋ ㄕˋ,shùn shì
8090,順手,6,,13,4,17,ㄕㄨㄣˋ ㄕㄡˇ,shùn shǒu
8091,說穿,6,,6,3,9,ㄕㄨㄛ ㄔㄨㄢ,shuō chuān
8092,說教,6,,6,1,7,ㄕㄨㄛ ㄐㄧㄠˋ,shuō jiào
8093,說笑,6,,4,0,4,ㄕㄨㄛ ㄒㄧㄠˋ,shuō xiào
8094,撕,6,,6,10,16,ㄙ,sī
8095,思潮,6,,8,3,11,ㄙ ㄔㄠˊ,sī cháo
8096,似的,6,,76,3,79,ㄙˋ ˙ㄉㄜ,sì de
8097,司法,6,,15,5,20,ㄙ ㄈㄚˇ,sī fǎ
8098,四海,6,,9,2,11,ㄙˋ ㄏㄞˇ,sì hǎi
8099,嘶喊,6,,1,0,1,ㄙ ㄏㄢˇ,sī hǎn
8100,絲毫,6,,32,11,43,ㄙ ㄏㄠˊ,sī háo
8101,嘶吼,6,,3,1,4,ㄙ ㄏㄡˇ,sī hǒu
8102,思路,6,,9,2,11,ㄙ ㄌㄨˋ,sī lù
8103,四面八方,6,,8,4,12,ㄙˋ ㄇㄧㄢˋ ㄅㄚ ㄈㄤ,sì miàn bā fāng
8104,死神,6,,8,3,11,ㄙˇ ㄕㄣˊ,sǐ shén
8105,思索,6,,35,8,43,ㄙ ㄙㄨㄛˇ,sī suǒ
8106,思維,6,,41,30,71,ㄙ ㄨㄟˊ,sī wéi
8107,死心,6,,5,1,6,ㄙˇ ㄒㄧㄣ,sǐ xīn
8108,私心,6,,5,1,6,ㄙ ㄒㄧㄣ,sī xīn
8109,死刑,6,,17,2,19,ㄙˇ ㄒㄧㄥˊ,sǐ xíng
8110,思緒,6,,23,2,25,ㄙ ㄒㄩˋ,sī xù
8111,飼養,6,,9,11,20,ㄙˋ ㄧㄤˇ,sì yǎng
8112,賜予,6,,8,3,11,ㄙˋ ㄩˇ,sì yǔ
8113,寺院,6,,12,10,22,ㄙˋ ㄩㄢˋ,sì yuàn
8114,死者,6,,22,3,25,ㄙˇ ㄓㄜˇ,sǐ zhě
8115,四肢,6,,15,11,26,ㄙˋ ㄓ,sì zhī
8116,鬆弛,6,,11,1,12,ㄙㄨㄥ ㄔˊ,sōng chí
8117,鬆散,6,,5,4,9,ㄙㄨㄥ ㄙㄢˇ,sōng sǎn
8118,松樹/松,6,,22,8,30,ㄙㄨㄥ ㄕㄨˋ/ㄙㄨㄥ,sōng shù/sōng
8119,鬆懈,6,,7,4,11,ㄙㄨㄥ ㄒㄧㄝˋ,sōng xiè
8120,送行,6,,5,3,8,ㄙㄨㄥˋ ㄒㄧㄥˊ,sòng xíng
8121,慫恿,6,,7,1,8,ㄙㄨㄥˇ ㄩㄥˇ,sǒng yǒng
8122,搜查,6,,8,1,9,ㄙㄡ ㄔㄚˊ,sōu chá
8123,搜集,6,,8,13,21,ㄙㄡ ㄐㄧˊ,sōu jí
8124,搜索,6,,11,6,17,ㄙㄡ ㄙㄨㄛˇ,sōu suǒ
8125,素材,6,,11,15,26,ㄙㄨˋ ㄘㄞˊ,sù cái
8126,俗稱,6,,11,17,28,ㄙㄨˊ ㄔㄥ,sú chēng
8127,訴求,6,,11,15,26,ㄙㄨˋ ㄑㄧㄡˊ,sù qiú
8128,訴說,6,,14,8,22,ㄙㄨˋ ㄕㄨㄛ,sù shuō
8129,訴訟,6,,9,2,11,ㄙㄨˋ ㄙㄨㄥˋ,sù sòng
8130,甦醒,6,,6,5,11,ㄙㄨ ㄒㄧㄥˇ,sū xǐng
8131,素養,6,,9,9,18,ㄙㄨˋ ㄧㄤˇ,sù yǎng
8132,俗語,6,,4,3,7,ㄙㄨˊ ㄩˇ,sú yǔ
8133,塑造,6,,23,6,29,ㄙㄨˋ ㄗㄠˋ,sù zào
8134,素質,6,,10,3,13,ㄙㄨˋ ㄓˊ,sù zhí
8135,算數,6,,6,3,9,ㄙㄨㄢˋ ㄕㄨˋ,suàn shù
8136,遂,6,,65,3,68,ㄙㄨㄟˋ,suì
8137,隨從1,6,,13,0,13,ㄙㄨㄟˊ ㄘㄨㄥˊ,suí cóng
8138,隧道,6,,9,14,23,ㄙㄨㄟˋ ㄉㄠˋ,suì dào
8139,隨後,6,,35,11,46,ㄙㄨㄟˊ ㄏㄡˋ,suí hòu
8140,隨即,6,,36,8,44,ㄙㄨㄟˊ ㄐㄧˊ,suí jí
8141,隨心所欲,6,,6,2,8,ㄙㄨㄟˊ ㄒㄧㄣ ㄙㄨㄛˇ ㄩˋ,suí xīn suǒ yù
8142,隨之,6,,8,2,10,ㄙㄨㄟˊ ㄓ,suí zhī
8143,隨從2,6,,13,0,13,ㄙㄨㄟˊ ㄗㄨㄥˋ,suí zòng
8144,損害,6,,15,9,24,ㄙㄨㄣˇ ㄏㄞˋ,sǔn hài
8145,損傷,6,,12,5,17,ㄙㄨㄣˇ ㄕㄤ,sǔn shāng
8146,縮,6,,13,9,22,ㄙㄨㄛ,suō
8147,所得,6,,13,5,18,ㄙㄨㄛˇ ㄉㄜˊ,suǒ dé
8148,鎖定,6,,7,13,20,ㄙㄨㄛˇ ㄉㄧㄥˋ,suǒ dìng
8149,縮短,6,,11,10,21,ㄙㄨㄛ ㄉㄨㄢˇ,suō duǎn
8150,索取,6,,5,1,6,ㄙㄨㄛˇ ㄑㄩˇ,suǒ qǔ
8151,瑣事,6,,7,2,9,ㄙㄨㄛˇ ㄕˋ,suǒ shì
8152,瑣碎,6,,6,1,7,ㄙㄨㄛˇ ㄙㄨㄟˋ,suǒ suì
8153,縮寫,6,,4,3,7,ㄙㄨㄛ ㄒㄧㄝˇ,suō xiě
8154,所幸,6,,10,7,17,ㄙㄨㄛˇ ㄒㄧㄥˋ,suǒ xìng
8155,索性,6,,11,2,13,ㄙㄨㄛˇ ㄒㄧㄥˋ,suǒ xìng
8156,所在,6,,47,12,59,ㄙㄨㄛˇ ㄗㄞˋ,suǒ zài
8157,所作所為,6,,9,3,12,ㄙㄨㄛˇ ㄗㄨㄛˋ ㄙㄨㄛˇ ㄨㄟˊ,suǒ zuò suǒ wéi
8158,踏實,6,,12,14,26,ㄊㄚˋ ㄕˊ,tà shí
8159,胎,6,,8,6,14,ㄊㄞ,tāi
8160,台詞/臺詞,6,,6,1,7,ㄊㄞˊ ㄘˊ,tái cí
8161,胎兒,6,,13,9,22,ㄊㄞ ㄦˊ ,tāi ér
8162,抬高,6,,8,3,11,ㄊㄞˊ ㄍㄠ,tái gāo
8163,台階,6,,13,3,16,ㄊㄞˊ ㄐㄧㄝ,tái jiē
8164,太平,6,,13,4,17,ㄊㄞˋ ㄆㄧㄥˊ,tài píng
8165,潭,6,,6,3,9,ㄊㄢˊ,tán
8166,攤,6,,13,18,31,ㄊㄢ,tān
8167,灘,6,,7,8,15,ㄊㄢ,tān
8168,坦承,6,,9,3,12,ㄊㄢˇ ㄔㄥˊ,tǎn chéng
8169,坦誠,6,,7,1,8,ㄊㄢˇ ㄔㄥˊ,tǎn chéng
8170,彈劾,6,,7,0,7,ㄊㄢˊ ㄏㄜˊ,tán hé
8171,癱瘓,6,,9,11,20,ㄊㄢ ㄏㄨㄢˋ,tān huàn
8172,探究,6,,28,3,31,ㄊㄢˋ ㄐㄧㄡˋ,tàn jiù
8173,攤開,6,,7,3,10,ㄊㄢ ㄎㄞ,tān kāi
8174,貪婪,6,,17,5,22,ㄊㄢ ㄌㄢˊ,tān lán
8175,談判,6,,27,42,69,ㄊㄢˊ ㄆㄢˋ,tán pàn
8176,坦然,6,,7,6,13,ㄊㄢˇ ㄖㄢˊ,tǎn rán
8177,坦率,6,,8,1,9,ㄊㄢˇ ㄕㄨㄞˋ,tǎn shuài
8178,探索,6,,56,32,88,ㄊㄢˋ ㄙㄨㄛˇ,tàn suǒ
8179,探望,6,,15,10,25,ㄊㄢˋ ㄨㄤˋ,tàn wàng
8180,貪污,6,,8,2,10,ㄊㄢ ㄨ,tān wū
8181,嘆息/歎息,6,,16,4,20,ㄊㄢˋ ㄒㄧˊ  ,tàn xí 
8182,探險,6,,13,20,33,ㄊㄢˋ ㄒㄧㄢˇ,tàn xiǎn
8183,坦言,6,,2,1,3,ㄊㄢˇ ㄧㄢˊ,tǎn yán
8184,彈奏,6,,7,2,9,ㄊㄢˊ ㄗㄡˋ,tán zòu
8185,倘若,6,,25,2,27,ㄊㄤˇ ㄖㄨㄛˋ,tǎng ruò
8186,掏,6,,5,5,10,ㄊㄠ,tāo
8187,陶瓷,6,,5,4,9,ㄊㄠˊ ㄘˊ,táo cí
8188,討好,6,,16,4,20,ㄊㄠˇ ㄏㄠˇ,tǎo hǎo
8189,桃花,6,,8,5,13,ㄊㄠˊ ㄏㄨㄚ,táo huā
8190,討價還價,6,,4,1,5,ㄊㄠˇ ㄐㄧㄚˋ ㄏㄨㄢˊ ㄐㄧㄚˋ,tǎo jià huán jià
8191,逃離,6,,15,10,25,ㄊㄠˊ ㄌㄧˊ,táo lí
8192,逃命,6,,7,1,8,ㄊㄠˊ ㄇㄧㄥˋ,táo mìng
8193,逃難,6,,5,10,15,ㄊㄠˊ ㄋㄢˋ,táo nàn
8194,陶器,6,,4,3,7,ㄊㄠˊ ㄑㄧˋ,táo qì
8195,淘汰,6,,12,9,21,ㄊㄠˊ ㄊㄞˋ,táo tài
8196,滔滔不絕,6,,8,1,9,ㄊㄠ ㄊㄠ ㄅㄨˋ ㄐㄩㄝˊ,tāo tāo bù jué
8197,逃脫,6,,9,2,11,ㄊㄠˊ ㄊㄨㄛ,táo tuō
8198,逃亡,6,,15,5,20,ㄊㄠˊ ㄨㄤˊ,táo wáng
8199,套用,6,,5,1,6,ㄊㄠˋ ㄩㄥˋ,tào yòng
8200,陶醉,6,,10,1,11,ㄊㄠˊ ㄗㄨㄟˋ,táo zuì
8201,特意,6,,9,2,11,ㄊㄜˋ ㄧˋ,tè yì
8202,特異,6,,5,1,6,ㄊㄜˋ ㄧˋ,tè yì
8203,蹄,6,,7,2,9,ㄊㄧˊ,tí
8204,提案,6,,14,8,22,ㄊㄧˊ ㄢˋ,tí àn
8205,提拔,6,,7,1,8,ㄊㄧˊ ㄅㄚˊ,tí bá
8206,題材,6,,16,10,26,ㄊㄧˊ ㄘㄞˊ,tí cái
8207,體操,6,,9,3,12,ㄊㄧˇ ㄘㄠ,tǐ cāo
8208,提倡,6,,20,19,39,ㄊㄧˊ ㄔㄤˋ,tí chàng
8209,堤防,6,,4,15,19,ㄊㄧˊ ㄈㄤˊ,tí fáng
8210,提防,6,,9,2,11,ㄊㄧˊ ㄈㄤˊ,tí fáng
8211,體格,6,,5,1,6,ㄊㄧˇ ㄍㄜˊ,tǐ gé
8212,體積,6,,9,14,23,ㄊㄧˇ ㄐㄧ,tǐ jī
8213,體諒,6,,9,11,20,ㄊㄧˇ ㄌㄧㄤˋ,tǐ liàng
8214,提名,6,,5,3,8,ㄊㄧˊ ㄇㄧㄥˊ,tí míng
8215,體認,6,,8,2,10,ㄊㄧˇ ㄖㄣˋ,tǐ rèn
8216,提升/提昇,6,,89,58,147,ㄊㄧˊ ㄕㄥ,tí shēng
8217,提示,6,,14,4,18,ㄊㄧˊ ㄕˋ,tí shì
8218,體系,6,,56,25,81,ㄊㄧˇ ㄒㄧˋ,tǐ xì
8219,體現,6,,13,4,17,ㄊㄧˇ ㄒㄧㄢˋ,tǐ xiàn
8220,提議,6,,29,13,42,ㄊㄧˊ ㄧˋ,tí yì
8221,體質,6,,15,22,37,ㄊㄧˇ ㄓˊ,tǐ zhí
8222,體制,6,,33,10,43,ㄊㄧˇ ㄓˋ,tǐ zhì
8223,舔,6,,10,2,12,ㄊㄧㄢˇ,tiǎn
8224,填補,6,,8,6,14,ㄊㄧㄢˊ ㄅㄨˇ,tián bǔ
8225,天敵,6,,2,8,10,ㄊㄧㄢ ㄉㄧˊ,tiān dí
8226,天地,6,,42,20,62,ㄊㄧㄢ ㄉㄧˋ,tiān dì
8227,天底下,6,,4,2,6,ㄊㄧㄢ ㄉㄧˇ ㄒㄧㄚˋ,tiān dǐ xià
8228,天分/天份,6,,11,10,21,ㄊㄧㄢ ㄈㄣˋ,tiān fèn
8229,天花板,6,,16,5,21,ㄊㄧㄢ ㄏㄨㄚ ㄅㄢˇ,tiān huā bǎn
8230,添加,6,,12,21,33,ㄊㄧㄢ ㄐㄧㄚ,tiān jiā
8231,田徑,6,,2,3,5,ㄊㄧㄢˊ ㄐㄧㄥˋ,tián jìng
8232,天色,6,,13,8,21,ㄊㄧㄢ ㄙㄜˋ,tiān sè
8233,天王,6,,7,1,8,ㄊㄧㄢ ㄨㄤˊ,tiān wáng
8234,天文,6,,16,8,24,ㄊㄧㄢ ㄨㄣˊ,tiān wén
8235,甜言蜜語,6,,3,2,5,ㄊㄧㄢˊ ㄧㄢˊ ㄇㄧˋ ㄩˇ,tián yán mì yǔ
8236,田園,6,,8,16,24,ㄊㄧㄢˊ ㄩㄢˊ,tián yuán
8237,調和,6,,10,3,13,ㄊㄧㄠˊ ㄏㄜˊ,tiáo hé
8238,調節,6,,17,17,34,ㄊㄧㄠˊ ㄐㄧㄝˊ,tiáo jié
8239,條款,6,,8,3,11,ㄊㄧㄠˊ ㄎㄨㄢˇ,tiáo kuǎn
8240,條例,6,,9,5,14,ㄊㄧㄠˊ ㄌㄧˋ,tiáo lì
8241,條理,6,,8,1,9,ㄊㄧㄠˊ ㄌㄧˇ,tiáo lǐ
8242,調皮,6,,6,7,13,ㄊㄧㄠˊ ㄆㄧˊ,tiáo pí
8243,挑起,6,,8,6,14,ㄊㄧㄠ ㄑㄧˇ,tiāo qǐ
8244,調適,6,,15,10,25,ㄊㄧㄠˊ ㄕˋ,tiáo shì
8245,跳脫,6,,6,7,13,ㄊㄧㄠˋ ㄊㄨㄛ,tiào tuō
8246,眺望,6,,8,1,9,ㄊㄧㄠˋ ㄨㄤˋ,tiào wàng
8247,條紋,6,,5,2,7,ㄊㄧㄠˊ ㄨㄣˊ,tiáo wén
8248,挑釁,6,,10,14,24,ㄊㄧㄠˇ ㄒㄧㄣˋ,tiǎo xìn
8249,條約,6,,16,14,30,ㄊㄧㄠˊ ㄩㄝ,tiáo yuē
8250,跳躍,6,,12,5,17,ㄊㄧㄠˋ ㄩㄝˋ,tiào yuè
8251,貼近,6,,10,11,21,ㄊㄧㄝ ㄐㄧㄣˋ,tiē jìn
8252,貼切,6,,7,6,13,ㄊㄧㄝ ㄑㄧㄝˋ,tiē qiè
8253,貼身,6,,8,3,11,ㄊㄧㄝ ㄕㄣ,tiē shēn
8254,貼心,6,,6,28,34,ㄊㄧㄝ ㄒㄧㄣ,tiē xīn
8255,提告,6,,1,1,2,ㄊㄧˊ ㄍㄠˋ,tígào
8256,聽信,6,,5,2,7,ㄊㄧㄥ ㄒㄧㄣˋ,tīng xìn
8257,停滯,6,,9,6,15,ㄊㄧㄥˊ ㄓˋ,tíng zhì
8258,挺直,6,,7,1,8,ㄊㄧㄥˇ ㄓˊ,tǐng zhí
8259,銅板,6,,5,3,8,ㄊㄨㄥˊ ㄅㄢˇ,tóng bǎn
8260,同胞,6,,16,8,24,ㄊㄨㄥˊ ㄅㄠ,tóng bāo
8261,通報,6,,10,7,17,ㄊㄨㄥ ㄅㄠˋ,tōng bào
8262,同輩,6,,3,2,5,ㄊㄨㄥˊ ㄅㄟˋ,tóng bèi
8263,同步,6,,12,8,20,ㄊㄨㄥˊ ㄅㄨˋ,tóng bù
8264,同儕,6,,19,4,23,ㄊㄨㄥˊ ㄔㄞˊ,tóng chái
8265,通車,6,,2,3,5,ㄊㄨㄥ ㄔㄜ,tōng chē
8266,通道,6,,13,11,24,ㄊㄨㄥ ㄉㄠˋ,tōng dào
8267,同等,6,,9,1,10,ㄊㄨㄥˊ ㄉㄥˇ,tóng děng
8268,統合,6,,14,5,19,ㄊㄨㄥˇ ㄏㄜˊ,tǒng hé
8269,通紅,6,,7,1,8,ㄊㄨㄥ ㄏㄨㄥˊ,tōng hóng
8270,童話,6,,10,4,14,ㄊㄨㄥˊ ㄏㄨㄚˋ,tóng huà
8271,通貨膨脹,6,,5,5,10,ㄊㄨㄥ ㄏㄨㄛˋ ㄆㄥˊ ㄓㄤˋ,tōng huò péng zhàng
8272,同居,6,,6,1,7,ㄊㄨㄥˊ ㄐㄩ,tóng jū
8273,通路,6,,12,19,31,ㄊㄨㄥ ㄌㄨˋ,tōng lù
8274,同盟,6,,15,3,18,ㄊㄨㄥˊ ㄇㄥˊ,tóng méng
8275,同仁,6,,13,35,48,ㄊㄨㄥˊ ㄖㄣˊ,tóng rén
8276,統統,6,,15,2,17,ㄊㄨㄥˇ ㄊㄨㄥˇ,tǒng tǒng
8277,痛心,6,,6,4,10,ㄊㄨㄥˋ ㄒㄧㄣ,tòng xīn
8278,通信,6,,8,3,11,ㄊㄨㄥ ㄒㄧㄣˋ,tōng xìn
8279,通行,6,,7,6,13,ㄊㄨㄥ ㄒㄧㄥˊ,tōng xíng
8280,同業,6,,9,1,10,ㄊㄨㄥˊ ㄧㄝˋ,tóng yè
8281,投保,6,,1,3,4,ㄊㄡˊ ㄅㄠˇ,tóu bǎo
8282,投奔,6,,8,0,8,ㄊㄡˊ ㄅㄣˋ,tóu bèn
8283,偷渡,6,,2,5,7,ㄊㄡ ㄉㄨˋ,tōu dù
8284,頭號,6,,5,3,8,ㄊㄡˊ ㄏㄠˋ,tóu hào
8285,投機,6,,9,2,11,ㄊㄡˊ ㄐㄧ,tóu jī
8286,頭巾,6,,8,4,12,ㄊㄡˊ ㄐㄧㄣ,tóu jīn
8287,投靠,6,,8,2,10,ㄊㄡˊ ㄎㄠˋ,tóu kào
8288,偷竊,6,,8,4,12,ㄊㄡ ㄑㄧㄝˋ,tōu qiè
8289,投入,6,,72,121,193,ㄊㄡˊ ㄖㄨˋ,tóu rù
8290,投射,6,,10,6,16,ㄊㄡˊ ㄕㄜˋ,tóu shè
8291,投身,6,,7,5,12,ㄊㄡˊ ㄕㄣ,tóu shēn
8292,偷襲,6,,7,1,8,ㄊㄡ ㄒㄧˊ,tōu xí
8293,頭銜,6,,12,4,16,ㄊㄡˊ ㄒㄧㄢˊ,tóu xián
8294,頭緒,6,,8,2,10,ㄊㄡˊ ㄒㄩˋ,tóu xù
8295,投注,6,,9,7,16,ㄊㄡˊ ㄓㄨˋ,tóu zhù
8296,頭子,6,,8,1,9,ㄊㄡˊ ˙ㄗ,tóu zi
8297,徒,6,,20,8,28,ㄊㄨˊ,tú
8298,圖表,6,,13,2,15,ㄊㄨˊ ㄅㄧㄠˇ,tú biǎo
8299,徒弟,6,,9,4,13,ㄊㄨˊ ㄉㄧˋ,tú dì
8300,突發,6,,10,7,17,ㄊㄨˊ ㄈㄚ,tú fā
8301,途徑,6,,22,13,35,ㄊㄨˊ ㄐㄧㄥˋ,tú jìng
8302,土壤,6,,11,114,125,ㄊㄨˇ ㄖㄤˇ,tǔ rǎng
8303,突如其來,6,,9,6,15,ㄊㄨˊ ㄖㄨˊ ㄑㄧˊ ㄌㄞˊ,tú rú qí lái
8304,屠殺,6,,12,7,19,ㄊㄨˊ ㄕㄚ,tú shā
8305,凸顯,6,,7,3,10,ㄊㄨˊ ㄒㄧㄢˇ,tú xiǎn
8306,突顯,6,,7,4,11,ㄊㄨˊ ㄒㄧㄢˇ,tú xiǎn
8307,圖形,6,,13,5,18,ㄊㄨˊ ㄒㄧㄥˊ,tú xíng
8308,團團轉,6,,5,0,5,ㄊㄨㄢˊ ㄊㄨㄢˊ ㄓㄨㄢˋ,tuán tuán zhuàn
8309,推崇,6,,10,4,14,ㄊㄨㄟ ㄔㄨㄥˊ,tuī chóng
8310,推斷,6,,8,3,11,ㄊㄨㄟ ㄉㄨㄢˋ,tuī duàn
8311,退化,6,,11,13,24,ㄊㄨㄟˋ ㄏㄨㄚˋ,tuì huà
8312,推進,6,,14,4,18,ㄊㄨㄟ ㄐㄧㄣˋ,tuī jìn
8313,推舉,6,,9,1,10,ㄊㄨㄟ ㄐㄩˇ,tuī jǔ
8314,退路,6,,4,1,5,ㄊㄨㄟˋ ㄌㄨˋ,tuì lù
8315,推論,6,,20,4,24,ㄊㄨㄟ ㄌㄨㄣˋ,tuī lùn
8316,退讓,6,,4,1,5,ㄊㄨㄟˋ ㄖㄤˋ,tuì ràng
8317,退縮,6,,14,12,26,ㄊㄨㄟˋ ㄙㄨㄛ,tuì suō
8318,推行,6,,16,24,40,ㄊㄨㄟ ㄒㄧㄥˊ,tuī xíng
8319,推展,6,,7,9,16,ㄊㄨㄟ ㄓㄢˇ,tuī zhǎn
8320,褪色,6,,6,3,9,ㄊㄨㄣˋ ㄙㄜˋ,tùn sè
8321,托,6,,16,9,25,ㄊㄨㄛ,tuō
8322,託,6,,15,4,19,ㄊㄨㄛ,tuō
8323,駝背,6,,6,5,11,ㄊㄨㄛˊ ㄅㄟˋ,tuó bèi
8324,妥當,6,,13,3,16,ㄊㄨㄛˇ ㄉㄤˋ,tuǒ dàng
8325,脫口而出,6,,7,1,8,ㄊㄨㄛ ㄎㄡˇ ㄦˊ ㄔㄨ,tuō kǒu ér chū
8326,托盤,6,,5,1,6,ㄊㄨㄛ ㄆㄢˊ,tuō pán
8327,妥善,6,,12,7,19,ㄊㄨㄛˇ ㄕㄢˋ,tuǒ shàn
8328,脫身,6,,7,2,9,ㄊㄨㄛ ㄕㄣ,tuō shēn
8329,脫手,6,,2,0,2,ㄊㄨㄛ ㄕㄡˇ,tuō shǒu
8330,妥協,6,,17,10,27,ㄊㄨㄛˇ ㄒㄧㄝˊ,tuǒ xié
8331,拓展,6,,12,7,19,ㄊㄨㄛˋ ㄓㄢˇ,tuò zhǎn
8332,瓦解,6,,14,7,21,ㄨㄚˇ ㄐㄧㄝˇ,wǎ jiě
8333,挖掘,6,,14,10,24,ㄨㄚ ㄐㄩㄝˊ,wā jué
8334,歪,6,,16,4,20,ㄨㄞ,wāi
8335,外觀,6,,14,28,42,ㄨㄞˋ ㄍㄨㄢ,wài guān
8336,外號,6,,4,4,8,ㄨㄞˋ ㄏㄠˋ,wài hào
8337,外匯,6,,8,4,12,ㄨㄞˋ ㄏㄨㄟˋ,wài huì
8338,外籍,6,,6,16,22,ㄨㄞˋ ㄐㄧˊ,wài jí
8339,外甥,6,,8,3,11,ㄨㄞˋ ㄕㄥ,wài shēng
8340,外圍,6,,9,8,17,ㄨㄞˋ ㄨㄟˊ,wài wéi
8341,外資,6,,7,9,16,ㄨㄞˋ ㄗ,wài zī
8342,玩伴,6,,7,3,10,ㄨㄢˊ ㄅㄢˋ,wán bàn
8343,完備,6,,6,4,10,ㄨㄢˊ ㄅㄟˋ,wán bèi
8344,完畢,6,,16,13,29,ㄨㄢˊ ㄅㄧˋ,wán bì
8345,完工,6,,9,15,24,ㄨㄢˊ ㄍㄨㄥ,wán gōng
8346,頑固,6,,9,1,10,ㄨㄢˊ ㄍㄨˋ,wán gù
8347,挽回,6,,9,4,13,ㄨㄢˇ ㄏㄨㄟˊ,wǎn huí
8348,挽救,6,,10,10,20,ㄨㄢˇ ㄐㄧㄡˋ,wǎn jiù
8349,萬能,6,,6,3,9,ㄨㄢˋ ㄋㄥˊ,wàn néng
8350,玩弄,6,,8,1,9,ㄨㄢˊ ㄋㄨㄥˋ,wán nòng
8351,頑皮,6,,5,4,9,ㄨㄢˊ ㄆㄧˊ,wán pí
8352,頑強,6,,7,3,10,ㄨㄢˊ ㄑㄧㄤˊ,wán qiáng
8353,宛如,6,,18,5,23,ㄨㄢˇ ㄖㄨˊ,wǎn rú
8354,完善,6,,13,11,24,ㄨㄢˊ ㄕㄢˋ,wán shàn
8355,萬歲,6,,12,5,17,ㄨㄢˋ ㄙㄨㄟˋ,wàn suì
8356,萬萬,6,,7,4,11,ㄨㄢˋ ㄨㄢˋ,wàn wàn
8357,惋惜,6,,7,2,9,ㄨㄢˋ ㄒㄧˊ,wàn xí
8358,蜿蜒,6,,8,7,15,ㄨㄢˇ ㄧㄢˊ,wǎn yán
8359,晚宴,6,,6,2,8,ㄨㄢˇ ㄧㄢˋ,wǎn yàn
8360,彎腰,6,,12,9,21,ㄨㄢ ㄧㄠ,wān yāo
8361,玩意兒,6,,10,3,13,ㄨㄢˊ ㄧㄜˋㄦ,wán yèr
8362,旺,6,,11,11,22,ㄨㄤˋ,wàng
8363,往返,6,,9,6,15,ㄨㄤˇ ㄈㄢˇ,wǎng fǎn
8364,亡國,6,,9,2,11,ㄨㄤˊ ㄍㄨㄛˊ,wáng guó
8365,往日,6,,8,2,10,ㄨㄤˇ ㄖˋ,wǎng rì
8366,旺盛,6,,11,15,26,ㄨㄤˋ ㄕㄥˋ,wàng shèng
8367,往生,6,,5,29,34,ㄨㄤˇ ㄕㄥ,wǎng shēng
8368,往昔,6,,8,3,11,ㄨㄤˇ ㄒㄧˊ,wǎng xí
8369,妄想,6,,11,4,15,ㄨㄤˋ ㄒㄧㄤˇ,wàng xiǎng
8370,望遠鏡,6,,12,16,28,ㄨㄤˋ ㄩㄢˇ ㄐㄧㄥˋ,wàng yuǎn jìng
8371,惟/唯,6,,32,5,37,ㄨㄟˊ,wéi
8372,為2,6,,2687,1519,4206,ㄨㄟˊ,wéi
8373,偽,6,,16,1,17,ㄨㄟˋ,wèi
8374,違背,6,,15,7,22,ㄨㄟˊ ㄅㄟˋ,wéi bèi
8375,微不足道,6,,9,3,12,ㄨㄟˊ ㄅㄨˋ ㄗㄨˊ ㄉㄠˋ,wéi bù zú dào
8376,唯獨/惟獨,6,,10,4,14,ㄨㄟˊ ㄉㄨˊ,wéi dú
8377,違法,6,,8,9,17,ㄨㄟˊ ㄈㄚˇ,wéi fǎ
8378,違反,6,,24,12,36,ㄨㄟˊ ㄈㄢˇ,wéi fǎn
8379,圍攻,6,,8,1,9,ㄨㄟˊ ㄍㄨㄥ,wéi gōng
8380,圍觀,6,,6,2,8,ㄨㄟˊ ㄍㄨㄢ,wéi guān
8381,危害,6,,11,30,41,ㄨㄟˊ ㄏㄞˋ,wéi hài
8382,危及,6,,5,6,11,ㄨㄟˊ ㄐㄧˊ,wéi jí
8383,畏懼,6,,14,5,19,ㄨㄟˋ ㄐㄩˋ,wèi jù
8384,慰勞,6,,3,2,5,ㄨㄟˋ ㄌㄠˋ,wèi lào
8385,未免,6,,13,2,15,ㄨㄟˋ ㄇㄧㄢˇ,wèi miǎn
8386,為難,6,,13,2,15,ㄨㄟˊ ㄋㄢˊ,wéi nán
8387,為期,6,,8,11,19,ㄨㄟˊ ㄑㄧˊ,wéi qí
8388,圍牆,6,,10,6,16,ㄨㄟˊ ㄑㄧㄤˊ,wéi qiáng
8389,委屈,6,,15,10,25,ㄨㄟˇ ㄑㄩ,wěi qū
8390,威權,6,,7,3,10,ㄨㄟ ㄑㄩㄢˊ,wēi quán
8391,為人,6,,12,2,14,ㄨㄟˊ ㄖㄣˊ,wéi rén
8392,微弱,6,,15,4,19,ㄨㄟˊ ㄖㄨㄛˋ,wéi ruò
8393,為生,6,,8,2,10,ㄨㄟˊ ㄕㄥ,wéi shēng
8394,維生,6,,7,20,27,ㄨㄟˊ ㄕㄥ,wéi shēng
8395,尾聲,6,,7,6,13,ㄨㄟˇ ㄕㄥ,wěi shēng
8396,為數,6,,8,2,10,ㄨㄟˊ ㄕㄨˋ,wéi shù
8397,萎縮,6,,10,13,23,ㄨㄟ ㄙㄨㄛ,wēi suō
8398,維他命/維生素,6,,19,43,62,ㄨㄟˊ ㄊㄚ ㄇㄧㄥˋ/ㄨㄟˊ ㄕㄥ ㄙㄨˋ,wéi tā mìng/wéi shēng sù
8399,委託,6,,13,5,18,ㄨㄟˇ ㄊㄨㄛ,wěi tuō
8400,慰問,6,,3,3,6,ㄨㄟˋ ㄨㄣˋ,wèi wèn
8401,維繫,6,,11,6,17,ㄨㄟˊ ㄒㄧˋ,wéi xì
8402,微小,6,,12,4,16,ㄨㄟˊ ㄒㄧㄠˇ,wéi xiǎo
8403,衛星,6,,12,31,43,ㄨㄟˋ ㄒㄧㄥ,wèi xīng
8404,維修,6,,11,18,29,ㄨㄟˊ ㄒㄧㄡ,wéi xiū
8405,威嚴,6,,8,2,10,ㄨㄟ ㄧㄢˊ,wēi yán
8406,唯有,6,,41,23,64,ㄨㄟˊ ㄧㄡˇ,wéi yǒu
8407,位於,6,,64,83,147,ㄨㄟˋ ㄩˊ,wèi yú
8408,違約,6,,2,4,6,ㄨㄟˊ ㄩㄝ,wéi yuē
8409,偽造,6,,7,2,9,ㄨㄟˋ ㄗㄠˋ,wèi zào
8410,未知,6,,16,10,26,ㄨㄟˋ ㄓ,wèi zhī
8411,偽裝,6,,10,4,14,ㄨㄟˋ ㄓㄨㄤ,wèi zhuāng
8412,文筆,6,,5,2,7,ㄨㄣˊ ㄅㄧˇ,wén bǐ
8413,穩固,6,,12,10,22,ㄨㄣˇ ㄍㄨˋ,wěn gù
8414,吻合,6,,9,2,11,ㄨㄣˇ ㄏㄜˊ,wěn hé
8415,問卷,6,,14,7,21,ㄨㄣˋ ㄐㄩㄢˋ,wèn juàn
8416,紊亂,6,,7,1,8,ㄨㄣˋ ㄌㄨㄢˋ,wèn luàn
8417,聞名,6,,18,12,30,ㄨㄣˊ ㄇㄧㄥˊ,wén míng
8418,問世,6,,11,4,15,ㄨㄣˋ ㄕˋ,wèn shì
8419,溫室,6,,6,79,85,ㄨㄣ ㄕˋ,wēn shì
8420,文書,6,,13,5,18,ㄨㄣˊ ㄕㄨ,wén shū
8421,文武,6,,12,1,13,ㄨㄣˊ ㄨˇ,wén wǔ
8422,文獻,6,,38,14,52,ㄨㄣˊ ㄒㄧㄢˋ,wén xiàn
8423,溫馨,6,,15,22,37,ㄨㄣ ㄒㄧㄣ,wēn xīn
8424,文藝,6,,13,5,18,ㄨㄣˊ ㄧˋ,wén yì
8425,瘟疫,6,,7,3,10,ㄨㄣ ㄧˋ,wēn yì
8426,文藝復興,6,,8,3,11,ㄨㄣˊ ㄧˋ ㄈㄨˋ ㄒㄧㄥ,wén yì fù xīng
8427,穩重,6,,6,3,9,ㄨㄣˇ ㄓㄨㄥˋ,wěn zhòng
8428,臥,6,,13,4,17,ㄨㄛˋ,wò
8429,臥病,6,,5,2,7,ㄨㄛˋ ㄅㄧㄥˋ,wò bìng
8430,臥床,6,,4,3,7,ㄨㄛˋ ㄔㄨㄤˊ,wò chuáng
8431,吾,6,,47,8,55,ㄨˊ,wú
8432,無比,6,,38,10,48,ㄨˊ ㄅㄧˇ,wú bǐ
8433,務必,6,,16,3,19,ㄨˋ ㄅㄧˋ,wù bì
8434,無不,6,,24,6,30,ㄨˊ ㄅㄨˋ,wú bù
8435,無常,6,,18,11,29,ㄨˊ ㄔㄤˊ,wú cháng
8436,無恥,6,,7,1,8,ㄨˊ ㄔˇ,wú chǐ
8437,無從,6,,17,3,20,ㄨˊ ㄘㄨㄥˊ,wú cóng
8438,誤導,6,,9,2,11,ㄨˋ ㄉㄠˇ,wù dǎo
8439,舞動,6,,5,2,7,ㄨˇ ㄉㄨㄥˋ,wǔ dòng
8440,無妨,6,,7,1,8,ㄨˊ ㄈㄤ,wú fāng
8441,無非,6,,10,5,15,ㄨˊ ㄈㄟ,wú fēi
8442,無辜,6,,21,14,35,ㄨˊ ㄍㄨ,wú gū
8443,五官,6,,7,2,9,ㄨˇ ㄍㄨㄢ,wǔ guān
8444,無關緊要,6,,8,1,9,ㄨˊ ㄍㄨㄢ ㄐㄧㄣˇ ㄧㄠˋ,wú guān jǐn yào
8445,烏龜/龜,6,,31,31,62,ㄨ ㄍㄨㄟ / ㄍㄨㄟ ,wū guī / guī
8446,烏黑,6,,5,1,6,ㄨ ㄏㄟ,wū hēi
8447,無家可歸,6,,3,5,8,ㄨˊ ㄐㄧㄚ ㄎㄜˇ ㄍㄨㄟ,wú jiā kě guī
8448,物件,6,,15,5,20,ㄨˋ ㄐㄧㄢˋ,wù jiàn
8449,無盡,6,,11,3,14,ㄨˊ ㄐㄧㄣˋ,wú jìn
8450,無可奈何,6,,13,3,16,ㄨˊ ㄎㄜˇ ㄋㄞˋ ㄏㄜˊ,wú kě nài hé
8451,無力,6,,28,11,39,ㄨˊ ㄌㄧˋ,wú lì
8452,無名,6,,9,3,12,ㄨˊ ㄇㄧㄥˊ,wú míng
8453,無名指,6,,2,1,3,ㄨˊ ㄇㄧㄥˊ ㄓˇ,wú míng zhǐ
8454,無奈,6,,32,20,52,ㄨˊ ㄋㄞˋ,wú nài
8455,無能,6,,15,0,15,ㄨˊ ㄋㄥˊ,wú néng
8456,無能為力,6,,9,4,13,ㄨˊ ㄋㄥˊ ㄨㄟˊ ㄌㄧˋ,wú néng wéi lì
8457,無期徒刑,6,,2,2,4,ㄨˊ ㄑㄧˊ ㄊㄨˊ ㄒㄧㄥˊ,wú qí tú xíng
8458,侮辱,6,,13,2,15,ㄨˇ ㄖㄨˋ,wǔ rù
8459,無視,6,,5,3,8,ㄨˊ ㄕˋ,wú shì
8460,務實,6,,11,8,19,ㄨˋ ㄕˊ,wù shí
8461,無時無刻,6,,6,2,8,ㄨˊ ㄕˊ ㄨˊ ㄎㄜˋ,wú shí wú kè
8462,無私,6,,8,16,24,ㄨˊ ㄙ,wú sī
8463,無所不在,6,,7,2,9,ㄨˊ ㄙㄨㄛˇ ㄅㄨˊ ㄗㄞ,wú suǒ bú zài
8464,無所事事,6,,5,3,8,ㄨˊ ㄙㄨㄛˇ ㄕˋ ㄕˋ,wú suǒ shì shì
8465,晤談,6,,9,1,10,ㄨˋ ㄊㄢˊ,wù tán
8466,無為,6,,7,2,9,ㄨˊ ㄨㄟˊ,wú wéi
8467,武俠,6,,36,1,37,ㄨˇ ㄒㄧㄚˊ,wǔ xiá
8468,無心,6,,9,9,18,ㄨˊ ㄒㄧㄣ,wú xīn
8469,烏鴉,6,,18,2,20,ㄨ ㄧㄚ,wū yā
8470,無言,6,,7,2,9,ㄨˊ ㄧㄢˊ,wú yán
8471,武藝,6,,8,2,10,ㄨˇ ㄧˋ,wǔ yì
8472,烏雲,6,,11,5,16,ㄨ ㄩㄣˊ,wū yún
8473,物種,6,,13,48,61,ㄨˋ ㄓㄨㄥˇ,wù zhǒng
8474,武裝,6,,21,29,50,ㄨˇ ㄓㄨㄤ,wǔ zhuāng
8475,物資,6,,13,49,62,ㄨˋ ㄗ,wù zī
8476,席,6,,14,19,33,ㄒㄧˊ,xí
8477,係,6,,26,15,41,ㄒㄧˋ,xì
8478,夕,6,,12,9,21,ㄒㄧˋ,xì
8479,細胞,6,,115,107,222,ㄒㄧˋ ㄅㄠ,xì bāo
8480,席次,6,,2,4,6,ㄒㄧˊ ㄘˋ,xí cì
8481,習得,6,,10,2,12,ㄒㄧˊㄉㄜˊ,xí dé
8482,襲擊,6,,16,10,26,ㄒㄧˊ ㄐㄧˊ,xí jí
8483,細節,6,,60,28,88,ㄒㄧˋ ㄐㄧㄝˊ,xì jié
8484,喜樂,6,,13,4,17,ㄒㄧˇ ㄌㄜˋ,xǐ lè
8485,系列,6,,56,32,88,ㄒㄧˋ ㄌㄧㄝˋ,xì liè
8486,溪流,6,,8,15,23,ㄒㄧ ㄌㄧㄡˊ,xī liú
8487,熄滅/熄,6,,13,7,20,ㄒㄧˊ ㄇㄧㄝˋ/ㄒㄧˊ,xí miè/xí
8488,細膩,6,,14,9,23,ㄒㄧˋ ㄋㄧˋ,xì nì
8489,喜怒哀樂,6,,4,2,6,ㄒㄧˇ ㄋㄨˋ ㄞ ㄌㄜˋ,xǐ nù āi lè
8490,稀奇,6,,8,5,13,ㄒㄧ ㄑㄧˊ,xī qí
8491,吸取,6,,7,5,12,ㄒㄧ ㄑㄩˇ,xī qǔ
8492,昔日,6,,17,9,26,ㄒㄧˊ ㄖˋ,xí rì
8493,稀少,6,,6,9,15,ㄒㄧ ㄕㄠˇ,xī shǎo
8494,犧牲,6,,48,31,79,ㄒㄧ ㄕㄥ,xī shēng
8495,吸食,6,,4,2,6,ㄒㄧ ㄕˊ,xī shí
8496,細微,6,,15,8,23,ㄒㄧˋ ㄨㄟˊ,xì wéi
8497,息息相關,6,,9,12,21,ㄒㄧˊ ㄒㄧˊ ㄒㄧㄤ ㄍㄨㄢ,xí xí xiāng guān
8498,習性,6,,10,13,23,ㄒㄧˊ ㄒㄧㄥˋ,xí xìng
8499,稀有,6,,6,6,12,ㄒㄧ ㄧㄡˇ,xī yǒu
8500,細緻,6,,13,6,19,ㄒㄧˋ ㄓˋ,xì zhì
8501,瞎,6,,9,2,11,ㄒㄧㄚ,xiā
8502,狹隘,6,,8,2,10,ㄒㄧㄚˊ ㄞˋ,xiá ài
8503,瑕疵,6,,8,4,12,ㄒㄧㄚˊ ㄘ,xiá cī
8504,下達,6,,7,3,10,ㄒㄧㄚˋ ㄉㄚˊ,xià dá
8505,下毒,6,,4,1,5,ㄒㄧㄚˋ ㄉㄨˊ,xià dú
8506,峽谷,6,,10,6,16,ㄒㄧㄚˊ ㄍㄨˇ,xiá gǔ
8507,下滑,6,,7,7,14,ㄒㄧㄚˋ ㄏㄨㄚˊ,xià huá
8508,嚇壞,6,,11,3,14,ㄒㄧㄚˋ ㄏㄨㄞˋ,xià huài
8509,下流,6,,6,1,7,ㄒㄧㄚˋ ㄌㄧㄡˊ,xià liú
8510,下落,6,,10,3,13,ㄒㄧㄚˋ ㄌㄨㄛˋ,xià luò
8511,蝦米,6,,4,1,5,ㄒㄧㄚ ㄇㄧˇ,xiā mǐ
8512,下手,6,,17,3,20,ㄒㄧㄚˋ ㄕㄡˇ,xià shǒu
8513,下屬,6,,12,1,13,ㄒㄧㄚˋ ㄕㄨˇ,xià shǔ
8514,下文,6,,5,2,7,ㄒㄧㄚˋ ㄨㄣˊ,xià wén
8515,狹小,6,,8,5,13,ㄒㄧㄚˊ ㄒㄧㄠˇ,xiá xiǎo
8516,下意識,6,,7,1,8,ㄒㄧㄚˋ ㄧˋ ㄕˋ,xià yì shì
8517,下游,6,,9,23,32,ㄒㄧㄚˋ ㄧㄡˊ,xià yóu
8518,狹窄,6,,16,5,21,ㄒㄧㄚˊ ㄓㄞˇ,xiá zhǎi
8519,獻,6,,12,6,18,ㄒㄧㄢˋ,xiàn
8520,險,6,,12,10,22,ㄒㄧㄢˇ,xiǎn
8521,顯出,6,,8,1,9,ㄒㄧㄢˇ ㄔㄨ,xiǎn chū
8522,限定,6,,5,3,8,ㄒㄧㄢˋ ㄉㄧㄥˋ,xiàn dìng
8523,限度,6,,9,3,12,ㄒㄧㄢˋ ㄉㄨˋ,xiàn dù
8524,險惡,6,,6,3,9,ㄒㄧㄢˇ ㄜˋ,xiǎn è
8525,顯而易見,6,,8,1,9,ㄒㄧㄢˇ ㄦˊ ㄧˋ ㄐㄧㄢˋ,xiǎn ér yì jiàn
8526,憲法,6,,14,18,32,ㄒㄧㄢˋ ㄈㄚˇ,xiàn fǎ
8527,先鋒,6,,10,4,14,ㄒㄧㄢ ㄈㄥ,xiān fēng
8528,陷害,6,,7,3,10,ㄒㄧㄢˋ ㄏㄞˋ,xiàn hài
8529,顯赫,6,,8,2,10,ㄒㄧㄢˇ ㄏㄜˋ,xiǎn hè
8530,閒話,6,,6,1,7,ㄒㄧㄢˊ ㄏㄨㄚˋ,xián huà
8531,鮮活,6,,5,3,8,ㄒㄧㄢ ㄏㄨㄛˊ,xiān huó
8532,現況,6,,10,9,19,ㄒㄧㄢˋ ㄎㄨㄤˋ,xiàn kuàng
8533,先例,6,,5,2,7,ㄒㄧㄢ ㄌㄧˋ,xiān lì
8534,顯露,6,,8,1,9,ㄒㄧㄢˇ ㄌㄨˋ,xiǎn lù
8535,鮮美,6,,4,2,6,ㄒㄧㄢ ㄇㄟˇ,xiān měi
8536,仙女,6,,17,2,19,ㄒㄧㄢ ㄋㄩˇ,xiān nǚ
8537,先驅,6,,12,5,17,ㄒㄧㄢ ㄑㄩ,xiān qū
8538,現任,6,,10,12,22,ㄒㄧㄢˋ ㄖㄣˋ,xiàn rèn
8539,陷入,6,,77,45,122,ㄒㄧㄢˋ ㄖㄨˋ,xiàn rù
8540,現身,6,,13,3,16,ㄒㄧㄢˋ ㄕㄣ,xiàn shēn
8541,線索,6,,35,8,43,ㄒㄧㄢˋ ㄙㄨㄛˇ,xiàn suǒ
8542,纖維,6,,23,59,82,ㄒㄧㄢ ㄨㄟˊ,xiān wéi
8543,顯微鏡,6,,8,15,23,ㄒㄧㄢˇ ㄨㄟˊ ㄐㄧㄥˋ,xiǎn wéi jìng
8544,閒暇,6,,5,3,8,ㄒㄧㄢˊ ㄒㄧㄚˊ,xián xiá
8545,鮮血,6,,14,3,17,ㄒㄧㄢ ㄒㄧㄝˇ,xiān xiě
8546,現行,6,,7,3,10,ㄒㄧㄢˋ ㄒㄧㄥˊ,xiàn xíng
8547,線性,6,,6,1,7,ㄒㄧㄢˋ ㄒㄧㄥˋ,xiàn xìng
8548,先行,6,,12,4,16,ㄒㄧㄢ ㄒㄧㄥˊ,xiān xíng
8549,嫌疑,6,,7,2,9,ㄒㄧㄢˊ ㄧˊ,xián yí
8550,限於,6,,17,2,19,ㄒㄧㄢˋ ㄩˊ,xiàn yú
8551,現狀,6,,16,6,22,ㄒㄧㄢˋ ㄓㄨㄤˋ,xiàn zhuàng
8552,鮮,6,,11,40,51,ㄒㄧㄢ/ㄒㄧㄢˇ,xiān/xiǎn
8553,相差,6,,11,9,20,ㄒㄧㄤ ㄔㄚ,xiāng chā
8554,相傳,6,,18,13,31,ㄒㄧㄤ ㄔㄨㄢˊ,xiāng chuán
8555,嚮導,6,,6,5,11,ㄒㄧㄤˋ ㄉㄠˇ,xiàng dǎo
8556,相等,6,,7,1,8,ㄒㄧㄤ ㄉㄥˇ,xiāng děng
8557,相仿,6,,5,1,6,ㄒㄧㄤ ㄈㄤˇ,xiāng fǎng
8558,相符,6,,7,1,8,ㄒㄧㄤ ㄈㄨˊ,xiāng fú
8559,相隔,6,,7,4,11,ㄒㄧㄤ ㄍㄜˊ,xiāng gé
8560,祥和,6,,7,9,16,ㄒㄧㄤˊ ㄏㄜˊ,xiáng hé
8561,相會,6,,8,1,9,ㄒㄧㄤ ㄏㄨㄟˋ,xiāng huì
8562,相機,6,,14,26,40,ㄒㄧㄤˋ ㄐㄧ,xiàng jī
8563,相繼,6,,14,10,24,ㄒㄧㄤ ㄐㄧˋ,xiāng jì
8564,想見,6,,9,4,13,ㄒㄧㄤˇ ㄐㄧㄢˋ,xiǎng jiàn
8565,相見,6,,13,2,15,ㄒㄧㄤ ㄐㄧㄢˋ,xiāng jiàn
8566,相較,6,,20,21,41,ㄒㄧㄤ ㄐㄧㄠˋ,xiāng jiào
8567,詳盡,6,,10,2,12,ㄒㄧㄤˊ ㄐㄧㄣˋ,xiáng jìn
8568,想開,6,,2,1,3,ㄒㄧㄤˇ ㄎㄞ,xiǎng kāi
8569,享樂,6,,9,3,12,ㄒㄧㄤˇ ㄌㄜˋ,xiǎng lè
8570,相連,6,,14,5,19,ㄒㄧㄤ ㄌㄧㄢˊ,xiāng lián
8571,響亮,6,,9,4,13,ㄒㄧㄤˇ ㄌㄧㄤˋ,xiǎng liàng
8572,相貌,6,,8,1,9,ㄒㄧㄤˋ ㄇㄠˋ,xiàng mào
8573,鄉民,6,,4,4,8,ㄒㄧㄤ ㄇㄧㄣˊ,xiāng mín
8574,香噴噴,6,,4,3,7,ㄒㄧㄤ ㄆㄣ ㄆㄣ,xiāng pēn pēn
8575,詳情,6,,4,0,4,ㄒㄧㄤˊ ㄑㄧㄥˊ,xiáng qíng
8576,相容,6,,7,3,10,ㄒㄧㄤ ㄖㄨㄥˊ,xiāng róng
8577,響聲,6,,8,0,8,ㄒㄧㄤˇ ㄕㄥ,xiǎng shēng
8578,相識,6,,10,3,13,ㄒㄧㄤ ㄕˋ,xiāng shì
8579,相通,6,,7,5,12,ㄒㄧㄤ ㄊㄨㄥ,xiāng tōng
8580,鄉土,6,,7,4,11,ㄒㄧㄤ ㄊㄨˇ,xiāng tǔ
8581,嚮往,6,,15,13,28,ㄒㄧㄤˋ ㄨㄤˇ,xiàng wǎng
8582,像樣,6,,5,1,6,ㄒㄧㄤˋ ㄧㄤˋ,xiàng yàng
8583,響應,6,,7,16,23,ㄒㄧㄤˇ ㄧㄥˋ,xiǎng yìng
8584,相應,6,,10,1,11,ㄒㄧㄤ ㄧㄥˋ,xiāng yìng
8585,享用,6,,13,11,24,ㄒㄧㄤˇ ㄩㄥˋ,xiǎng yòng
8586,享有,6,,22,10,32,ㄒㄧㄤˇ ㄧㄡˇ,xiǎng yǒu
8587,象徵,6,,48,47,95,ㄒㄧㄤˋ ㄓㄥ,xiàng zhēng
8588,削,6,,7,16,23,ㄒㄧㄠ / ㄒㄩㄝˋ,xiāo / xuè
8589,小丑,6,,5,4,9,ㄒㄧㄠˇ ㄔㄡˇ,xiǎo chǒu
8590,消毒,6,,5,14,19,ㄒㄧㄠ ㄉㄨˊ,xiāo dú
8591,效法,6,,9,6,15,ㄒㄧㄠˋ ㄈㄚˇ,xiào fǎ
8592,消防,6,,2,9,11,ㄒㄧㄠ ㄈㄤˊ,xiāo fáng
8593,消耗,6,,17,32,49,ㄒㄧㄠ ㄏㄠˋ,xiāo hào
8594,小徑,6,,16,3,19,ㄒㄧㄠˇ ㄐㄧㄥˋ,xiǎo jìng
8595,笑咪咪,6,,3,2,5,ㄒㄧㄠˋ ㄇㄧ ㄇㄧ,xiào mī mī
8596,效能,6,,16,5,21,ㄒㄧㄠˋ ㄋㄥˊ,xiào néng
8597,消遣,6,,8,2,10,ㄒㄧㄠ ㄑㄧㄢˇ,xiāo qiǎn
8598,小巧,6,,5,2,7,ㄒㄧㄠˇ ㄑㄧㄠˇ,xiǎo qiǎo
8599,小人,6,,22,4,26,ㄒㄧㄠˇ ㄖㄣˊ,xiǎo rén
8600,瀟灑,6,,9,2,11,ㄒㄧㄠ ㄙㄚˇ,xiāo sǎ
8601,消逝,6,,9,4,13,ㄒㄧㄠ ㄕˋ,xiāo shì
8602,蕭條,6,,8,8,16,ㄒㄧㄠ ㄊㄧㄠˊ,xiāo tiáo
8603,肖像,6,,9,4,13,ㄒㄧㄠˋ ㄒㄧㄤˋ,xiào xiàng
8604,小心翼翼,6,,22,7,29,ㄒㄧㄠˇ ㄒㄧㄣ ㄧˋ ㄧˋ,xiǎo xīn yì yì
8605,逍遙,6,,8,1,9,ㄒㄧㄠ ㄧㄠˊ,xiāo yáo
8606,效益,6,,16,16,32,ㄒㄧㄠˋ ㄧˋ,xiào yì
8607,效用,6,,10,4,14,ㄒㄧㄠˋ ㄩㄥˋ,xiào yòng
8608,效忠,6,,8,2,10,ㄒㄧㄠˋ ㄓㄨㄥ,xiào zhōng
8609,孝子,6,,5,1,6,ㄒㄧㄠˋ ㄗˇ,xiào zǐ
8610,邪,6,,15,4,19,ㄒㄧㄝˊ,xié
8611,瀉,6,,6,1,7,ㄒㄧㄝˋ,xiè
8612,謝,6,,20,22,42,ㄒㄧㄝˋ,xiè
8613,協定,6,,12,18,30,ㄒㄧㄝˊ ㄉㄧㄥˋ,xié dìng
8614,邪惡,6,,26,4,30,ㄒㄧㄝˊ ㄜˋ,xié è
8615,血汗,6,,3,4,7,ㄒㄧㄝˇ ㄏㄢˋ,xiě hàn
8616,血跡,6,,7,4,11,ㄒㄧㄝˇ ㄐㄧ,xiě jī
8617,洩漏,6,,6,3,9,ㄒㄧㄝˋ ㄌㄡˋ,xiè lòu
8618,協商,6,,10,21,31,ㄒㄧㄝˊ ㄕㄤ,xié shāng
8619,寫實,6,,17,7,24,ㄒㄧㄝˇ ㄕˊ,xiě shí
8620,謝天謝地,6,,4,1,5,ㄒㄧㄝˋ ㄊㄧㄢ ㄒㄧㄝˋ ㄉㄧˋ,xiè tiān xiè dì
8621,協調,6,,31,20,51,ㄒㄧㄝˊ ㄊㄧㄠˊ,xié tiáo
8622,血統,6,,10,3,13,ㄒㄧㄝˇ ㄊㄨㄥˇ,xiě tǒng
8623,些微,6,,5,4,9,ㄒㄧㄝ ㄨㄟˊ,xiē wéi
8624,血腥,6,,7,10,17,ㄒㄧㄝˇ ㄒㄧㄥ,xiě xīng
8625,些許,6,,11,6,17,ㄒㄧㄝ ㄒㄩˇ,xiē xǔ
8626,協議,6,,14,25,39,ㄒㄧㄝˊ ㄧˋ,xié yì
8627,謝意,6,,4,2,6,ㄒㄧㄝˋ ㄧˋ,xiè yì
8628,血緣,6,,7,4,11,ㄒㄧㄝˇ ㄩㄢˊ,xiě yuán
8629,心安,6,,4,2,6,ㄒㄧㄣ ㄢ,xīn ān
8630,心不在焉,6,,8,1,9,ㄒㄧㄣ ㄅㄨˊ ㄗㄞˋ ㄧㄢ,xīn bú zài yān
8631,心腸,6,,10,3,13,ㄒㄧㄣ ㄔㄤˊ,xīn cháng
8632,新陳代謝,6,,7,6,13,ㄒㄧㄣ ㄔㄣˊ ㄉㄞˋ ㄒㄧㄝˋ,xīn chén dài xiè
8633,心地,6,,8,3,11,ㄒㄧㄣ ㄉㄧˋ,xīn dì
8634,信奉,6,,9,9,18,ㄒㄧㄣˋ ㄈㄥˋ,xìn fèng
8635,信服,6,,8,1,9,ㄒㄧㄣˋ ㄈㄨˊ,xìn fú
8636,心甘情願,6,,7,3,10,ㄒㄧㄣ ㄍㄢ ㄑㄧㄥˊ ㄩㄢˋ,xīn gān qíng yuàn
8637,信函,6,,5,2,7,ㄒㄧㄣˋ ㄏㄢˊ,xìn hán
8638,心境,6,,15,13,28,ㄒㄧㄣ ㄐㄧㄥˋ,xīn jìng
8639,辛勞,6,,6,12,18,ㄒㄧㄣ ㄌㄠˊ,xīn láo
8640,心靈,6,,147,85,232,ㄒㄧㄣ ㄌㄧㄥˊ,xīn líng
8641,心滿意足,6,,8,1,9,ㄒㄧㄣ ㄇㄢˇ ㄧˋ ㄗㄨˊ,xīn mǎn yì zú
8642,信念,6,,44,21,65,ㄒㄧㄣˋ ㄋㄧㄢˋ,xìn niàn
8643,欣然,6,,10,2,12,ㄒㄧㄣ ㄖㄢˊ,xīn rán
8644,心聲,6,,9,7,16,ㄒㄧㄣ ㄕㄥ,xīn shēng
8645,新手,6,,11,10,21,ㄒㄧㄣ ㄕㄡˇ,xīn shǒu
8646,心碎,6,,6,1,7,ㄒㄧㄣ ㄙㄨㄟˋ,xīn suì
8647,心態,6,,43,44,87,ㄒㄧㄣ ㄊㄞˋ,xīn tài
8648,心疼,6,,8,22,30,ㄒㄧㄣ ㄊㄥˊ,xīn téng
8649,心跳,6,,18,5,23,ㄒㄧㄣ ㄊㄧㄠˋ,xīn tiào
8650,心頭,6,,27,5,32,ㄒㄧㄣ ㄊㄡˊ,xīn tóu
8651,欣慰,6,,9,15,24,ㄒㄧㄣ ㄨㄟˋ,xīn wèi
8652,欣喜,6,,9,3,12,ㄒㄧㄣ ㄒㄧˇ,xīn xǐ
8653,心性,6,,5,3,8,ㄒㄧㄣ ㄒㄧㄥˋ,xīn xìng
8654,新興,6,,15,20,35,ㄒㄧㄣ ㄒㄧㄥ,xīn xīng
8655,心胸,6,,13,7,20,ㄒㄧㄣ ㄒㄩㄥ,xīn xiōng
8656,心虛,6,,5,3,8,ㄒㄧㄣ ㄒㄩ,xīn xū
8657,心血,6,,8,15,23,ㄒㄧㄣ ㄒㄩㄝˋ,xīn xuè
8658,新穎,6,,6,2,8,ㄒㄧㄣ ㄧㄥˇ,xīn yǐng
8659,心願,6,,13,21,34,ㄒㄧㄣ ㄩㄢˋ,xīn yuàn
8660,心智,6,,70,4,74,ㄒㄧㄣ ㄓˋ,xīn zhì
8661,新知,6,,11,3,14,ㄒㄧㄣ ㄓ,xīn zhī
8662,刑,6,,8,1,9,ㄒㄧㄥˊ,xíng
8663,形成,6,,165,164,329,ㄒㄧㄥˊ ㄔㄥˊ,xíng chéng
8664,興高采烈,6,,8,1,9,ㄒㄧㄥˋ ㄍㄠ ㄘㄞˇ ㄌㄧㄝˋ,xìng gāo cǎi liè
8665,星光,6,,5,3,8,ㄒㄧㄥ ㄍㄨㄤ,xīng guāng
8666,行進,6,,8,6,14,ㄒㄧㄥˊ ㄐㄧㄣˋ,xíng jìn
8667,行徑,6,,11,4,15,ㄒㄧㄥˊ ㄐㄧㄥˋ,xíng jìng
8668,行禮,6,,9,2,11,ㄒㄧㄥˊ ㄌㄧˇ,xíng lǐ
8669,興隆,6,,4,1,5,ㄒㄧㄥ ㄌㄨㄥˊ,xīng lóng
8670,醒目,6,,5,2,7,ㄒㄧㄥˇ ㄇㄨˋ,xǐng mù
8671,性能,6,,5,3,8,ㄒㄧㄥˋ ㄋㄥˊ,xìng néng
8672,興起2,6,,23,13,36,ㄒㄧㄥˋ ㄑㄧˇ,xìng qǐ
8673,性情,6,,17,3,20,ㄒㄧㄥˋ ㄑㄧㄥˊ,xìng qíng
8674,星球,6,,11,7,18,ㄒㄧㄥ ㄑㄧㄡˊ,xīng qiú
8675,行人,6,,14,5,19,ㄒㄧㄥˊ ㄖㄣˊ,xíng rén
8676,行善,6,,5,15,20,ㄒㄧㄥˊ ㄕㄢˋ,xíng shàn
8677,刑事,6,,6,4,10,ㄒㄧㄥˊ ㄕˋ,xíng shì
8678,形勢,6,,19,3,22,ㄒㄧㄥˊ ㄕˋ,xíng shì
8679,行事,6,,29,4,33,ㄒㄧㄥˊ ㄕˋ,xíng shì
8680,行駛,6,,10,9,19,ㄒㄧㄥˊ ㄕˇ,xíng shǐ
8681,姓氏,6,,9,1,10,ㄒㄧㄥˋ ㄕˋ,xìng shì
8682,型態,6,,42,35,77,ㄒㄧㄥˊ ㄊㄞˋ,xíng tài
8683,形態,6,,43,13,56,ㄒㄧㄥˊ ㄊㄞˋ,xíng tài
8684,性向,6,,6,2,8,ㄒㄧㄥˋ ㄒㄧㄤˋ,xìng xiàng
8685,性行為,6,,12,1,13,ㄒㄧㄥˋ ㄒㄧㄥˊ ㄨㄟˊ,xìng xíng wéi
8686,性慾,6,,7,0,7,ㄒㄧㄥˋ ㄩˋ,xìng yù
8687,興致,6,,14,3,17,ㄒㄧㄥˋ ㄓˋ,xìng zhì
8688,性子,6,,8,2,10,ㄒㄧㄥˋ ˙ㄗ,xìng zi
8689,行蹤,6,,7,2,9,ㄒㄧㄥˊ ㄗㄨㄥ,xíng zōng
8690,凶/兇,6,,20,28,48,ㄒㄩㄥ,xiōng
8691,凶狠/兇狠,6,,6,2,8,ㄒㄩㄥ ㄏㄣˇ,xiōng hěn
8692,胸懷,6,,8,2,10,ㄒㄩㄥ ㄏㄨㄞˊ,xiōng huái
8693,胸襟,6,,9,2,11,ㄒㄩㄥ ㄐㄧㄣ,xiōng jīn
8694,胸口,6,,15,2,17,ㄒㄩㄥ ㄎㄡˇ,xiōng kǒu
8695,胸膛,6,,9,1,10,ㄒㄩㄥ ㄊㄤˊ,xiōng táng
8696,雄偉,6,,5,4,9,ㄒㄩㄥˊ ㄨㄟˇ,xióng wěi
8697,洶湧,6,,10,6,16,ㄒㄩㄥ ㄩㄥˇ,xiōng yǒng
8698,兄長,6,,8,1,9,ㄒㄩㄥ ㄓㄤˇ,xiōng zhǎng
8699,嗅,6,,7,2,9,ㄒㄧㄡˋ,xiù
8700,秀,6,,5,14,19,ㄒㄧㄡˋ,xiù
8701,休,6,,10,19,29,ㄒㄧㄡ,xiū
8702,修補,6,,10,10,20,ㄒㄧㄡ ㄅㄨˇ,xiū bǔ
8703,修長,6,,5,1,6,ㄒㄧㄡ ㄔㄤˊ,xiū cháng
8704,羞恥,6,,8,0,8,ㄒㄧㄡ ㄔˇ,xiū chǐ
8705,修訂,6,,7,3,10,ㄒㄧㄡ ㄉㄧㄥˋ,xiū dìng
8706,修復,6,,13,29,42,ㄒㄧㄡ ㄈㄨˋ,xiū fù
8707,修建,6,,11,8,19,ㄒㄧㄡ ㄐㄧㄢˋ,xiū jiàn
8708,修剪,6,,7,13,20,ㄒㄧㄡ ㄐㄧㄢˇ,xiū jiǎn
8709,嗅覺,6,,11,8,19,ㄒㄧㄡˋ ㄐㄩㄝˊ,xiù jué
8710,羞愧,6,,11,1,12,ㄒㄧㄡ ㄎㄨㄟˋ,xiū kuì
8711,羞辱,6,,13,1,14,ㄒㄧㄡ ㄖㄨˋ,xiū rù
8712,修飾,6,,6,2,8,ㄒㄧㄡ ㄕˋ,xiū shì
8713,修行,6,,13,13,26,ㄒㄧㄡ ㄒㄧㄥˊ,xiū xíng
8714,休養,6,,8,5,13,ㄒㄧㄡ ㄧㄤˇ,xiū yǎng
8715,修養,6,,9,9,18,ㄒㄧㄡ ㄧㄤˇ,xiū yǎng
8716,許,6,,19,26,45,ㄒㄩˇ,xǔ
8717,虛構,6,,14,2,16,ㄒㄩ ㄍㄡˋ,xū gòu
8718,虛假,6,,8,1,9,ㄒㄩ ㄐㄧㄚˇ,xū jiǎ
8719,許久,6,,12,3,15,ㄒㄩˇ ㄐㄧㄡˇ,xǔ jiǔ
8720,許可,6,,12,7,19,ㄒㄩˇ ㄎㄜˇ,xǔ kě
8721,虛擬,6,,13,4,17,ㄒㄩ ㄋㄧˇ,xū nǐ
8722,虛榮,6,,6,1,7,ㄒㄩ ㄖㄨㄥˊ,xū róng
8723,虛弱,6,,15,6,21,ㄒㄩ ㄖㄨㄛˋ,xū ruò
8724,敘述,6,,48,9,57,ㄒㄩˋ ㄕㄨˋ,xù shù
8725,虛偽,6,,9,2,11,ㄒㄩ ㄨㄟˋ,xū wèi
8726,虛心,6,,5,5,10,ㄒㄩ ㄒㄧㄣ,xū xīn
8727,蓄意,6,,8,2,10,ㄒㄩˋ ㄧˋ,xù yì
8728,須知,6,,4,0,4,ㄒㄩ ㄓ,xū zhī
8729,懸,6,,11,5,16,ㄒㄩㄢˊ,xuán
8730,選拔,6,,5,4,9,ㄒㄩㄢˇ ㄅㄚˊ,xuǎn bá
8731,宣稱,6,,31,7,38,ㄒㄩㄢ ㄔㄥ,xuān chēng
8732,選定,6,,9,3,12,ㄒㄩㄢˇ ㄉㄧㄥˋ,xuǎn dìng
8733,宣告,6,,18,8,26,ㄒㄩㄢ ㄍㄠˋ,xuān gào
8734,懸掛,6,,8,2,10,ㄒㄩㄢˊ ㄍㄨㄚˋ,xuán guà
8735,旋律,6,,12,4,16,ㄒㄩㄢˊ ㄌㄩˋ,xuán lǜ
8736,宣示,6,,7,3,10,ㄒㄩㄢ ㄕˋ,xuān shì
8737,漩渦,6,,7,4,11,ㄒㄩㄢˊ ㄨㄛ,xuán wō
8738,選項,6,,6,4,10,ㄒㄩㄢˇ ㄒㄧㄤˋ,xuǎn xiàng
8739,懸崖/崖,6,,22,10,32,ㄒㄩㄢˊ ㄧㄞˊ/ㄧㄞˊ,xuán yái/yái
8740,宣言,6,,10,4,14,ㄒㄩㄢ ㄧㄢˊ,xuān yán
8741,宣揚,6,,11,6,17,ㄒㄩㄢ ㄧㄤˊ,xuān yáng
8742,炫耀,6,,11,3,14,ㄒㄩㄢˋ ㄧㄠˋ,xuàn yào
8743,雪花,6,,7,5,12,ㄒㄩㄝˇ ㄏㄨㄚ,xuě huā
8744,削弱,6,,9,4,13,ㄒㄩㄝˋ ㄖㄨㄛˋ,xuè ruò
8745,學識,6,,8,1,9,ㄒㄩㄝˊ ㄕˋ,xué shì
8746,學說,6,,15,4,19,ㄒㄩㄝˊ ㄕㄨㄛ,xué shuō
8747,學堂,6,,14,7,21,ㄒㄩㄝˊ ㄊㄤˊ,xué táng
8748,學徒,6,,6,3,9,ㄒㄩㄝˊ ㄊㄨˊ,xué tú
8749,學制,6,,2,0,2,ㄒㄩㄝˊ ㄓˋ,xué zhì
8750,學子,6,,5,6,11,ㄒㄩㄝˊ ㄗˇ,xué zǐ
8751,尋常,6,,14,2,16,ㄒㄩㄣˊ ㄔㄤˊ,xún cháng
8752,巡迴,6,,9,7,16,ㄒㄩㄣˊ ㄏㄨㄟˊ,xún huí
8753,巡邏,6,,7,7,14,ㄒㄩㄣˊ ㄌㄨㄛˊ,xún luó
8754,尋覓,6,,7,3,10,ㄒㄩㄣˊ ㄇㄧˋ,xún mì
8755,巡視,6,,10,10,20,ㄒㄩㄣˊ ㄕˋ,xún shì
8756,啞,6,,5,3,8,ㄧㄚˇ,yǎ
8757,壓低,6,,10,4,14,ㄧㄚ ㄉㄧ,yā dī
8758,丫頭,6,,13,1,14,ㄧㄚ ˙ㄊㄡ,yā tou
8759,壓抑,6,,39,10,49,ㄧㄚ ㄧˋ,yā yì
8760,壓制,6,,10,4,14,ㄧㄚ ㄓˋ,yā zhì
8761,雁,6,,8,3,11,ㄧㄢˋ,yàn
8762,掩,6,,12,2,14,ㄧㄢˇ,yǎn
8763,淹,6,,4,15,19,ㄧㄢ,yān
8764,醃,6,,5,8,13,ㄧㄢ,yān
8765,沿岸,6,,7,18,25,ㄧㄢˊ ㄢˋ,yán àn
8766,延遲,6,,7,5,12,ㄧㄢˊ ㄔˊ,yán chí
8767,研讀,6,,8,2,10,ㄧㄢˊ ㄉㄨˊ,yán dú
8768,厭煩,6,,11,5,16,ㄧㄢˋ ㄈㄢˊ,yàn fán
8769,掩蓋,6,,10,4,14,ㄧㄢˇ ㄍㄞˋ,yǎn gài
8770,沿海,6,,12,25,37,ㄧㄢˊ ㄏㄞˇ,yán hǎi
8771,眼紅,6,,3,0,3,ㄧㄢˇ ㄏㄨㄥˊ,yǎn hóng
8772,演化,6,,36,13,49,ㄧㄢˇ ㄏㄨㄚˋ,yǎn huà
8773,延緩,6,,6,7,13,ㄧㄢˊ ㄏㄨㄢˇ,yán huǎn
8774,眼見,6,,11,4,15,ㄧㄢˇㄐㄧㄢˋ,yǎn jiàn
8775,眼角,6,,8,1,9,ㄧㄢˇ ㄐㄧㄠˇ,yǎn jiǎo
8776,眼界,6,,5,3,8,ㄧㄢˇ ㄐㄧㄝˋ,yǎn jiè
8777,嚴謹,6,,17,12,29,ㄧㄢˊ ㄐㄧㄣˇ,yán jǐn
8778,厭倦,6,,12,2,14,ㄧㄢˋ ㄐㄩㄢˋ,yàn juàn
8779,嚴苛,6,,8,8,16,ㄧㄢˊ ㄎㄜ,yán kē
8780,眼眶,6,,10,2,12,ㄧㄢˇ ㄎㄨㄤ,yǎn kuāng
8781,演練,6,,7,13,20,ㄧㄢˇ ㄌㄧㄢˋ,yǎn liàn
8782,嚴密,6,,9,5,14,ㄧㄢˊ ㄇㄧˋ,yán mì
8783,淹沒,6,,14,19,33,ㄧㄢ ㄇㄛˋ,yān mò
8784,研判,6,,5,7,12,ㄧㄢˊ ㄆㄢˋ,yán pàn
8785,眼皮,6,,8,4,12,ㄧㄢˇ ㄆㄧˊ,yǎn pí
8786,延期,6,,3,2,5,ㄧㄢˊ ㄑㄧˊ,yán qí
8787,延伸,6,,22,16,38,ㄧㄢˊ ㄕㄣ,yán shēn
8788,衍生,6,,13,5,18,ㄧㄢˇ ㄕㄥ,yǎn shēng
8789,岩石,6,,21,14,35,ㄧㄢˊ ㄕˊ,yán shí
8790,掩飾,6,,19,2,21,ㄧㄢˇ ㄕˋ,yǎn shì
8791,沿途,6,,12,10,22,ㄧㄢˊ ㄊㄨˊ,yán tú
8792,延誤,6,,5,4,9,ㄧㄢˊ ㄨˋ,yán wù
8793,煙霧,6,,11,6,17,ㄧㄢ ㄨˋ,yān wù
8794,沿用,6,,5,4,9,ㄧㄢˊ ㄩㄥˋ,yán yòng
8795,言語,6,,29,12,41,ㄧㄢˊ ㄩˇ,yán yǔ
8796,諺語,6,,10,13,23,ㄧㄢˋ ㄩˇ,yàn yǔ
8797,驗證,6,,18,14,32,ㄧㄢˋ ㄓㄥˋ,yàn zhèng
8798,眼睜睜,6,,6,3,9,ㄧㄢˇ ㄓㄥ ㄓㄥ,yǎn zhēng zhēng
8799,眼珠子/眼珠,6,,13,2,15,ㄧㄢˇ ㄓㄨ ˙ㄗ/ㄧㄢˇ ㄓㄨ,yǎn zhū zi/yǎn zhū
8800,燕子,6,,9,4,13,ㄧㄢˋ ˙ㄗ,yàn zi
8801,樣本,6,,12,9,21,ㄧㄤˋ ㄅㄣˇ,yàng běn
8802,養活,6,,7,13,20,ㄧㄤˇ ㄏㄨㄛˊ,yǎng huó
8803,仰賴,6,,15,20,35,ㄧㄤˇ ㄌㄞˋ,yǎng lài
8804,樣貌,6,,8,13,21,ㄧㄤˋ ㄇㄠˋ,yàng mào
8805,氧氣,6,,11,22,33,ㄧㄤˇ ㄑㄧˋ,yǎng qì
8806,仰望,6,,8,3,11,ㄧㄤˇ ㄨㄤˋ,yǎng wàng
8807,陽性,6,,6,1,7,ㄧㄤˊ ㄒㄧㄥˋ,yáng xìng
8808,洋溢,6,,10,4,14,ㄧㄤˊ ㄧˋ,yáng yì
8809,養育,6,,14,7,21,ㄧㄤˇ ㄩˋ,yǎng yù
8810,搖擺,6,,8,3,11,ㄧㄠˊ ㄅㄞˇ,yáo bǎi
8811,藥材,6,,8,7,15,ㄧㄠˋ ㄘㄞˊ,yào cái
8812,腰帶,6,,8,0,8,ㄧㄠ ㄉㄞˋ,yāo dài
8813,要點,6,,9,3,12,ㄧㄠˋ ㄉㄧㄢˇ,yào diǎn
8814,搖動,6,,6,2,8,ㄧㄠˊ ㄉㄨㄥˋ,yáo dòng
8815,藥方,6,,8,3,11,ㄧㄠˋ ㄈㄤ,yào fāng
8816,妖怪,6,,12,1,13,ㄧㄠ ㄍㄨㄞˋ,yāo guài
8817,搖籃,6,,7,6,13,ㄧㄠˊ ㄌㄢˊ,yáo lán
8818,要領,6,,9,2,11,ㄧㄠˋ ㄌㄧㄥˇ,yào lǐng
8819,謠言,6,,13,4,17,ㄧㄠˊ ㄧㄢˊ,yáo yán
8820,耀眼,6,,11,4,15,ㄧㄠˋ ㄧㄢˇ,yào yǎn
8821,邀約,6,,7,9,16,ㄧㄠ ㄩㄝ,yāo yuē
8822,野,6,,16,16,32,ㄧㄝˇ,yě
8823,業績,6,,21,7,28,ㄧㄝˋ ㄐㄧ,yè jī
8824,業界,6,,11,2,13,ㄧㄝˋ ㄐㄧㄝˋ,yè jiè
8825,野蠻,6,,9,2,11,ㄧㄝˇ ㄇㄢˊ,yě mán
8826,夜色,6,,6,2,8,ㄧㄝˋ ㄙㄜˋ,yè sè
8827,野生,6,,11,49,60,ㄧㄝˇ ㄕㄥ,yě shēng
8828,野獸,6,,15,2,17,ㄧㄝˇ ㄕㄡˋ,yě shòu
8829,液體,6,,12,11,23,ㄧㄝˋ ㄊㄧˇ,yè tǐ
8830,野外,6,,11,31,42,ㄧㄝˇ ㄨㄞˋ,yě wài
8831,業餘,6,,10,3,13,ㄧㄝˋ ㄩˊ,yè yú
8832,亦,6,,202,12,214,ㄧˋ,yì
8833,役,6,,22,1,23,ㄧˋ,yì
8834,易,6,,56,19,75,ㄧˋ,yì
8835,乙,6,,29,8,37,ㄧˇ,yǐ
8836,一律,6,,16,5,21,ㄧˊ ㄌㄩˋ,yí  lǜ
8837,一路順風,6,,0,0,0,ㄧˊㄌㄨˋ ㄕㄨㄣˋ ㄈㄥ,yí  lù shùn fēng
8838,譯本,6,,14,1,15,ㄧˋ ㄅㄣˇ,yì běn
8839,以便,6,,48,8,56,ㄧˇ ㄅㄧㄢˋ,yǐ biàn
8840,一併,6,,10,4,14,ㄧˊ ㄅㄧㄥˋ,yí bìng
8841,一點一滴,6,,7,13,20,ㄧˋ ㄉㄧㄢˇ ㄧˋ ㄉㄧ,yì diǎn yì dī
8842,一度,6,,18,19,37,ㄧˊ ㄉㄨˋ,yí dù
8843,一帆風順,6,,3,2,5,ㄧˋ ㄈㄢˊ ㄈㄥ ㄕㄨㄣˋ,yì fán fēng shùn
8844,以防,6,,7,2,9,ㄧˇ ㄈㄤˊ,yǐ fáng
8845,依附,6,,13,4,17,ㄧ ㄈㄨˋ,yī fù
8846,一概,6,,8,2,10,ㄧˊ ㄍㄞˋ,yí gài
8847,一貫,6,,18,7,25,ㄧˊ ㄍㄨㄢˋ,yí guàn
8848,異國,6,,7,6,13,ㄧˋ ㄍㄨㄛˊ,yì guó
8849,意涵,6,,15,11,26,ㄧˋ ㄏㄢˊ,yì hán
8850,醫護,6,,8,22,30,ㄧ ㄏㄨˋ,yī hù
8851,議會,6,,12,12,24,ㄧˋ ㄏㄨㄟˋ,yì huì
8852,疑惑,6,,22,9,31,ㄧˊ ㄏㄨㄛˋ,yí huò
8853,移居,6,,5,4,9,ㄧˊ ㄐㄩ,yí jū
8854,一舉,6,,10,11,21,ㄧˋ ㄐㄩˇ,yì jǔ
8855,一舉兩得,6,,2,1,3,ㄧˋ ㄐㄩˇ ㄌㄧㄤˇ ㄉㄜˊ,yì jǔ liǎng dé
8856,一舉一動,6,,8,1,9,ㄧˋ ㄐㄩˇ ㄧˊ ㄉㄨㄥˋ,yì jǔ yí dòng
8857,異口同聲,6,,5,1,6,ㄧˋ ㄎㄡˇ ㄊㄨㄥˊ ㄕㄥ,yì kǒu tóng shēng
8858,毅力,6,,16,18,34,ㄧˋ ㄌㄧˋ,yì lì
8859,意料,6,,13,3,16,ㄧˋ ㄌㄧㄠˋ,yì liào
8860,遺漏,6,,5,2,7,ㄧˊ ㄌㄡˋ,yí lòu
8861,一路,6,,58,78,136,ㄧˊㄌㄨˋ,yí lù
8862,疑慮,6,,14,12,26,ㄧˊ ㄌㄩˋ,yí lǜ
8863,議論,6,,15,1,16,ㄧˋ ㄌㄨㄣˋ,yì lùn
8864,疫苗,6,,7,28,35,ㄧˋ ㄇㄧㄠˊ,yì miáo
8865,翌年,6,,8,1,9,ㄧˋ ㄋㄧㄢˊ,yì nián
8866,意念,6,,12,8,20,ㄧˋ ㄋㄧㄢˋ,yì niàn
8867,遺棄,6,,9,7,16,ㄧˊ ㄑㄧˋ,yí qì
8868,一齊,6,,20,1,21,ㄧˋ ㄑㄧˊ,yì qí
8869,依然,6,,82,42,124,ㄧ ㄖㄢˊ,yī rán
8870,一如,6,,32,7,39,ㄧˋ ㄖㄨˊ,yì rú
8871,衣衫,6,,6,1,7,ㄧ ㄕㄢ,yī shān
8872,衣裳,6,,14,0,14,ㄧ ˙ㄕㄤ,yī shang
8873,以身作則,6,,5,2,7,ㄧˇ ㄕㄣ ㄗㄨㄛˋ ㄗㄜˊ,yǐ shēn zuò zé
8874,儀式,6,,46,25,71,ㄧˊ ㄕˋ,yí shì
8875,遺失,6,,8,1,9,ㄧˊ ㄕ,yí shī
8876,一事無成,6,,4,1,5,ㄧˊ ㄕˋ ㄨˊ ㄔㄥˊ,yí shì wú chéng
8877,一手,6,,22,11,33,ㄧˋㄕㄡˇ,yì shǒu
8878,醫術,6,,5,4,9,ㄧ ㄕㄨˋ,yī shù
8879,一塌糊塗,6,,4,1,5,ㄧˋ ㄊㄚ ㄏㄨˊ ㄊㄨˊ,yì tā hú tú
8880,遺體,6,,10,15,25,ㄧˊ ㄊㄧˇ,yí tǐ
8881,議題,6,,59,77,136,ㄧˋ ㄊㄧˊ,yì tí
8882,一體,6,,19,6,25,ㄧˋ ㄊㄧˇ,yì tǐ
8883,意圖,6,,24,7,31,ㄧˋ ㄊㄨˊ,yì tú
8884,一味,6,,22,4,26,ㄧˊㄨㄟˋ,yí wèi
8885,意味,6,,55,16,71,ㄧˋ ㄨㄟˋ,yì wèi
8886,一無所有,6,,5,4,9,ㄧˋㄨˊ ㄙㄨㄛˇ ㄧㄡˇ,yì wú suǒ yǒu
8887,一無所知,6,,13,1,14,ㄧˋㄨˊ ㄙㄨㄛˇ ㄓ,yì wú suǒ zhī
8888,一五一十,6,,5,1,6,ㄧˋㄨˇ ㄧˋ ㄕˊ,yì wǔ yì shí
8889,一夕,6,,0,0,0,ㄧˊ ㄒㄧˋ,yí xì
8890,意象,6,,9,7,16,ㄧˋ ㄒㄧㄤˋ,yì xiàng
8891,意想不到,6,,10,5,15,ㄧˋ ㄒㄧㄤˇ ㄅㄨˊ ㄉㄠˋ,yì xiǎng bú dào
8892,疑心,6,,9,0,9,ㄧˊ ㄒㄧㄣ,yí xīn
8893,一心,6,,25,10,35,ㄧˋ ㄒㄧㄣ,yì xīn
8894,一心一意,6,,7,3,10,ㄧˋ ㄒㄧㄣ ㄧ ㄧˋ,yì xīn yī yì
8895,異性,6,,12,2,14,ㄧˋ ㄒㄧㄥˋ,yì xìng
8896,依序,6,,7,3,10,ㄧ ㄒㄩˋ,yī xù
8897,依循,6,,8,3,11,ㄧ ㄒㄩㄣˊ,yī xún
8898,異議,6,,10,1,11,ㄧˋ ㄧˋ,yì yì
8899,議員,6,,15,17,32,ㄧˋ ㄩㄢˊ,yì yuán
8900,移植,6,,10,12,22,ㄧˊ ㄓˊ,yí zhí
8901,意志,6,,41,13,54,ㄧˋ ㄓˋ,yì zhì
8902,抑制,6,,29,26,55,ㄧˋ ㄓˋ,yì zhì
8903,以至於/以致於,6,,24,4,28,ㄧˇ ㄓˋ ㄩˊ  ,yǐ zhì yú  
8904,以致/以至,6,,45,2,47,ㄧˇ ㄓˋ/ㄧˇ ㄓˋ,yǐ zhì/yǐ zhì
8905,譯註,6,,23,0,23,ㄧˋ ㄓㄨˋ,yì zhù
8906,衣著,6,,9,1,10,ㄧ ㄓㄨㄛˊ,yī zhuó
8907,陰暗,6,,11,3,14,ㄧㄣ ㄢˋ,yīn àn
8908,引爆,6,,5,9,14,ㄧㄣˇ ㄅㄠˋ,yǐn bào
8909,引導,6,,50,32,82,ㄧㄣˇ ㄉㄠˇ,yǐn dǎo
8910,因果,6,,25,10,35,ㄧㄣ ㄍㄨㄛˇ,yīn guǒ
8911,隱含,6,,10,3,13,ㄧㄣˇ ㄏㄢˊ,yǐn hán
8912,引進,6,,28,26,54,ㄧㄣˇ ㄐㄧㄣˋ,yǐn jìn
8913,隱居,6,,9,2,11,ㄧㄣˇ ㄐㄩ,yǐn jū
8914,引領,6,,12,13,25,ㄧㄣˇ ㄌㄧㄥˇ,yǐn lǐng
8915,隱瞞,6,,14,3,17,ㄧㄣˇ ㄇㄢˊ,yǐn mán
8916,銀幕,6,,12,3,15,ㄧㄣˊ ㄇㄨˋ,yín mù
8917,因人而異,6,,3,1,4,ㄧㄣ ㄖㄣˊ ㄦˊ ㄧˋ,yīn rén ér yì
8918,引人注目,6,,7,4,11,ㄧㄣˇ ㄖㄣˊ ㄓㄨˋ ㄇㄨˋ,yǐn rén zhù mù
8919,引述,6,,8,1,9,ㄧㄣˇ ㄕㄨˋ,yǐn shù
8920,印刷,6,,12,7,19,ㄧㄣˋ ㄕㄨㄚ,yìn shuā
8921,飲水,6,,5,10,15,ㄧㄣˇ ㄕㄨㄟˇ,yǐn shuǐ
8922,隱私,6,,12,6,18,ㄧㄣˇ ㄙ,yǐn sī
8923,音響,6,,10,5,15,ㄧㄣ ㄒㄧㄤˇ,yīn xiǎng
8924,陰陽,6,,13,4,17,ㄧㄣ ㄧㄤˊ,yīn yáng
8925,隱隱,6,,8,2,10,ㄧㄣˇ ㄧㄣˇ,yǐn yǐn
8926,因應,6,,27,31,58,ㄧㄣ ㄧㄥˋ,yīn yìng
8927,引誘,6,,13,4,17,ㄧㄣˇ ㄧㄡˋ,yǐn yòu
8928,因緣,6,,10,50,60,ㄧㄣ ㄩㄢˊ,yīn yuán
8929,隱約,6,,14,3,17,ㄧㄣˇ ㄩㄝ,yǐn yuē
8930,印證,6,,10,8,18,ㄧㄣˋ ㄓㄥˋ,yìn zhèng
8931,銀子,6,,43,1,44,ㄧㄣˊ ˙ㄗ,yín zi
8932,因子,6,,18,14,32,ㄧㄣ ㄗˇ,yīn zǐ
8933,營,6,,10,10,20,ㄧㄥˊ,yíng
8934,應2,6,,255,44,299,ㄧㄥˋ,yìng
8935,應變,6,,12,8,20,ㄧㄥˋ ㄅㄧㄢˋ,yìng biàn
8936,應酬,6,,6,6,12,ㄧㄥˋ ㄔㄡˊ,yìng chóu
8937,營地,6,,8,4,12,ㄧㄥˊ ㄉㄧˋ,yíng dì
8938,硬碟,6,,2,2,4,ㄧㄥˋ ㄉㄧㄝˊ,yìng dié
8939,應對,6,,11,4,15,ㄧㄥˋ ㄉㄨㄟˋ,yìng duì
8940,迎合,6,,7,2,9,ㄧㄥˊ ㄏㄜˊ,yíng hé
8941,營利,6,,10,9,19,ㄧㄥˊ ㄌㄧˋ,yíng lì
8942,迎面,6,,10,2,12,ㄧㄥˊ ㄇㄧㄢˋ,yíng miàn
8943,英勇,6,,10,2,12,ㄧㄥ ㄩㄥˇ,yīng yǒng
8944,營運,6,,19,10,29,ㄧㄥˊ ㄩㄣˋ,yíng yùn
8945,營造,6,,23,21,44,ㄧㄥˊ ㄗㄠˋ,yíng zào
8946,用兵,6,,8,0,8,ㄩㄥˋ ㄅㄧㄥ,yòng bīng
8947,永恆,6,,21,6,27,ㄩㄥˇ ㄏㄥˊ,yǒng héng
8948,用戶,6,,8,4,12,ㄩㄥˋ ㄏㄨˋ,yòng hù
8949,擁護,6,,14,4,18,ㄩㄥˇ ㄏㄨˋ,yǒng hù
8950,擁擠,6,,13,5,18,ㄩㄥˇ ㄐㄧˇ,yǒng jǐ
8951,用人,6,,11,2,13,ㄩㄥˋ ㄖㄣˊ,yòng rén
8952,佣人/傭人,6,,9,2,11,ㄩㄥˋ ㄖㄣˊ/ㄩㄥ ㄖㄣˊ,yòng rén/yōng rén
8953,勇士,6,,8,2,10,ㄩㄥˇ ㄕˋ,yǒng shì
8954,永續,6,,9,54,63,ㄩㄥˇ ㄒㄩˋ,yǒng xù
8955,用意,6,,13,11,24,ㄩㄥˋ ㄧˋ,yòng yì
8956,用以,6,,15,3,18,ㄩㄥˋ ㄧˇ,yòng yǐ
8957,用語,6,,11,1,12,ㄩㄥˋ ㄩˇ,yòng yǔ
8958,勇於,6,,16,13,29,ㄩㄥˇ ㄩˊ,yǒng yú
8959,有別,6,,5,1,6,ㄧㄡˇ ㄅㄧㄝˊ,yǒu bié
8960,有成,6,,6,2,8,ㄧㄡˇ ㄔㄥˊ,yǒu chéng
8961,憂愁,6,,8,4,12,ㄧㄡ ㄔㄡˊ,yōu chóu
8962,優待,6,,4,1,5,ㄧㄡ ㄉㄞˋ,yōu dài
8963,黝黑,6,,7,3,10,ㄧㄡˇ ㄏㄟ,yǒu hēi
8964,優惠,6,,6,3,9,ㄧㄡ ㄏㄨㄟˋ,yōu huì
8965,誘惑,6,,18,16,34,ㄧㄡˋ ㄏㄨㄛˋ,yòu huò
8966,悠久,6,,8,8,16,ㄧㄡ ㄐㄧㄡˇ,yōu jiǔ
8967,由來,6,,9,4,13,ㄧㄡˊ ㄌㄞˊ,yóu lái
8968,優良,6,,14,9,23,ㄧㄡ ㄌㄧㄤˊ,yōu liáng
8969,優劣,6,,5,2,7,ㄧㄡ ㄌㄧㄝˋ,yōu liè
8970,幽靈,6,,9,2,11,ㄧㄡ ㄌㄧㄥˊ,yōu líng
8971,優美,6,,16,11,27,ㄧㄡ ㄇㄟˇ,yōu měi
8972,游牧,6,,5,8,13,ㄧㄡˊ ㄇㄨˋ,yóu mù
8973,油漆,6,,7,11,18,ㄧㄡˊ ㄑㄧ,yóu qī
8974,有期徒刑,6,,2,0,2,ㄧㄡˇ ㄑㄧˊ ㄊㄨˊ ㄒㄧㄥˊ,yǒu qí tú xíng
8975,有情,6,,9,3,12,ㄧㄡˇ ㄑㄧㄥˊ,yǒu qíng
8976,誘人,6,,6,1,7,ㄧㄡˋ ㄖㄣˊ,yòu rén
8977,友人,6,,15,1,16,ㄧㄡˇ ㄖㄣˊ,yǒu rén
8978,猶如,6,,21,8,29,ㄧㄡˊ ㄖㄨˊ,yóu rú
8979,有如,6,,45,16,61,ㄧㄡˇ ㄖㄨˊ,yǒu rú
8980,憂傷,6,,12,2,14,ㄧㄡ ㄕㄤ,yōu shāng
8981,優勢,6,,54,28,82,ㄧㄡ ㄕˋ,yōu shì
8982,有史以來,6,,7,13,20,ㄧㄡˇ ㄕˇ ㄧˇ ㄌㄞˊ,yǒu shǐ yǐ lái
8983,遊說,6,,7,3,10,ㄧㄡˊ ㄕㄨㄟˋ,yóu shuì
8984,有所,6,,52,19,71,ㄧㄡˇ ㄙㄨㄛˇ,yǒu suǒ
8985,幼童,6,,5,3,8,ㄧㄡˋ ㄊㄨㄥˊ,yòu tóng
8986,悠閒,6,,11,9,20,ㄧㄡ ㄒㄧㄢˊ,yōu xián
8987,幼小,6,,6,3,9,ㄧㄡˋ ㄒㄧㄠˇ,yòu xiǎo
8988,憂心,6,,12,10,22,ㄧㄡ ㄒㄧㄣ,yōu xīn
8989,有幸,6,,9,5,14,ㄧㄡˇ ㄒㄧㄥˋ,yǒu xìng
8990,優雅,6,,21,14,35,ㄧㄡ ㄧㄚˇ,yōu yǎ
8991,優異,6,,11,5,16,ㄧㄡ ㄧˋ,yōu yì
8992,猶豫不決,6,,8,3,11,ㄧㄡˊ ㄩˋ ㄅㄨˋ ㄐㄩㄝˊ,yóu yù bù jué
8993,優越,6,,6,2,8,ㄧㄡ ㄩㄝˋ,yōu yuè
8994,于,6,,10,4,14,ㄩˊ,yú
8995,逾,6,,9,2,11,ㄩˊ,yú
8996,愈,6,,169,23,192,ㄩˋ,yù
8997,欲,6,,84,28,112,ㄩˋ,yù
8998,愚蠢,6,,27,3,30,ㄩˊ ㄔㄨㄣˇ,yú chǔn
8999,餘地,6,,9,2,11,ㄩˊ ㄉㄧˋ,yú dì
9000,語調,6,,14,2,16,ㄩˇ ㄉㄧㄠˋ,yǔ diào
9001,漁夫,6,,6,3,9,ㄩˊ ㄈㄨ,yú fū
9002,預感,6,,8,2,10,ㄩˋ ㄍㄢˇ,yù gǎn
9003,預估,6,,7,25,32,ㄩˋ ㄍㄨ,yù gū
9004,遇害,6,,5,1,6,ㄩˋ ㄏㄞˋ,yù hài
9005,與會,6,,11,6,17,ㄩˋ ㄏㄨㄟˋ,yù huì
9006,預見,6,,7,2,9,ㄩˋ ㄐㄧㄢˋ,yù jiàn
9007,預警,6,,5,19,24,ㄩˋ ㄐㄧㄥˇ,yù jǐng
9008,預料,6,,15,5,20,ㄩˋ ㄌㄧㄠˋ,yù liào
9009,輿論,6,,13,7,20,ㄩˊ ㄌㄨㄣˋ,yú lùn
9010,羽毛,6,,14,4,18,ㄩˇ ㄇㄠˊ,yǔ máo
9011,愚昧,6,,7,1,8,ㄩˊ ㄇㄟˋ,yú mèi
9012,與其,6,,17,8,25,ㄩˇ ㄑㄧˊ,yǔ qí
9013,預設,6,,12,2,14,ㄩˋ ㄕㄜˋ,yù shè
9014,與生俱來,6,,8,3,11,ㄩˇ ㄕㄥ ㄐㄩˋ ㄌㄞˊ,yǔ shēng jù lái
9015,寓言,6,,9,2,11,ㄩˋ ㄧㄢˊ,yù yán
9016,予以,6,,28,2,30,ㄩˇ ㄧˇ,yǔ yǐ
9017,語音,6,,15,2,17,ㄩˇ ㄧㄣ,yǔ yīn
9018,預知,6,,7,3,10,ㄩˋ ㄓ,yù zhī
9019,與眾不同,6,,14,4,18,ㄩˇ ㄓㄨㄥˋ ㄅㄨˋ ㄊㄨㄥˊ,yǔ zhòng bù tóng
9020,員,6,,16,14,30,ㄩㄢˊ,yuán
9021,緣,6,,11,33,44,ㄩㄢˊ,yuán
9022,原創,6,,4,1,5,ㄩㄢˊ ㄔㄨㄤˋ,yuán chuàng
9023,遠大,6,,7,2,9,ㄩㄢˇ ㄉㄚˋ,yuǎn dà
9024,冤大頭,6,,1,0,1,ㄩㄢ ㄉㄚˋ ㄊㄡˊ,yuān dà tóu
9025,原地,6,,14,5,19,ㄩㄢˊ ㄉㄧˋ,yuán dì
9026,園丁,6,,7,4,11,ㄩㄢˊ ㄉㄧㄥ,yuán dīng
9027,原告,6,,2,0,2,ㄩㄢˊ ㄍㄠˋ,yuán gào
9028,怨恨,6,,15,5,20,ㄩㄢˋ ㄏㄣˋ,yuàn hèn
9029,遠見,6,,10,3,13,ㄩㄢˇ ㄐㄧㄢˋ,yuǎn jiàn
9030,願景,6,,12,4,16,ㄩㄢˋㄐㄧㄥˇ,yuàn jǐng
9031,遠景,6,,7,1,8,ㄩㄢˇ ㄐㄧㄥˇ,yuǎn jǐng
9032,原理,6,,31,42,73,ㄩㄢˊ ㄌㄧˇ,yuán lǐ
9033,元氣,6,,7,4,11,ㄩㄢˊ ㄑㄧˋ,yuán qì
9034,緣起,6,,7,4,11,ㄩㄢˊ ㄑㄧˇ,yuán qǐ
9035,元首,6,,5,4,9,ㄩㄢˊ ㄕㄡˇ,yuán shǒu
9036,援手,6,,7,10,17,ㄩㄢˊ ㄕㄡˇ,yuán shǒu
9037,元素,6,,35,32,67,ㄩㄢˊ ㄙㄨˋ,yuán sù
9038,源頭,6,,13,31,44,ㄩㄢˊ ㄊㄡˊ,yuán tóu
9039,冤枉,6,,7,5,12,ㄩㄢ ㄨㄤˇ,yuān wǎng
9040,原文,6,,13,1,14,ㄩㄢˊ ㄨㄣˊ,yuán wén
9041,原型,6,,7,2,9,ㄩㄢˊ ㄒㄧㄥˊ,yuán xíng
9042,緣由,6,,6,1,7,ㄩㄢˊ ㄧㄡˊ,yuán yóu
9043,原有,6,,23,11,34,ㄩㄢˊ ㄧㄡˇ,yuán yǒu
9044,源於,6,,9,2,11,ㄩㄢˊ ㄩˊ,yuán yú
9045,源源不絕,6,,5,7,12,ㄩㄢˊ ㄩㄢˊ ㄅㄨˋ ㄐㄩㄝˊ,yuán yuán bù jué
9046,原著,6,,12,1,13,ㄩㄢˊ ㄓㄨˋ,yuán zhù
9047,援助,6,,12,64,76,ㄩㄢˊ ㄓㄨˋ,yuán zhù
9048,原狀,6,,6,1,7,ㄩㄢˊ ㄓㄨㄤˋ,yuán zhuàng
9049,悅耳,6,,5,2,7,ㄩㄝˋ ㄦˇ,yuè ěr
9050,越發,6,,7,1,8,ㄩㄝˋ ㄈㄚ,yuè fā
9051,樂曲,6,,5,2,7,ㄩㄝˋ ㄑㄩˇ,yuè qǔ
9052,約束,6,,13,5,18,ㄩㄝ ㄕㄨˋ,yuē shù
9053,韻律,6,,8,2,10,ㄩㄣˋ ㄌㄩˋ,yùn lǜ
9054,醞釀,6,,7,4,11,ㄩㄣˋ ㄋㄧㄤˋ,yùn niàng
9055,運輸,6,,15,27,42,ㄩㄣˋ ㄕㄨ,yùn shū
9056,運行,6,,11,4,15,ㄩㄣˋ ㄒㄧㄥˊ,yùn xíng
9057,孕育,6,,12,16,28,ㄩㄣˋ ㄩˋ,yùn yù
9058,運轉,6,,13,9,22,ㄩㄣˋ ㄓㄨㄢˇ,yùn zhuǎn
9059,運作,6,,85,44,129,ㄩㄣˋ ㄗㄨㄛˋ,yùn zuò
9060,砸,6,,12,5,17,ㄗㄚˊ,zá
9061,雜草,6,,7,46,53,ㄗㄚˊ ㄘㄠˇ,zá cǎo
9062,雜亂,6,,6,2,8,ㄗㄚˊ ㄌㄨㄢˋ,zá luàn
9063,宰,6,,11,3,14,ㄗㄞˇ,zǎi
9064,載2,6,,66,47,113,ㄗㄞˇ,zǎi
9065,栽,6,,10,10,20,ㄗㄞ,zāi
9066,災禍,6,,8,2,10,ㄗㄞ ㄏㄨㄛˋ,zāi huò
9067,栽培,6,,7,53,60,ㄗㄞ ㄆㄟˊ,zāi péi
9068,再生,6,,11,40,51,ㄗㄞˋ ㄕㄥ,zài shēng
9069,在世,6,,9,4,13,ㄗㄞˋ ㄕˋ,zài shì
9070,在位,6,,14,4,18,ㄗㄞˋ ㄨㄟˋ,zài wèi
9071,在野,6,,3,4,7,ㄗㄞˋ ㄧㄝˇ,zài yě
9072,在於,6,,138,56,194,ㄗㄞˋ ㄩˊ,zài yú
9073,在在,6,,8,4,12,ㄗㄞˋ ㄗㄞˋ,zài zài
9074,再者,6,,14,3,17,ㄗㄞˋ ㄓㄜˇ,zài zhě
9075,讚賞,6,,15,4,19,ㄗㄢˋ ㄕㄤˇ,zàn shǎng
9076,讚嘆,6,,10,7,17,ㄗㄢˋ ㄊㄢˋ,zàn tàn
9077,讚歎,6,,5,2,7,ㄗㄢˋ ㄊㄢˋ,zàn tàn
9078,讚許,6,,6,1,7,ㄗㄢˋ ㄒㄩˇ,zàn xǔ
9079,讚揚,6,,11,4,15,ㄗㄢˋ ㄧㄤˊ,zàn yáng
9080,贊助,6,,15,10,25,ㄗㄢˋ ㄓㄨˋ,zàn zhù
9081,葬禮,6,,12,3,15,ㄗㄤˋ ㄌㄧˇ,zàng lǐ
9082,髒兮兮,6,,4,4,8,ㄗㄤ ㄒㄧ ㄒㄧ,zāng xī xī
9083,造反,6,,16,1,17,ㄗㄠˋ ㄈㄢˇ,zào fǎn
9084,造訪,6,,16,17,33,ㄗㄠˋ ㄈㄤˇ,zào fǎng
9085,造就,6,,12,16,28,ㄗㄠˋ ㄐㄧㄡˋ,zào jiù
9086,糟蹋,6,,6,1,7,ㄗㄠ ㄊㄚˋ,zāo tà
9087,責備,6,,21,4,25,ㄗㄜˊ ㄅㄟˋ,zé bèi
9088,責怪,6,,15,3,18,ㄗㄜˊ ㄍㄨㄞˋ,zé guài
9089,責罵,6,,8,1,9,ㄗㄜˊ ㄇㄚˋ,zé mà
9090,憎恨,6,,12,1,13,ㄗㄥ ㄏㄣˋ,zēng hèn
9091,增添,6,,14,14,28,ㄗㄥ ㄊㄧㄢ,zēng tiān
9092,詐,6,,5,1,6,ㄓㄚˋ,zhà
9093,扎,6,,7,4,11,ㄓㄚ / ㄓㄚˊ,zhā / zhá
9094,炸彈,6,,17,34,51,ㄓㄚˋ ㄉㄢˋ,zhà dàn
9095,柵欄,6,,6,2,8,ㄓㄚˋ ㄌㄢˊ,zhà lán
9096,眨眼,6,,9,1,10,ㄓㄚˇ ㄧㄢˇ,zhǎ yǎn
9097,債,6,,8,16,24,ㄓㄞˋ,zhài
9098,債務,6,,8,36,44,ㄓㄞˋ ㄨˋ,zhài wù
9099,摘要,6,,9,1,10,ㄓㄞ ㄧㄠˋ,zhāi yào
9100,戰,6,,81,35,116,ㄓㄢˋ,zhàn
9101,斬,6,,25,4,29,ㄓㄢˇ,zhǎn
9102,戰敗,6,,12,3,15,ㄓㄢˋ ㄅㄞˋ,zhàn bài
9103,顫動,6,,5,0,5,ㄓㄢˋ ㄉㄨㄥˋ,zhàn dòng
9104,戰鬥,6,,30,8,38,ㄓㄢˋ ㄉㄡˋ,zhàn dòu
9105,顫抖,6,,28,4,32,ㄓㄢˋ ㄉㄡˇ,zhàn dǒu
9106,綻放,6,,8,5,13,ㄓㄢˋ ㄈㄤˋ,zhàn fàng
9107,戰功,6,,8,0,8,ㄓㄢˋ ㄍㄨㄥ,zhàn gōng
9108,佔據/占據,6,,21,8,29,ㄓㄢˋ ㄐㄩˋ,zhàn jù
9109,展露,6,,5,4,9,ㄓㄢˇ ㄌㄨˋ,zhǎn lù
9110,戰略,6,,35,26,61,ㄓㄢˋ ㄌㄩㄝˋ,zhàn lüè
9111,戰勝,6,,15,6,21,ㄓㄢˋ ㄕㄥˋ,zhàn shèng
9112,戰事,6,,12,4,16,ㄓㄢˋ ㄕˋ,zhàn shì
9113,暫停,6,,12,8,20,ㄓㄢˋ ㄊㄧㄥˊ,zhàn tíng
9114,展現,6,,59,47,106,ㄓㄢˇ ㄒㄧㄢˋ,zhǎn xiàn
9115,嶄新,6,,15,10,25,ㄓㄢˇ ㄒㄧㄣ,zhǎn xīn
9116,戰役,6,,24,7,31,ㄓㄢˋ ㄧˋ,zhàn yì
9117,輾轉,6,,10,10,20,ㄓㄢˇ ㄓㄨㄢˇ,zhǎn zhuǎn
9118,仗,6,,16,4,20,ㄓㄤˋ,zhàng
9119,脹,6,,9,5,14,ㄓㄤˋ,zhàng
9120,賬,6,,5,0,5,ㄓㄤˋ,zhàng
9121,掌管,6,,13,3,16,ㄓㄤˇ ㄍㄨㄢˇ,zhǎng guǎn
9122,長官,6,,27,7,34,ㄓㄤˇ ㄍㄨㄢ,zhǎng guān
9123,章節,6,,15,2,17,ㄓㄤ ㄐㄧㄝˊ,zhāng jié
9124,長老,6,,17,5,22,ㄓㄤˇ ㄌㄠˇ,zhǎng lǎo
9125,張力,6,,10,3,13,ㄓㄤ ㄌㄧˋ,zhāng lì
9126,掌權,6,,6,6,12,ㄓㄤˇ ㄑㄩㄢˊ,zhǎng quán
9127,掌聲,6,,9,34,43,ㄓㄤˇ ㄕㄥ,zhǎng shēng
9128,張貼,6,,4,3,7,ㄓㄤ ㄊㄧㄝ,zhāng tiē
9129,張望,6,,10,1,11,ㄓㄤ ㄨㄤˋ,zhāng wàng
9130,彰顯,6,,7,5,12,ㄓㄤ ㄒㄧㄢˇ,zhāng xiǎn
9131,長相,6,,13,4,17,ㄓㄤˇ ㄒㄧㄤˋ,zhǎng xiàng
9132,罩,6,,9,7,16,ㄓㄠˋ,zhào
9133,爪1,6,,9,5,14,ㄓㄠˇ,zhǎo
9134,招,6,,50,27,77,ㄓㄠ,zhāo
9135,朝1,6,,237,64,301,ㄓㄠ,zhāo
9136,照護,6,,16,17,33,ㄓㄠˋ ㄏㄨˋ,zhào hù
9137,召喚,6,,11,2,13,ㄓㄠˋ ㄏㄨㄢˋ,zhào huàn
9138,著火,6,,4,2,6,ㄓㄠˊ ㄏㄨㄛˇ,zháo huǒ
9139,召見,6,,13,1,14,ㄓㄠˋ ㄐㄧㄢˋ,zhào jiàn
9140,召開,6,,21,21,42,ㄓㄠˋ ㄎㄞ,zhào kāi
9141,照亮,6,,11,5,16,ㄓㄠˋ ㄌㄧㄤˋ,zhào liàng
9142,照料,6,,13,9,22,ㄓㄠˋ ㄌㄧㄠˋ,zhào liào
9143,著迷,6,,14,4,18,ㄓㄠˊ ㄇㄧˊ,zháo mí
9144,照明,6,,6,11,17,ㄓㄠˋ ㄇㄧㄥˊ,zhào míng
9145,招募,6,,8,6,14,ㄓㄠ ㄇㄨˋ,zhāo mù
9146,照射,6,,8,12,20,ㄓㄠˋ ㄕㄜˋ,zhào shè
9147,招式,6,,5,2,7,ㄓㄠ ㄕˋ,zhāo shì
9148,著想,6,,11,4,15,ㄓㄠˊ ㄒㄧㄤˇ,zháo xiǎng
9149,找尋,6,,15,13,28,ㄓㄠˇ ㄒㄩㄣˊ,zhǎo xún
9150,遮,6,,8,12,20,ㄓㄜ,zhē
9151,折斷,6,,7,2,9,ㄓㄜˊ ㄉㄨㄢˋ,zhé duàn
9152,折合,6,,1,6,7,ㄓㄜˊ ㄏㄜˊ,zhé hé
9153,折磨,6,,31,8,39,ㄓㄜˊ ㄇㄛˊ,zhé mó
9154,折騰,6,,8,3,11,ㄓㄜ ㄊㄥˊ,zhē téng
9155,偵辦,6,,1,1,2,ㄓㄣ ㄅㄢˋ,zhēn bàn
9156,珍藏,6,,5,4,9,ㄓㄣ ㄘㄤˊ,zhēn cáng
9157,鎮定,6,,12,5,17,ㄓㄣˋ ㄉㄧㄥˋ,zhèn dìng
9158,針對,6,,90,72,162,ㄓㄣ ㄉㄨㄟˋ,zhēn duì
9159,振奮,6,,10,5,15,ㄓㄣˋ ㄈㄣˋ,zhèn fèn
9160,震撼,6,,18,26,44,ㄓㄣˋ ㄏㄢˋ,zhèn hàn
9161,鎮靜,6,,7,1,8,ㄓㄣˋ ㄐㄧㄥˋ,zhèn jìng
9162,真情,6,,9,10,19,ㄓㄣ ㄑㄧㄥˊ,zhēn qíng
9163,陣容,6,,5,1,6,ㄓㄣˋ ㄖㄨㄥˊ,zhèn róng
9164,鎮壓,6,,12,13,25,ㄓㄣˋ ㄧㄚ,zhèn yā
9165,陣營,6,,15,12,27,ㄓㄣˋ ㄧㄥˊ,zhèn yíng
9166,診治,6,,5,3,8,ㄓㄣˇ ㄓˋ,zhěn zhì
9167,政變,6,,13,16,29,ㄓㄥˋ ㄅㄧㄢˋ,zhèng biàn
9168,爭辯,6,,12,1,13,ㄓㄥ ㄅㄧㄢˋ,zhēng biàn
9169,正當1,6,,29,8,37,ㄓㄥˋ ㄉㄤˋ,zhèng dàng
9170,政黨,6,,11,21,32,ㄓㄥˋ ㄉㄤˇ,zhèng dǎng
9171,正當2,6,,29,8,37,ㄓㄥˋ ㄉㄤ,zhèng dāng
9172,整頓,6,,11,4,15,ㄓㄥˇ ㄉㄨㄣˋ,zhěng dùn
9173,征服,6,,26,6,32,ㄓㄥ ㄈㄨˊ,zhēng fú
9174,正規,6,,8,4,12,ㄓㄥˋ ㄍㄨㄟ,zhèng guī
9175,整合,6,,38,15,53,ㄓㄥˇ ㄏㄜˊ,zhěng hé
9176,症候群,6,,19,17,36,ㄓㄥˋ ㄏㄡˋ ㄑㄩㄣˊ,zhèng hòu qún
9177,政績,6,,3,2,5,ㄓㄥˋ ㄐㄧ,zhèng jī
9178,整潔,6,,9,5,14,ㄓㄥˇ ㄐㄧㄝˊ,zhěng jié
9179,癥結,6,,6,3,9,ㄓㄥ ㄐㄧㄝˊ,zhēng jié
9180,正經,6,,7,1,8,ㄓㄥˋ ㄐㄧㄥ,zhèng jīng
9181,拯救,6,,21,32,53,ㄓㄥˇ ㄐㄧㄡˋ,zhěng jiù
9182,睜開,6,,17,7,24,ㄓㄥ ㄎㄞ,zhēng kāi
9183,正巧,6,,6,1,7,ㄓㄥˋ ㄑㄧㄠˇ,zhèng qiǎo
9184,證券,6,,11,3,14,ㄓㄥˋ ㄑㄩㄢˋ,zhèng quàn
9185,證人,6,,17,1,18,ㄓㄥˋ ㄖㄣˊ,zhèng rén
9186,政事,6,,8,1,9,ㄓㄥˋ ㄕˋ,zhèng shì
9187,正視,6,,11,8,19,ㄓㄥˋ ㄕˋ,zhèng shì
9188,徵收,6,,7,6,13,ㄓㄥ ㄕㄡ,zhēng shōu
9189,政壇,6,,7,4,11,ㄓㄥˋ ㄊㄢˊ,zhèng tán
9190,正統,6,,12,3,15,ㄓㄥˋ ㄊㄨㄥˇ,zhèng tǒng
9191,掙脫,6,,10,3,13,ㄓㄥ ㄊㄨㄛ,zhēng tuō
9192,政務,6,,13,2,15,ㄓㄥˋ ㄨˋ,zhèng wù
9193,正午,6,,4,2,6,ㄓㄥˋ ㄨˇ,zhèng wǔ
9194,爭相,6,,7,4,11,ㄓㄥ ㄒㄧㄤ,zhēng xiāng
9195,整修,6,,5,6,11,ㄓㄥˇ ㄒㄧㄡ,zhěng xiū
9196,徵詢,6,,6,0,6,ㄓㄥ ㄒㄩㄣˊ,zhēng xún
9197,正義,6,,22,10,32,ㄓㄥˋ ㄧˋ,zhèng yì
9198,徵兆,6,,11,4,15,ㄓㄥ ㄓㄠˋ,zhēng zhào
9199,正直,6,,15,2,17,ㄓㄥˋ ㄓˊ,zhèng zhí
9200,執,6,,16,9,25,ㄓˊ,zhí
9201,擲,6,,9,1,10,ㄓˊ,zhí
9202,致,6,,43,15,58,ㄓˋ,zhì
9203,治安,6,,8,8,16,ㄓˋ ㄢ,zhì ān
9204,值班,6,,5,6,11,ㄓˊ ㄅㄢ,zhí bān
9205,指標,6,,27,25,52,ㄓˇ ㄅㄧㄠ,zhǐ biāo
9206,支撐,6,,24,18,42,ㄓ ㄔㄥ,zhī chēng
9207,質地,6,,6,5,11,ㄓˊ ㄉㄧˋ,zhí dì
9208,指點,6,,11,4,15,ㄓˇ ㄉㄧㄢˇ,zhǐ diǎn
9209,執法,6,,7,4,11,ㄓˊ ㄈㄚˇ,zhí fǎ
9210,脂肪,6,,22,25,47,ㄓ ㄈㄤˊ,zhī fáng
9211,治國,6,,12,5,17,ㄓˋ ㄍㄨㄛˊ,zhì guó
9212,至極,6,,7,0,7,ㄓˋ ㄐㄧˊ,zhì jí
9213,知己,6,,9,1,10,ㄓ ㄐㄧˇ,zhī jǐ
9214,直徑,6,,12,7,19,ㄓˊ ㄐㄧㄥˋ,zhí jìng
9215,致敬,6,,6,3,9,ㄓˋ ㄐㄧㄥˋ,zhì jìng
9216,直覺,6,,48,5,53,ㄓˊ ㄐㄩㄝˊ,zhí jué
9217,指控,6,,15,12,27,ㄓˇ ㄎㄨㄥˋ,zhǐ kòng
9218,之類,6,,56,44,100,ㄓ ㄌㄟˋ,zhī lèi
9219,直立,6,,5,2,7,ㄓˊ ㄌㄧˋ,zhí lì
9220,致力,6,,21,18,39,ㄓˋ ㄌㄧˋ,zhì lì
9221,指南,6,,9,2,11,ㄓˇ ㄋㄢˊ,zhǐ nán
9222,智能,6,,11,3,14,ㄓˋ ㄋㄥˊ,zhì néng
9223,指派,6,,9,4,13,ㄓˇ ㄆㄞˋ,zhǐ pài
9224,支配,6,,23,2,25,ㄓ ㄆㄟˋ,zhī pèi
9225,志氣,6,,5,2,7,ㄓˋ ㄑㄧˋ,zhì qì
9226,知情,6,,10,2,12,ㄓ ㄑㄧㄥˊ,zhī qíng
9227,智商,6,,11,3,14,ㄓˋ ㄕㄤ,zhì shāng
9228,置身,6,,14,4,18,ㄓˋ ㄕㄣ,zhì shēn
9229,致勝,6,,6,1,7,ㄓˋ ㄕㄥˋ,zhì shèng
9230,致使,6,,9,1,10,ㄓˋ ㄕˇ,zhì shǐ
9231,指數,6,,16,24,40,ㄓˇ ㄕㄨˋ,zhǐ shù
9232,致死,6,,6,3,9,ㄓˋ ㄙˇ,zhì sǐ
9233,指望,6,,11,2,13,ㄓˇ ㄨㄤˋ,zhǐ wàng
9234,質問,6,,11,1,12,ㄓˊ ㄨㄣˋ,zhí wèn
9235,指紋,6,,5,5,10,ㄓˇ ㄨㄣˊ,zhǐ wén
9236,窒息,6,,9,2,11,ㄓˋ ㄒㄧˊ,zhì xí
9237,志向,6,,6,7,13,ㄓˋ ㄒㄧㄤˋ,zhì xiàng
9238,知曉,6,,9,0,9,ㄓ ㄒㄧㄠˇ,zhī xiǎo
9239,致謝,6,,5,1,6,ㄓˋ ㄒㄧㄝˋ,zhì xiè
9240,知性,6,,6,1,7,ㄓ ㄒㄧㄥˋ,zhī xìng
9241,直言,6,,8,3,11,ㄓˊ ㄧㄢˊ,zhí yán
9242,質疑,6,,31,24,55,ㄓˊ ㄧˊ,zhí yí
9243,致意,6,,8,3,11,ㄓˋ ㄧˋ,zhì yì
9244,治癒,6,,13,7,20,ㄓˋ ㄩˋ,zhì yù
9245,制約,6,,13,1,14,ㄓˋ ㄩㄝ,zhì yuē
9246,指責,6,,27,8,35,ㄓˇ ㄗㄜˊ,zhǐ zé
9247,執政,6,,12,21,33,ㄓˊ ㄓㄥˋ,zhí zhèng
9248,制止,6,,12,6,18,ㄓˋ ㄓˇ,zhì zhǐ
9249,支柱,6,,8,11,19,ㄓ ㄓㄨˋ,zhī zhù
9250,執著,6,,30,11,41,ㄓˊ ㄓㄨㄛˊ,zhí zhuó
9251,知足,6,,5,14,19,ㄓ ㄗㄨˊ,zhī zú
9252,中產階級,6,,9,3,12,ㄓㄨㄥ ㄔㄢˇ ㄐㄧㄝ ㄐㄧˊ,zhōng chǎn jiē jí
9253,終場,6,,1,0,1,ㄓㄨㄥ ㄔㄤˊ,zhōng cháng
9254,忠誠,6,,17,3,20,ㄓㄨㄥ ㄔㄥˊ,zhōng chéng
9255,重創,6,,5,8,13,ㄓㄨㄥˋ ㄔㄨㄤ,zhòng chuāng
9256,忠告,6,,10,2,12,ㄓㄨㄥ ㄍㄨˋ,zhōng gù
9257,終極,6,,12,6,18,ㄓㄨㄥ ㄐㄧˊ,zhōng jí
9258,終結,6,,13,7,20,ㄓㄨㄥ ㄐㄧㄝˊ,zhōng jié
9259,終究,6,,30,14,44,ㄓㄨㄥ ㄐㄧㄡˋ,zhōng jiù
9260,中立,6,,7,4,11,ㄓㄨㄥ ㄌㄧˋ,zhōng lì
9261,重任,6,,8,2,10,ㄓㄨㄥˋ ㄖㄣˋ,zhòng rèn
9262,終日,6,,10,3,13,ㄓㄨㄥ ㄖˋ,zhōng rì
9263,終生,6,,12,5,17,ㄓㄨㄥ ㄕㄥ,zhōng shēng
9264,忠實,6,,16,7,23,ㄓㄨㄥ ㄕˊ,zhōng shí
9265,種田,6,,6,57,63,ㄓㄨㄥˋ ㄊㄧㄢˊ,zhòng tián
9266,忠心,6,,7,3,10,ㄓㄨㄥ ㄒㄧㄣ,zhōng xīn
9267,重用,6,,12,1,13,ㄓㄨㄥˋ ㄩㄥˋ,zhòng yòng
9268,重責大任,6,,3,1,4,ㄓㄨㄥˋ ㄗㄜˊ ㄉㄚˋ ㄖㄣˋ,zhòng zé dà rèn
9269,種植,6,,16,131,147,ㄓㄨㄥˋ ㄓˊ,zhòng zhí
9270,中止,6,,9,5,14,ㄓㄨㄥ ㄓˇ,zhōng zhǐ
9271,終止,6,,8,5,13,ㄓㄨㄥ ㄓˇ,zhōng zhǐ
9272,舟,6,,10,12,22,ㄓㄡ,zhōu
9273,周到,6,,7,2,9,ㄓㄡ ㄉㄠˋ,zhōu dào
9274,州立,6,,11,0,11,ㄓㄡ ㄌㄧˋ,zhōu lì
9275,咒罵,6,,8,1,9,ㄓㄡˋ ㄇㄚˋ,zhòu mà
9276,皺紋,6,,9,4,13,ㄓㄡˋ ㄨㄣˊ,zhòu wén
9277,晝夜,6,,8,3,11,ㄓㄡˋ ㄧㄝˋ,zhòu yè
9278,周遭,6,,46,28,74,ㄓㄡ ㄗㄠ,zhōu zāo
9279,周轉,6,,1,1,2,ㄓㄡ ㄓㄨㄢˇ,zhōu zhuǎn
9280,柱,6,,11,7,18,ㄓㄨˋ,zhù
9281,著1,6,,4017,1760,5777,ㄓㄨˋ,zhù
9282,駐,6,,33,18,51,ㄓㄨˋ,zhù
9283,株,6,,21,40,61,ㄓㄨ,zhū
9284,珠寶,6,,15,8,23,ㄓㄨ ㄅㄠˇ,zhū bǎo
9285,主打,6,,1,4,5,ㄓㄨˇ ㄉㄚˇ,zhǔ dǎ
9286,注定/註定,6,,25,8,33,ㄓㄨˋ ㄉㄧㄥˋ,zhù dìng
9287,諸多,6,,23,5,28,ㄓㄨ ㄉㄨㄛ,zhū duō
9288,囑咐,6,,10,1,11,ㄓㄨˇ ㄈㄨˋ,zhǔ fù
9289,註解,6,,9,3,12,ㄓㄨˋ ㄐㄧㄝˇ,zhù jiě
9290,著名,6,,70,40,110,ㄓㄨˋ ㄇㄧㄥˊ,zhù míng
9291,矚目,6,,7,12,19,ㄓㄨˇ ㄇㄨˋ,zhǔ mù
9292,逐年,6,,4,10,14,ㄓㄨˊ ㄋㄧㄢˊ,zhú nián
9293,助人,6,,12,10,22,ㄓㄨˋ ㄖㄣˊ,zhù rén
9294,注入,6,,14,15,29,ㄓㄨˋ ㄖㄨˋ,zhù rù
9295,諸如,6,,26,2,28,ㄓㄨ ㄖㄨˊ,zhū rú
9296,注釋,6,,8,0,8,ㄓㄨˋ ㄕˋ,zhù shì
9297,註釋,6,,9,0,9,ㄓㄨˋ ㄕˋ,zhù shì
9298,助手,6,,11,9,20,ㄓㄨˋ ㄕㄡˇ,zhù shǒu
9299,諸位,6,,0,0,0,ㄓㄨ ㄨㄟˋ,zhū wèi
9300,逐一,6,,10,2,12,ㄓㄨˊ ㄧ,zhú yī
9301,助益,6,,12,2,14,ㄓㄨˋ ㄧˋ,zhù yì
9302,主宰,6,,13,3,16,ㄓㄨˇ ㄗㄞˇ,zhǔ zǎi
9303,駐紮,6,,8,4,12,ㄓㄨˋ ㄓㄚˊ,zhù zhá
9304,助長,6,,6,3,9,ㄓㄨˋ ㄓㄤˇ,zhù zhǎng
9305,主旨,6,,5,1,6,ㄓㄨˇ ㄓˇ,zhǔ zhǐ
9306,主軸,6,,9,5,14,ㄓㄨˇ ㄓㄡˊ,zhǔ zhóu
9307,柱子,6,,9,10,19,ㄓㄨˋ ˙ㄗ,zhù zi
9308,著作,6,,45,7,52,ㄓㄨˋ ㄗㄨㄛˋ,zhù zuò
9309,爪子/爪2,6,,14,8,22,ㄓㄨㄚˇ ˙ㄗ / ㄓㄨㄚˇ,zhuǎ zi / zhuǎ
9310,磚,6,,12,34,46,ㄓㄨㄢ,zhuān
9311,專案,6,,23,9,32,ㄓㄨㄢ ㄢˋ,zhuān àn
9312,專程,6,,6,4,10,ㄓㄨㄢ ㄔㄥˊ,zhuān chéng
9313,轉化,6,,18,8,26,ㄓㄨㄢˇ ㄏㄨㄚˋ,zhuǎn huà
9314,傳記,6,,14,6,20,ㄓㄨㄢˋ ㄐㄧˋ,zhuàn jì
9315,轉機,6,,6,14,20,ㄓㄨㄢˇ ㄐㄧ,zhuǎn jī
9316,專科,6,,7,8,15,ㄓㄨㄢ ㄎㄜ,zhuān kē
9317,專欄,6,,16,7,23,ㄓㄨㄢ ㄌㄢˊ,zhuān lán
9318,專利,6,,13,7,20,ㄓㄨㄢ ㄌㄧˋ,zhuān lì
9319,專權,6,,5,1,6,ㄓㄨㄢ ㄑㄩㄢˊ,zhuān quán
9320,專屬,6,,9,11,20,ㄓㄨㄢ ㄕㄨˇ,zhuān shǔ
9321,專題,6,,7,22,29,ㄓㄨㄢ ㄊㄧˊ,zhuān tí
9322,撰寫,6,,27,9,36,ㄓㄨㄢˋ ㄒㄧㄝˇ,zhuàn xiě
9323,轉型,6,,12,25,37,ㄓㄨㄢˇ ㄒㄧㄥˊ,zhuǎn xíng
9324,專用,6,,12,7,19,ㄓㄨㄢ ㄩㄥˋ,zhuān yòng
9325,轉折,6,,8,10,18,ㄓㄨㄢˇ ㄓㄜˊ,zhuǎn zhé
9326,狀,6,,12,13,25,ㄓㄨㄤˋ,zhuàng
9327,樁,6,,32,5,37,ㄓㄨㄤ,zhuāng
9328,裝扮,6,,5,4,9,ㄓㄨㄤ ㄅㄢˋ,zhuāng bàn
9329,裝備,6,,16,15,31,ㄓㄨㄤ ㄅㄟˋ,zhuāng bèi
9330,壯大,6,,8,7,15,ㄓㄨㄤˋ ㄉㄚˋ,zhuàng dà
9331,壯觀,6,,9,11,20,ㄓㄨㄤˋ ㄍㄨㄢ,zhuàng guān
9332,裝潢,6,,8,10,18,ㄓㄨㄤ ㄏㄨㄤˊ,zhuāng huáng
9333,撞擊,6,,10,11,21,ㄓㄨㄤˋ ㄐㄧˊ,zhuàng jí
9334,狀元,6,,9,3,12,ㄓㄨㄤˋ ㄩㄢˊ,zhuàng yuán
9335,莊園,6,,12,5,17,ㄓㄨㄤ ㄩㄢˊ,zhuāng yuán
9336,追捕,6,,6,1,7,ㄓㄨㄟ ㄅㄨˇ,zhuī bǔ
9337,追查,6,,9,2,11,ㄓㄨㄟ ㄔㄚˊ,zhuī chá
9338,追趕,6,,15,1,16,ㄓㄨㄟ ㄍㄢˇ,zhuī gǎn
9339,追擊,6,,10,1,11,ㄓㄨㄟ ㄐㄧˊ,zhuī jí
9340,追究,6,,11,4,15,ㄓㄨㄟ ㄐㄧㄡˋ,zhuī jiù
9341,追殺,6,,8,1,9,ㄓㄨㄟ ㄕㄚ,zhuī shā
9342,追溯,6,,6,7,13,ㄓㄨㄟ ㄙㄨˋ,zhuī sù
9343,追隨,6,,19,6,25,ㄓㄨㄟ ㄙㄨㄟˊ,zhuī suí
9344,追問,6,,16,1,17,ㄓㄨㄟ ㄨㄣˋ,zhuī wèn
9345,准許,6,,8,4,12,ㄓㄨㄣˇ ㄒㄩˇ,zhǔn xǔ
9346,準則,6,,16,4,20,ㄓㄨㄣˇ ㄗㄜˊ,zhǔn zé
9347,著2,6,,4017,1760,5777,ㄓㄨㄛˊ,zhuó
9348,琢磨,6,,8,2,10,ㄓㄨㄛˊ ㄇㄛˊ,zhuó mó
9349,捉弄,6,,6,2,8,ㄓㄨㄛ ㄋㄨㄥˋ,zhuō nòng
9350,著實,6,,10,3,13,ㄓㄨㄛˊ ㄕˊ,zhuó shí
9351,著手,6,,38,10,48,ㄓㄨㄛˊ ㄕㄡˇ,zhuó shǒu
9352,卓越,6,,19,4,23,ㄓㄨㄛˊ ㄩㄝˋ,zhuó yuè
9353,著重,6,,14,10,24,ㄓㄨㄛˊ ㄓㄨㄥˋ,zhuó zhòng
9354,茁壯,6,,7,11,18,ㄓㄨㄛˊ ㄓㄨㄤˋ,zhuó zhuàng
9355,自卑,6,,11,4,15,ㄗˋ ㄅㄟ,zì bēi
9356,自此,6,,15,4,19,ㄗˋ ㄘˇ,zì cǐ
9357,自大,6,,9,2,11,ㄗˋ ㄉㄚˋ,zì dà
9358,子彈,6,,15,6,21,ㄗˇ ㄉㄢˋ,zǐ dàn
9359,子弟,6,,24,8,32,ㄗˇ ㄉㄧˋ,zǐ dì
9360,自動自發,6,,6,4,10,ㄗˋ ㄉㄨㄥˋ ㄗˋ ㄈㄚ,zì dòng zì fā
9361,自發,6,,5,2,7,ㄗˋ ㄈㄚ,zì fā
9362,自負,6,,9,1,10,ㄗˋ ㄈㄨˋ,zì fù
9363,子宮,6,,15,4,19,ㄗˇ ㄍㄨㄥ,zǐ gōng
9364,自古以來,6,,8,10,18,ㄗˋ ㄍㄨˇ ㄧˇ ㄌㄞˊ,zì gǔ yǐ lái
9365,自豪,6,,14,5,19,ㄗˋ ㄏㄠˊ,zì háo
9366,自覺,6,,23,6,29,ㄗˋ ㄐㄩㄝˊ,zì jué
9367,自立,6,,10,6,16,ㄗˋ ㄌㄧˋ,zì lì
9368,資歷,6,,7,3,10,ㄗ ㄌㄧˋ,zī lì
9369,自律,6,,9,3,12,ㄗˋ ㄌㄩˋ,zì lǜ
9370,自然而然,6,,12,12,24,ㄗˋ ㄖㄢˊ ㄦˊ ㄖㄢˊ,zì rán ér rán
9371,自如,6,,8,1,9,ㄗˋ ㄖㄨˊ,zì rú
9372,諮商,6,,24,4,28,ㄗ ㄕㄤ,zī shāng
9373,自身,6,,46,15,61,ㄗˋ ㄕㄣ,zì shēn
9374,自始至終,6,,4,1,5,ㄗˋ ㄕˇ ㄓˋ ㄓㄨㄥ,zì shǐ zhì zhōng
9375,諮詢,6,,20,7,27,ㄗ ㄒㄩㄣˊ,zī xún
9376,字眼,6,,23,5,28,ㄗˋ ㄧㄢˇ,zì yǎn
9377,自言自語,6,,13,2,15,ㄗˋ ㄧㄢˊ ㄗˋ ㄩˇ,zì yán zì yǔ
9378,字樣,6,,7,1,8,ㄗˋ ㄧㄤˋ,zì yàng
9379,自以為是,6,,6,1,7,ㄗˋ ㄧˇ ㄨㄟˊ ㄕˋ,zì yǐ wéi shì
9380,自由自在,6,,8,5,13,ㄗˋ ㄧㄡˊ ㄗˋ ㄗㄞˋ,zì yóu zì zài
9381,自治,6,,7,8,15,ㄗˋ ㄓˋ,zì zhì
9382,自知,6,,11,1,12,ㄗˋ ㄓ,zì zhī
9383,資助,6,,10,9,19,ㄗ ㄓㄨˋ,zī zhù
9384,縱1,6,,19,3,22,ㄗㄨㄥˋ,zòng
9385,宗,6,,14,15,29,ㄗㄨㄥ,zōng
9386,縱2,6,,19,3,22,ㄗㄨㄥ,zōng
9387,縱橫,6,,10,5,15,ㄗㄨㄥ ㄏㄥˊ,zōng héng
9388,蹤跡,6,,7,7,14,ㄗㄨㄥ ㄐㄧ,zōng jī
9389,總監,6,,7,4,11,ㄗㄨㄥˇ ㄐㄧㄢ,zǒng jiān
9390,總結,6,,15,4,19,ㄗㄨㄥˇ ㄐㄧㄝˊ,zǒng jié
9391,縱然,6,,10,3,13,ㄗㄨㄥˋ ㄖㄢˊ,zòng rán
9392,縱容,6,,7,1,8,ㄗㄨㄥˋ ㄖㄨㄥˊ,zòng róng
9393,縱使,6,,15,6,21,ㄗㄨㄥˋ ㄕˇ,zòng shǐ
9394,蹤影,6,,12,4,16,ㄗㄨㄥ ㄧㄥˇ,zōng yǐng
9395,宗旨,6,,9,10,19,ㄗㄨㄥ ㄓˇ,zōng zhǐ
9396,揍,6,,11,2,13,ㄗㄡˋ,zòu
9397,走私,6,,8,6,14,ㄗㄡˇ ㄙ,zǒu sī
9398,奏效,6,,7,4,11,ㄗㄡˋ ㄒㄧㄠˋ,zòu xiào
9399,阻擋,6,,13,12,25,ㄗㄨˇ ㄉㄤˇ,zǔ dǎng
9400,祖國,6,,12,2,14,ㄗㄨˇ ㄍㄨㄛˊ,zǔ guó
9401,足跡,6,,8,49,57,ㄗㄨˊ ㄐㄧ,zú jī
9402,租賃,6,,3,1,4,ㄗㄨ ㄌㄧㄣˋ,zū lìn
9403,阻撓,6,,6,2,8,ㄗㄨˇ ㄋㄠˊ,zǔ náo
9404,阻塞,6,,9,8,17,ㄗㄨˇ ㄙㄜˋ,zǔ sè
9405,詛咒/咒,6,,19,2,21,ㄗㄨˇ ㄓㄡˋ/ㄓㄡˋ,zǔ zhòu/zhòu
9406,祖宗,6,,15,5,20,ㄗㄨˇ ㄗㄨㄥ,zǔ zōng
9407,足足,6,,10,10,20,ㄗㄨˊ ㄗㄨˊ,zú zú
9408,鑽石,6,,13,12,25,ㄗㄨㄢˋ ㄕˊ,zuàn shí
9409,罪犯,6,,15,3,18,ㄗㄨㄟˋ ㄈㄢˋ,zuì fàn
9410,嘴角,6,,11,4,15,ㄗㄨㄟˇ ㄐㄧㄠˇ,zuǐ jiǎo
9411,罪名,6,,14,4,18,ㄗㄨㄟˋ ㄇㄧㄥˊ,zuì míng
9412,罪行,6,,14,2,16,ㄗㄨㄟˋ ㄒㄧㄥˋ,zuì xìng
9413,尊,6,,59,17,76,ㄗㄨㄣ,zūn
9414,尊貴,6,,9,2,11,ㄗㄨㄣ ㄍㄨㄟˋ,zūn guì
9415,遵循,6,,17,6,23,ㄗㄨㄣ ㄒㄩㄣˊ,zūn xún
9416,尊嚴,6,,23,13,36,ㄗㄨㄣ ㄧㄢˊ,zūn yán
9417,遵照,6,,9,3,12,ㄗㄨㄣ ㄓㄠˋ,zūn zhào
9418,作伴/做伴,6,,4,1,5,ㄗㄨㄛˋ ㄅㄢˋ ,zuò bàn 
9419,作答/做答,6,,4,3,7,ㄗㄨㄛˋ ㄉㄚˊ,zuò dá
9420,作對,6,,5,1,6,ㄗㄨㄛˋ ㄉㄨㄟˋ,zuò duì
9421,作風,6,,20,11,31,ㄗㄨㄛˋ ㄈㄥ,zuò fēng
9422,作怪,6,,4,1,5,ㄗㄨㄛˋ ㄍㄨㄞˋ,zuò guài
9423,做官,6,,11,1,12,ㄗㄨㄛˋ ㄍㄨㄢ,zuò guān
9424,作畫,6,,6,7,13,ㄗㄨㄛˋ ㄏㄨㄚˋ,zuò huà
9425,坐牢,6,,8,1,9,ㄗㄨㄛˋ ㄌㄠˊ,zuò láo
9426,座落/坐落,6,,9,13,22,ㄗㄨㄛˋ ㄌㄨㄛˋ,zuò luò
9427,做人,6,,16,17,33,ㄗㄨㄛˋ ㄖㄣˊ,zuò rén
9428,作息,6,,13,13,26,ㄗㄨㄛˋ ㄒㄧˊ,zuò xí
9429,左右為難,6,,3,1,4,ㄗㄨㄛˇ ㄧㄡˋ ㄨㄟˊ ㄋㄢˊ,zuǒ yòu wéi nán
9430,作戰,6,,52,14,66,ㄗㄨㄛˋ ㄓㄢˋ,zuò zhàn
9431,作證/做證,6,,7,0,7,ㄗㄨㄛˋ ㄓㄥˋ,zuò zhèng
9432,作主/做主,6,,10,2,12,ㄗㄨㄛˋ ㄓㄨˇ ,zuò zhǔ 
9433,愛不釋手,7,,2,2,4,ㄞˋ ㄅㄨˊ ㄕˋ ㄕㄡˇ,ài bú shì shǒu
9434,哀愁,7,,3,2,5,ㄞ ㄔㄡˊ,āi chóu
9435,愛戴,7,,5,3,8,ㄞˋ ㄉㄞˋ,ài dài
9436,哀悼,7,,7,6,13,ㄞ ㄉㄠˋ,āi dào
9437,愛撫,7,,3,0,3,ㄞˋ ㄈㄨˇ,ài fǔ
9438,哀嚎,7,,2,4,6,ㄞ ㄏㄠˊ,āi háo
9439,哀號,7,,4,1,5,ㄞ ㄏㄠˊ,āi háo
9440,愛恨,7,,3,2,5,ㄞˋㄏㄣˋ,ài hèn
9441,挨家挨戶,7,,3,5,8,ㄞ ㄐㄧㄚ ㄞ ㄏㄨˋ,āi jiā āi hù
9442,礙事,7,,2,1,3,ㄞˋ ㄕˋ,ài shì
9443,哀痛,7,,3,1,4,ㄞ ㄊㄨㄥˋ,āi tòng
9444,礙於,7,,4,3,7,ㄞˋ ㄩˊ,ài yú
9445,哀怨,7,,3,0,3,ㄞ ㄩㄢˋ,āi yuàn
9446,愛滋病,7,,10,16,26,ㄞˋ ㄗ ㄅㄧㄥˋ,ài zī bìng
9447,諳,7,,3,1,4,ㄢ,ān
9448,按兵不動,7,,3,1,4,ㄢˋ ㄅㄧㄥ ㄅㄨˋ ㄉㄨㄥˋ,àn bīng bù dòng
9449,按部就班,7,,4,3,7,ㄢˋ ㄅㄨˋ ㄐㄧㄡˋ ㄅㄢ,àn bù jiù bān
9450,暗藏,7,,5,3,8,ㄢˋ ㄘㄤˊ,àn cáng
9451,安插,7,,2,1,3,ㄢ ㄔㄚ,ān chā
9452,暗地,7,,4,2,6,ㄢˋ ㄉㄧˋ,àn dì
9453,安放,7,,4,1,5,ㄢ ㄈㄤˋ,ān fàng
9454,安分,7,,3,0,3,ㄢ ㄈㄣˋ,ān fèn
9455,暗號,7,,4,1,5,ㄢˋ ㄏㄠˋ,àn hào
9456,按鍵,7,,5,3,8,ㄢˋ ㄐㄧㄢˋ,àn jiàn
9457,安居樂業,7,,3,3,6,ㄢ ㄐㄩ ㄌㄜˋ ㄧㄝˋ,ān jū lè yè
9458,安樂,7,,3,2,5,ㄢ ㄌㄜˋ,ān lè
9459,按理,7,,2,1,3,ㄢˋ ㄌㄧˇ,àn lǐ
9460,安眠藥,7,,5,2,7,ㄢ ㄇㄧㄢˊ ㄧㄠˋ,ān mián yào
9461,按捺,7,,4,0,4,ㄢˋ ㄋㄚˋ,àn nà
9462,案情,7,,6,1,7,ㄢˋ ㄑㄧㄥˊ,àn qíng
9463,安全帶,7,,5,1,6,ㄢ ㄑㄩㄢˊ ㄉㄞˋ,ān quán dài
9464,黯然,7,,5,2,7,ㄢˋ ㄖㄢˊ,àn rán
9465,安然,7,,7,4,11,ㄢ ㄖㄢˊ,ān rán
9466,安然無恙,7,,3,2,5,ㄢ ㄖㄢˊ ㄨˊ ㄧㄤˋ,ān rán wú yàng
9467,安身立命,7,,4,4,8,ㄢ ㄕㄣ ㄌㄧˋ ㄇㄧㄥˋ,ān shēn lì mìng
9468,安息,7,,6,2,8,ㄢ ㄒㄧˊ,ān xí
9469,安詳,7,,6,3,9,ㄢ ㄒㄧㄤˊ,ān xiáng
9470,安逸,7,,6,2,8,ㄢ ㄧˋ,ān yì
9471,安於,7,,3,1,4,ㄢ ㄩˊ,ān yú
9472,昂然,7,,2,1,3,ㄤˊ ㄖㄢˊ,áng rán
9473,盎然,7,,6,4,10,ㄤˋ ㄖㄢˊ,àng rán
9474,昂首,7,,3,1,4,ㄤˊ ㄕㄡˇ,áng shǒu
9475,凹,7,,3,5,8,ㄠ,āo
9476,懊悔,7,,6,1,7,ㄠˋ ㄏㄨㄟˇ,ào huǐ
9477,奧妙,7,,7,6,13,ㄠˋ ㄇㄧㄠˋ,ào miào
9478,翱翔,7,,4,2,6,ㄠˊ ㄒㄧㄤˊ,áo xiáng
9479,遨遊,7,,3,2,5,ㄠˊ ㄧㄡˊ,áo yóu
9480,扒1,7,,4,2,6,ㄅㄚ,bā
9481,捌,7,,1,0,1,ㄅㄚ,bā
9482,把柄,7,,3,1,4,ㄅㄚˇ ㄅㄧㄥˇ,bǎ bǐng
9483,巴不得,7,,4,1,5,ㄅㄚ ㄅㄨˋ ˙ㄉㄜ,bā bù de
9484,把持,7,,5,2,7,ㄅㄚˇ ㄔˊ,bǎ chí
9485,拔除,7,,3,4,7,ㄅㄚˊ ㄔㄨˊ,bá chú
9486,罷黜,7,,4,6,10,ㄅㄚˋ ㄔㄨˋ,bà chù
9487,跋扈,7,,5,1,6,ㄅㄚˊ ㄏㄨˋ,bá hù
9488,巴結,7,,4,1,5,ㄅㄚ ㄐㄧㄝˊ,bā jié
9489,跋涉,7,,4,3,7,ㄅㄚˊ ㄕㄜˋ,bá shè
9490,罷手,7,,2,0,2,ㄅㄚˋ ㄕㄡˇ,bà shǒu
9491,把手,7,,5,1,6,ㄅㄚˇ ㄕㄡˇ,bǎ shǒu
9492,拔腿,7,,3,1,4,ㄅㄚˊ ㄊㄨㄟˇ,bá tuǐ
9493,拔腿就跑,7,,2,0,2,ㄅㄚˊ ㄊㄨㄟˇ ㄐㄧㄡˋ ㄆㄠˇ,bá tuǐ jiù pǎo
9494,把玩,7,,4,1,5,ㄅㄚˇ ㄨㄢˋ,bǎ wàn
9495,霸王,7,,6,1,7,ㄅㄚˋ ㄨㄤˊ,bà wáng
9496,把戲,7,,10,0,10,ㄅㄚˇ ㄒㄧˋ,bǎ xì
9497,霸主,7,,4,1,5,ㄅㄚˋ ㄓㄨˇ,bà zhǔ
9498,拔擢,7,,4,0,4,ㄅㄚˊ ㄓㄨㄛˊ,bá zhuó
9499,八字,7,,4,1,5,ㄅㄚ ㄗˋ,bā zì
9500,百般,7,,7,2,9,ㄅㄞˇ ㄅㄢ,bǎi bān
9501,擺佈/擺布,7,,6,1,7,ㄅㄞˇ ㄅㄨˋ,bǎi bù
9502,擺盪,7,,4,4,8,ㄅㄞˇ ㄉㄤˋ,bǎi dàng
9503,拜讀,7,,4,0,4,ㄅㄞˋ ㄉㄨˊ,bài dú
9504,白髮蒼蒼,7,,2,1,3,ㄅㄞˊ ㄈㄚˇ ㄘㄤ ㄘㄤ,bái fǎ cāng cāng
9505,白話,7,,8,2,10,ㄅㄞˊ ㄏㄨㄚˋ,bái huà
9506,白花花,7,,3,1,4,ㄅㄞˊ ㄏㄨㄚ ㄏㄨㄚ,bái huā huā
9507,敗壞,7,,6,1,7,ㄅㄞˋ ㄏㄨㄞˋ,bài huài
9508,拜會,7,,2,1,3,ㄅㄞˋ ㄏㄨㄟˋ,bài huì
9509,百科全書,7,,6,2,8,ㄅㄞˇ ㄎㄜ ㄑㄩㄢˊ ㄕㄨ,bǎi kē quán shū
9510,白領,7,,3,0,3,ㄅㄞˊ ㄌㄧㄥˇ,bái lǐng
9511,敗露,7,,3,0,3,ㄅㄞˋ ㄌㄨˋ,bài lù
9512,擺明,7,,2,2,4,ㄅㄞˇ ㄇㄧㄥˊ,bǎi míng
9513,白皮書,7,,1,1,2,ㄅㄞˊ ㄆㄧˊ ㄕㄨ,bái pí shū
9514,百思不解,7,,2,1,3,ㄅㄞˇ ㄙ ㄅㄨˋ ㄐㄧㄝˇ,bǎi sī bù jiě
9515,百態,7,,2,3,5,ㄅㄞˇ ㄊㄞˋ,bǎi tài
9516,敗退,7,,4,1,5,ㄅㄞˋ ㄊㄨㄟˋ,bài tuì
9517,白皙,7,,5,1,6,ㄅㄞˊ ㄒㄧ,bái xī
9518,白眼,7,,4,0,4,ㄅㄞˊ ㄧㄢˇ,bái yǎn
9519,白晝,7,,5,1,6,ㄅㄞˊ ㄓㄡˋ,bái zhòu
9520,瓣,7,,4,3,7,ㄅㄢˋ,bàn
9521,絆,7,,3,1,4,ㄅㄢˋ,bàn
9522,扳,7,,4,3,7,ㄅㄢ,bān
9523,半島,7,,6,16,22,ㄅㄢˋ ㄉㄠˇ,bàn dǎo
9524,絆腳石,7,,4,1,5,ㄅㄢˋ ㄐㄧㄠˇ ㄕˊ,bàn jiǎo shí
9525,版面,7,,4,7,11,ㄅㄢˇ ㄇㄧㄢˋ,bǎn miàn
9526,搬遷,7,,3,8,11,ㄅㄢ ㄑㄧㄢ,bān qiān
9527,半晌,7,,8,1,9,ㄅㄢˋ ㄕㄤˇ,bàn shǎng
9528,版圖,7,,7,5,12,ㄅㄢˇ ㄊㄨˊ,bǎn tú
9529,半途而廢,7,,3,3,6,ㄅㄢˋ ㄊㄨˊ ㄦˊ ㄈㄟˋ,bàn tú ér fèi
9530,伴奏,7,,4,1,5,ㄅㄢˋ ㄗㄡˋ,bàn zòu
9531,幫派,7,,12,4,16,ㄅㄤ ㄆㄞˋ,bāng pài
9532,報表,7,,5,0,5,ㄅㄠˋ ㄅㄧㄠˇ,bào biǎo
9533,報償,7,,4,1,5,ㄅㄠˋ ㄔㄤˊ,bào cháng
9534,寶島,7,,3,4,7,ㄅㄠˇ ㄉㄠˇ,bǎo dǎo
9535,包覆,7,,4,5,9,ㄅㄠ ㄈㄨˋ,bāo fù
9536,包管,7,,3,0,3,ㄅㄠ ㄍㄨㄢˇ,bāo guǎn
9537,包涵,7,,2,1,3,ㄅㄠ ㄏㄢˊ,bāo hán
9538,飽和,7,,7,10,17,ㄅㄠˇ ㄏㄜˊ,bǎo hé
9539,寶劍,7,,11,1,12,ㄅㄠˇ ㄐㄧㄢˋ,bǎo jiàn
9540,暴君,7,,6,1,7,ㄅㄠˋ ㄐㄩㄣ,bào jūn
9541,報考,7,,3,2,5,ㄅㄠˋ ㄎㄠˇ,bào kǎo
9542,堡壘,7,,4,5,9,ㄅㄠˇ ㄌㄟˇ,bǎo lěi
9543,暴戾,7,,3,2,5,ㄅㄠˋ ㄌㄧˋ,bào lì
9544,保姆,7,,8,1,9,ㄅㄠˇ ㄇㄨˇ,bǎo mǔ
9545,暴怒,7,,3,0,3,ㄅㄠˋ ㄋㄨˋ,bào nù
9546,保暖,7,,5,8,13,ㄅㄠˇ ㄋㄨㄢˇ,bǎo nuǎn
9547,暴虐,7,,5,1,6,ㄅㄠˋ ㄋㄩㄝˋ,bào nüè
9548,保守派,7,,3,4,7,ㄅㄠˇ ㄕㄡˇ ㄆㄞˋ,bǎo shǒu pài
9549,暴跳如雷,7,,3,0,3,ㄅㄠˋ ㄊㄧㄠˋ ㄖㄨˊ ㄌㄟˊ,bào tiào rú léi
9550,抱頭,7,,3,1,4,ㄅㄠˋ ㄊㄡˊ,bào tóu
9551,報信,7,,3,0,3,ㄅㄠˋ ㄒㄧㄣˋ,bào xìn
9552,報以,7,,3,0,3,ㄅㄠˋ ㄧˇ,bào yǐ
9553,保育,7,,8,53,61,ㄅㄠˇ ㄩˋ,bǎo yù
9554,包紮,7,,5,1,6,ㄅㄠ ㄗㄚ,bāo zā
9555,暴漲,7,,3,15,18,ㄅㄠˋ ㄓㄤˇ,bào zhǎng
9556,暴政,7,,4,1,5,ㄅㄠˋ ㄓㄥˋ,bào zhèng
9557,被單,7,,3,1,4,ㄅㄟˋ ㄉㄢ,bèi dān
9558,背道而馳,7,,4,2,6,ㄅㄟˋ ㄉㄠˋ ㄦˊ ㄔˊ,bèi dào ér chí
9559,悲憤,7,,5,1,6,ㄅㄟ ㄈㄣˋ,bēi fèn
9560,背脊,7,,5,2,7,ㄅㄟˋ ㄐㄧˇ,bèi jǐ
9561,卑賤,7,,3,1,4,ㄅㄟ ㄐㄧㄢˋ,bēi jiàn
9562,悲苦,7,,3,3,6,ㄅㄟ ㄎㄨˇ,bēi kǔ
9563,背離,7,,4,1,5,ㄅㄟˋ ㄌㄧˊ,bèi lí
9564,卑劣,7,,3,1,4,ㄅㄟ ㄌㄧㄝˋ,bēi liè
9565,背棄,7,,3,1,4,ㄅㄟˋ ㄑㄧˋ,bèi qì
9566,悲情,7,,3,5,8,ㄅㄟ ㄑㄧㄥˊ,bēi qíng
9567,背書,7,,4,7,11,ㄅㄟˋ ㄕㄨ,bèi shū
9568,卑微,7,,6,3,9,ㄅㄟ ㄨㄟˊ,bēi wéi
9569,被窩,7,,4,1,5,ㄅㄟˋ ㄨㄛ,bèi wō
9570,倍增,7,,3,2,5,ㄅㄟˋ ㄗㄥ,bèi zēng
9571,悲壯,7,,4,0,4,ㄅㄟ ㄓㄨㄤˋ,bēi zhuàng
9572,備感,7,,3,1,4,ㄅㄟˋㄍㄢˇ,bèigǎn
9573,奔放,7,,3,1,4,ㄅㄣ ㄈㄤˋ,bēn fàng
9574,奔流,7,,3,2,5,ㄅㄣ ㄌㄧㄡˊ,bēn liú
9575,本末倒置,7,,2,2,4,ㄅㄣˇ ㄇㄛˋ ㄉㄠˋ ㄓˋ,běn mò dào zhì
9576,本色,7,,5,1,6,ㄅㄣˇ ㄙㄜˋ,běn sè
9577,奔逃,7,,4,0,4,ㄅㄣ ㄊㄠˊ,bēn táo
9578,奔騰,7,,3,3,6,ㄅㄣ ㄊㄥˊ,bēn téng
9579,本位,7,,7,1,8,ㄅㄣˇ ㄨㄟˋ,běn wèi
9580,甭,7,,3,1,4,ㄅㄥˊ,béng
9581,蹦,7,,3,2,5,ㄅㄥˋ,bèng
9582,崩塌,7,,3,16,19,ㄅㄥ ㄊㄚ,bēng tā
9583,敝,7,,6,1,7,ㄅㄧˋ,bì
9584,斃,7,,3,2,5,ㄅㄧˋ,bì
9585,比比皆是,7,,3,3,6,ㄅㄧˋ ㄅㄧˋ ㄐㄧㄝ ㄕˋ,bì bì jiē shì
9586,弊病,7,,3,1,4,ㄅㄧˋ ㄅㄧㄥˋ,bì bìng
9587,筆觸,7,,3,3,6,ㄅㄧˇ ㄔㄨˋ,bǐ chù
9588,筆調,7,,3,1,4,ㄅㄧˇ ㄉㄧㄠˋ,bǐ diào
9589,弊端,7,,4,2,6,ㄅㄧˋ ㄉㄨㄢ,bì duān
9590,筆法,7,,3,1,4,ㄅㄧˇ ㄈㄚˇ,bǐ fǎ
9591,庇護,7,,6,15,21,ㄅㄧˋ ㄏㄨˋ,bì hù
9592,比劃,7,,3,1,4,ㄅㄧˇ ㄏㄨㄚˋ,bǐ huà
9593,筆畫,7,,2,1,3,ㄅㄧˇ ㄏㄨㄚˋ,bǐ huà
9594,避諱,7,,3,2,5,ㄅㄧˋ ㄏㄨㄟˋ,bì huì
9595,閉口,7,,3,1,4,ㄅㄧˋㄎㄡˇ,bì kǒu
9596,畢露,7,,3,0,3,ㄅㄧˋ ㄌㄨˋ,bì lù
9597,碧綠,7,,3,1,4,ㄅㄧˋ ㄌㄩˋ,bì lǜ
9598,篳路藍縷,7,,2,1,3,ㄅㄧˋ ㄌㄨˋ ㄌㄢˊ ㄌㄩˇ,bì lù lán lǚ
9599,閉門,7,,4,3,7,ㄅㄧˋ ㄇㄣˊ,bì mén
9600,筆名,7,,4,0,4,ㄅㄧˇ ㄇㄧㄥˊ,bǐ míng
9601,閉目,7,,3,0,3,ㄅㄧˋ ㄇㄨˋ,bì mù
9602,逼人,7,,4,1,5,ㄅㄧ ㄖㄣˊ,bī rén
9603,彼時,7,,3,1,4,ㄅㄧˇ ㄕˊ,bǐ shí
9604,鄙視,7,,7,1,8,ㄅㄧˇ ㄕˋ,bǐ shì
9605,逼問,7,,3,1,4,ㄅㄧ ㄨㄣˋ,bī wèn
9606,陛下,7,,21,1,22,ㄅㄧˋ ㄒㄧㄚˋ,bì xià
9607,鄙夷,7,,3,0,3,ㄅㄧˇ ㄧˊ,bǐ yí
9608,比照,7,,4,3,7,ㄅㄧˇ ㄓㄠˋ,bǐ zhào
9609,貶,7,,6,2,8,ㄅㄧㄢˇ,biǎn
9610,鞭,7,,4,1,5,ㄅㄧㄢ,biān
9611,變本加厲,7,,4,2,6,ㄅㄧㄢˋ ㄅㄣˇ ㄐㄧㄚ ㄌㄧˋ,biàn běn jiā lì
9612,辯駁,7,,3,1,4,ㄅㄧㄢˋ ㄅㄛˊ,biàn bó
9613,鞭策,7,,3,2,5,ㄅㄧㄢ ㄘㄜˋ,biān cè
9614,辯稱,7,,2,1,3,ㄅㄧㄢˋ ㄔㄥ,biàn chēng
9615,邊陲,7,,4,4,8,ㄅㄧㄢ ㄔㄨㄟˊ,biān chuí
9616,鞭打,7,,4,1,5,ㄅㄧㄢ ㄉㄚˇ,biān dǎ
9617,變法,7,,14,0,14,ㄅㄧㄢˋ ㄈㄚˇ,biàn fǎ
9618,變故,7,,5,2,7,ㄅㄧㄢˋ ㄍㄨˋ,biàn gù
9619,變化多端,7,,3,1,4,ㄅㄧㄢˋ ㄏㄨㄚˋ ㄉㄨㄛ ㄉㄨㄢ,biàn huà duō duān
9620,變幻,7,,4,1,5,ㄅㄧㄢˋ ㄏㄨㄢˋ,biàn huàn
9621,邊疆,7,,6,3,9,ㄅㄧㄢ ㄐㄧㄤ,biān jiāng
9622,變局,7,,4,1,5,ㄅㄧㄢˋ ㄐㄩˊ,biàn jú
9623,編排,7,,4,1,5,ㄅㄧㄢ ㄆㄞˊ,biān pái
9624,鞭炮,7,,3,17,20,ㄅㄧㄢ ㄆㄠˋ,biān pào
9625,編入,7,,3,1,4,ㄅㄧㄢ ㄖㄨˋ,biān rù
9626,變色,7,,5,11,16,ㄅㄧㄢˋ ㄙㄜˋ,biàn sè
9627,便條,7,,6,1,7,ㄅㄧㄢˋ ㄊㄧㄠˊ,biàn tiáo
9628,遍野,7,,4,3,7,ㄅㄧㄢˋ ㄧㄝˇ,biàn yě
9629,變異,7,,7,8,15,ㄅㄧㄢˋ ㄧˋ,biàn yì
9630,貶抑,7,,6,1,7,ㄅㄧㄢˇ ㄧˋ,biǎn yì
9631,編造,7,,5,0,5,ㄅㄧㄢ ㄗㄠˋ,biān zào
9632,辯證,7,,7,1,8,ㄅㄧㄢˋ ㄓㄥˋ,biàn zhèng
9633,變質,7,,3,2,5,ㄅㄧㄢˋ ㄓˊ,biàn zhí
9634,編制,7,,5,3,8,ㄅㄧㄢ ㄓˋ,biān zhì
9635,表白,7,,4,1,5,ㄅㄧㄠˇ ㄅㄞˊ,biǎo bái
9636,標榜,7,,6,6,12,ㄅㄧㄠ ㄅㄤˇ,biāo bǎng
9637,標本,7,,5,44,49,ㄅㄧㄠ ㄅㄣˇ,biāo běn
9638,標竿,7,,3,2,5,ㄅㄧㄠ ㄍㄢ,biāo gān
9639,表述,7,,7,1,8,ㄅㄧㄠˇ ㄕㄨˋ,biǎo shù
9640,表象,7,,6,3,9,ㄅㄧㄠˇ ㄒㄧㄤˋ,biǎo xiàng
9641,表揚,7,,6,4,10,ㄅㄧㄠˇ ㄧㄤˊ,biǎo yáng
9642,表彰,7,,3,1,4,ㄅㄧㄠˇ ㄓㄤ,biǎo zhāng
9643,表徵,7,,11,2,13,ㄅㄧㄠˇ ㄓㄥ,biǎo zhēng
9644,別出心裁,7,,2,2,4,ㄅㄧㄝˊ ㄔㄨ ㄒㄧㄣ ㄘㄞˊ,bié chū xīn cái
9645,彆扭,7,,4,2,6,ㄅㄧㄝˋ ㄋㄧㄡˇ,biè niǔ
9646,彬彬有禮,7,,4,1,5,ㄅㄧㄣ ㄅㄧㄣ ㄧㄡˇ ㄌㄧˇ,bīn bīn yǒu lǐ
9647,繽紛,7,,6,9,15,ㄅㄧㄣ ㄈㄣ,bīn fēn
9648,檳榔,7,,6,10,16,ㄅㄧㄣ ㄌㄤˊ,bīn láng
9649,稟報,7,,4,0,4,ㄅㄧㄥˇ ㄅㄠˋ,bǐng bào
9650,秉持,7,,6,7,13,ㄅㄧㄥˇ ㄔˊ,bǐng chí
9651,摒除,7,,2,1,3,ㄅㄧㄥˋ ㄔㄨˊ,bìng chú
9652,冰凍,7,,3,3,6,ㄅㄧㄥ ㄉㄨㄥˋ,bīng dòng
9653,併發症,7,,5,5,10,ㄅㄧㄥˋ ㄈㄚ ㄓㄥˋ,bìng fā zhèng
9654,稟告,7,,5,0,5,ㄅㄧㄥˇ ㄍㄠˋ,bǐng gào
9655,並駕齊驅,7,,2,1,3,ㄅㄧㄥˋ ㄐㄧㄚˋ ㄑㄧˊ ㄑㄩ,bìng jià qí qū
9656,並進,7,,3,0,3,ㄅㄧㄥˋ ㄐㄧㄣˋ,bìng jìn
9657,病歷,7,,6,1,7,ㄅㄧㄥˋ ㄌㄧˋ,bìng lì
9658,病理,7,,4,3,7,ㄅㄧㄥˋ ㄌㄧˇ,bìng lǐ
9659,病魔,7,,3,3,6,ㄅㄧㄥˋ ㄇㄛˊ,bìng mó
9660,摒棄,7,,4,1,5,ㄅㄧㄥˋ ㄑㄧˋ,bìng qì
9661,兵器,7,,5,1,6,ㄅㄧㄥ ㄑㄧˋ,bīng qì
9662,病入膏肓,7,,2,1,3,ㄅㄧㄥˋ ㄖㄨˋ ㄍㄠ ㄏㄨㄤ,bìng rù gāo huāng
9663,冰山一角,7,,1,0,1,ㄅㄧㄥ ㄕㄢ ㄧˋ ㄐㄧㄠˇ,bīng shān yī jiǎo
9664,病榻,7,,3,2,5,ㄅㄧㄥˋ ㄊㄚˋ,bìng tà
9665,併吞,7,,4,1,5,ㄅㄧㄥˋ ㄊㄨㄣ,bìng tūn
9666,病危,7,,4,4,8,ㄅㄧㄥˋ ㄨㄟˊ,bìng wéi
9667,屏息,7,,4,1,5,ㄅㄧㄥˇ ㄒㄧˊ,bǐng xí
9668,並行,7,,3,1,4,ㄅㄧㄥˋ ㄒㄧㄥˊ,bìng xíng
9669,並行不悖,7,,2,0,2,ㄅㄧㄥˋ ㄒㄧㄥˊ ㄅㄨˊ ㄅㄟˋ,bìng xíng bú  bèi
9670,博愛,7,,3,4,7,ㄅㄛˊ ㄞˋ,bó ài
9671,駁斥,7,,5,1,6,ㄅㄛˊ ㄔˋ,bó chì
9672,駁回,7,,3,1,4,ㄅㄛˊ ㄏㄨㄟˊ,bó huí
9673,波及,7,,4,7,11,ㄅㄛ ㄐㄧˊ,bō jí
9674,伯爵,7,,29,0,29,ㄅㄛˊㄐㄩㄝˊ,bó jué
9675,波瀾,7,,3,2,5,ㄅㄛ ㄌㄢˊ,bō lán
9676,撥弄,7,,3,2,5,ㄅㄛ ㄋㄨㄥˋ,bō nòng
9677,剝皮,7,,3,2,5,ㄅㄛ ㄆㄧˊ,bō pí
9678,博取,7,,3,1,4,ㄅㄛˊ ㄑㄩˇ,bó qǔ
9679,勃然大怒,7,,5,0,5,ㄅㄛˊ ㄖㄢˊ ㄉㄚˋ ㄋㄨˋ,bó rán dà nù
9680,博學,7,,4,1,5,ㄅㄛˊ ㄒㄩㄝˊ,bó xué
9681,波折,7,,3,3,6,ㄅㄛ ㄓㄜˊ,bō zhé
9682,播種,7,,5,14,19,ㄅㄛˋ ㄓㄨㄥˇ,bò zhǒng
9683,卜,7,,8,1,9,ㄅㄨˇ,bǔ
9684,步步為營,7,,3,0,3,ㄅㄨˋ ㄅㄨˋ ㄨㄟˊ ㄧㄥˊ,bù bù wéi yíng
9685,不啻,7,,3,0,3,ㄅㄨˊ ㄔˋ,bú chì
9686,不齒,7,,2,0,2,ㄅㄨˋ ㄔˇ,bù chǐ
9687,不敵,7,,4,3,7,ㄅㄨˋ ㄉㄧˊ,bù dí
9688,不動聲色,7,,4,0,4,ㄅㄨˊ ㄉㄨㄥˋ ㄕㄥ ㄙㄜˋ,bú dòng shēng sè
9689,不二法門,7,,2,3,5,ㄅㄨˊ ㄦˋ ㄈㄚˇ ㄇㄣˊ,bú èr fǎ mén
9690,不寒而慄,7,,4,1,5,ㄅㄨˋ ㄏㄢˊ ㄦˊ ㄌㄧˋ,bù hán ér lì
9691,不合時宜,7,,3,0,3,ㄅㄨˋ ㄏㄜˊ ㄕˊ ㄧˊ,bù hé shí yí
9692,不懷好意,7,,3,1,4,ㄅㄨˋ ㄏㄨㄞˊ ㄏㄠˇ ㄧˋ,bù huái hǎo yì
9693,捕獲,7,,5,3,8,ㄅㄨˇ ㄏㄨㄛˋ,bǔ huò
9694,不羈,7,,4,0,4,ㄅㄨˋ ㄐㄧ,bù jī
9695,不計其數,7,,4,1,5,ㄅㄨˋ ㄐㄧˋ ㄑㄧˊ ㄕㄨˋ,bù jì qí shù
9696,不盡然,7,,4,4,8,ㄅㄨˊ ㄐㄧㄣˋ ㄖㄢˊ,bú jìn rán
9697,布局/佈局,7,,9,7,16,ㄅㄨˋ ㄐㄩˊ,bù jú
9698,不拘,7,,4,1,5,ㄅㄨˋ ㄐㄩ,bù jū
9699,不絕,7,,5,4,9,ㄅㄨˋ ㄐㄩㄝˊ,bù jué
9700,不均,7,,3,2,5,ㄅㄨˋ ㄐㄩㄣ,bù jūn
9701,不堪設想,7,,3,1,4,ㄅㄨˋ ㄎㄢ ㄕㄜˋ ㄒㄧㄤˇ,bù kān shè xiǎng
9702,不堪一擊,7,,3,1,4,ㄅㄨˋ ㄎㄢ ㄧ ㄐㄧˊ,bù kān yī jí
9703,不可開交,7,,5,4,9,ㄅㄨˋ ㄎㄜˇ ㄎㄞ ㄐㄧㄠ,bù kě kāi jiāo
9704,不可理喻,7,,2,1,3,ㄅㄨˋ ㄎㄜˇ ㄌㄧˇ ㄩˋ,bù kě lǐ yù
9705,不可同日而語,7,,0,0,0,ㄅㄨˋ ㄎㄜˇ ㄊㄨㄥˊ ㄖˋ ㄦˊ ㄩˇ,bù kě tóng rì ér yǔ
9706,不可言喻,7,,0,0,0,ㄅㄨˋ ㄎㄜˇ ㄧㄢˊ ㄩˋ,bù kě yán yù
9707,不可一世,7,,3,1,4,ㄅㄨˋ ㄎㄜˇ ㄧˊ ㄕ,bù kě yí shì
9708,不愧,7,,5,6,11,ㄅㄨˊ ㄎㄨㄟˋ,bú kuì
9709,不吝,7,,3,2,5,ㄅㄨˊ ㄌㄧㄣˋ,bú lìn
9710,步履,7,,4,2,6,ㄅㄨˋ ㄌㄩˇ,bù lǚ
9711,不謀而合,7,,4,2,6,ㄅㄨˋ ㄇㄡˊ ㄦˊ ㄏㄜˊ,bù móu ér hé
9712,不偏不倚,7,,3,1,4,ㄅㄨˋ ㄆㄧㄢ ㄅㄨˋ ㄧˇ,bù piān bù yǐ
9713,不屈不撓,7,,4,2,6,ㄅㄨˋ ㄑㄩ ㄅㄨˋ ㄋㄠˊ,bù qū bù náo
9714,不容,7,,14,7,21,ㄅㄨˋ ㄖㄨㄥˊ,bù róng
9715,不容置疑,7,,2,0,2,ㄅㄨˋ ㄖㄨㄥˊ ㄓˋ ㄧˊ,bù róng zhì yí
9716,哺乳動物,7,,2,3,5,ㄅㄨˇ ㄖㄨˇ ㄉㄨㄥˋ ㄨˋ,bǔ rǔ dòng wù
9717,不捨,7,,5,8,13,ㄅㄨˋ ㄕㄜˇ,bù shě
9718,不勝枚舉,7,,5,1,6,ㄅㄨˋ ㄕㄥ ㄇㄟˊ ㄐㄩˇ,bù shēng méi jǔ
9719,不失為,7,,4,1,5,ㄅㄨˋ ㄕ ㄨㄟˊ,bù shī wéi
9720,布條,7,,3,4,7,ㄅㄨˋ ㄊㄧㄠˊ,bù tiáo
9721,補貼,7,,3,11,14,ㄅㄨˇ ㄊㄧㄝ,bǔ tiē
9722,不為過,7,,4,1,5,ㄅㄨˋ ㄨㄟˊ ㄍㄨㄛˋ,bù wéi guò
9723,不為所動,7,,4,1,5,ㄅㄨˋ ㄨㄟˊ ㄙㄨㄛˇ ㄉㄨㄥˋ,bù wéi suǒ dòng
9724,不相上下,7,,3,2,5,ㄅㄨˋ ㄒㄧㄤ ㄕㄤˋ ㄒㄧㄚˋ,bù xiāng shàng xià
9725,不肖,7,,5,1,6,ㄅㄨˋ ㄒㄧㄠˋ,bù xiào
9726,不屑一顧,7,,3,0,3,ㄅㄨˋ ㄒㄧㄝˋ ㄧˊ ㄍㄨˋ,bù xiè yí gù
9727,不省人事,7,,3,0,3,ㄅㄨˋ ㄒㄧㄥˇ ㄖㄣˊ ㄕˋ,bù xǐng rén shì
9728,不厭其煩,7,,4,3,7,ㄅㄨˊ ㄧㄢˋ ㄑㄧˊ ㄈㄢˊ,bú yàn qí fán
9729,不亦樂乎,7,,2,3,5,ㄅㄨˊ ㄧˋ ㄌㄜˋ ㄏㄨ,bú yì lè hū
9730,不以為意,7,,3,2,5,ㄅㄨˋ ㄧˇ ㄨㄟˊ ㄧˋ,bù yǐ wéi yì
9731,不遺餘力,7,,4,4,8,ㄅㄨˋ ㄧˊ ㄩˊ ㄌㄧˋ,bù yí yú lì
9732,不由,7,,3,0,3,ㄅㄨˋ ㄧㄡˊ,bù yóu
9733,不渝,7,,4,1,5,ㄅㄨˋ ㄩˊ,bù yú
9734,不虞,7,,2,3,5,ㄅㄨˋ ㄩˊ,bù yú
9735,不在話下,7,,3,2,5,ㄅㄨˊ ㄗㄞˋ ㄏㄨㄚˋ ㄒㄧㄚˋ,bú zài huà xià
9736,不擇手段,7,,5,1,6,ㄅㄨˋ ㄗㄜˊ ㄕㄡˇ ㄉㄨㄢˋ,bù zé shǒu duàn
9737,不支,7,,2,0,2,ㄅㄨˋ ㄓ,bù zhī
9738,不知所云,7,,3,1,4,ㄅㄨˋ ㄓ ㄙㄨㄛˇ ㄩㄣˊ,bù zhī suǒ yún
9739,不住,7,,5,1,6,ㄅㄨˊ ㄓㄨˋ,bú zhù
9740,補足,7,,4,7,11,ㄅㄨˇ ㄗㄨˊ,bǔ zú
9741,不足為奇,7,,4,1,5,ㄅㄨˋ ㄗㄨˊ ㄨㄟˊ ㄑㄧˊ,bù zú wéi qí
9742,猜忌,7,,5,4,9,ㄘㄞ ㄐㄧˋ,cāi jì
9743,裁減,7,,2,2,4,ㄘㄞˊ ㄐㄧㄢˇ,cái jiǎn
9744,裁決,7,,6,2,8,ㄘㄞˊ ㄐㄩㄝˊ,cái jué
9745,才貌雙全,7,,1,0,1,ㄘㄞˊ ㄇㄠˋ ㄕㄨㄤ ㄑㄩㄢˊ,cái mào shuāng quán
9746,菜鳥,7,,4,1,5,ㄘㄞˋ ㄋㄧㄠˇ,cài niǎo
9747,才氣,7,,3,2,5,ㄘㄞˊ ㄑㄧˋ,cái qì
9748,採收,7,,5,75,80,ㄘㄞˇ ㄕㄡ,cǎi shōu
9749,採行,7,,6,1,7,ㄘㄞˇ ㄒㄧㄥˊ,cǎi xíng
9750,才學,7,,3,2,5,ㄘㄞˊ ㄒㄩㄝˊ,cái xué
9751,菜餚,7,,4,5,9,ㄘㄞˋ ㄧㄠˊ,cài yáo
9752,猜疑,7,,6,2,8,ㄘㄞ ㄧˊ,cāi yí
9753,裁員,7,,5,7,12,ㄘㄞˊ ㄩㄢˊ,cái yuán
9754,財源,7,,3,1,4,ㄘㄞˊ ㄩㄢˊ,cái yuán
9755,才子,7,,5,1,6,ㄘㄞˊ ㄗˇ,cái zǐ
9756,參,7,,5,2,7,ㄘㄢ,cān
9757,慘白,7,,4,0,4,ㄘㄢˇ ㄅㄞˊ,cǎn bái
9758,參拜,7,,5,7,12,ㄘㄢ ㄅㄞˋ,cān bài
9759,慘不忍睹,7,,3,2,5,ㄘㄢˇ ㄅㄨˋ ㄖㄣˇ ㄉㄨˇ,cǎn bù rěn dǔ
9760,殘存,7,,4,5,9,ㄘㄢˊ ㄘㄨㄣˊ,cán cún
9761,參訪,7,,4,12,16,ㄘㄢ ㄈㄤˇ,cān fǎng
9762,殘廢,7,,5,1,6,ㄘㄢˊ ㄈㄟˋ,cán fèi
9763,殘骸,7,,4,4,8,ㄘㄢˊ ㄏㄞˊ,cán hái
9764,殘害,7,,4,3,7,ㄘㄢˊ ㄏㄞˋ,cán hài
9765,殘局,7,,3,1,4,ㄘㄢˊ ㄐㄩˊ,cán jú
9766,慘劇,7,,4,3,7,ㄘㄢˇ ㄐㄩˋ,cǎn jù
9767,參考書,7,,3,2,5,ㄘㄢ ㄎㄠˇ ㄕㄨ,cān kǎo shū
9768,慘烈,7,,6,2,8,ㄘㄢˇ ㄌㄧㄝˋ,cǎn liè
9769,殘缺,7,,5,6,11,ㄘㄢˊ ㄑㄩㄝ,cán quē
9770,殘殺,7,,3,1,4,ㄘㄢˊ ㄕㄚ,cán shā
9771,慘死,7,,4,0,4,ㄘㄢˇ ㄙˇ,cǎn sǐ
9772,參天,7,,3,0,3,ㄘㄢ ㄊㄧㄢ,cān tiān
9773,殘餘,7,,7,4,11,ㄘㄢˊ ㄩˊ,cán yú
9774,慘狀,7,,2,1,3,ㄘㄢˇ ㄓㄨㄤˋ,cǎn zhuàng
9775,倉皇,7,,6,1,7,ㄘㄤ ㄏㄨㄤˊ,cāng huáng
9776,蒼老,7,,3,1,4,ㄘㄤ ㄌㄠˇ,cāng lǎo
9777,蒼茫,7,,2,1,3,ㄘㄤ ㄇㄤˊ,cāng máng
9778,藏匿,7,,4,2,6,ㄘㄤˊ ㄋㄧˋ,cáng nì
9779,滄桑,7,,4,5,9,ㄘㄤ ㄙㄤ,cāng sāng
9780,藏身,7,,6,1,7,ㄘㄤˊ ㄕㄣ,cáng shēn
9781,蒼天,7,,4,1,5,ㄘㄤ ㄊㄧㄢ,cāng tiān
9782,槽,7,,3,10,13,ㄘㄠˊ,cáo
9783,草創,7,,3,3,6,ㄘㄠˇ ㄔㄨㄤˋ,cǎo chuàng
9784,操勞,7,,3,0,3,ㄘㄠ ㄌㄠˊ,cāo láo
9785,草擬,7,,4,2,6,ㄘㄠˇ ㄋㄧˇ,cǎo nǐ
9786,草皮,7,,3,7,10,ㄘㄠˇ ㄆㄧˊ,cǎo pí
9787,操守,7,,4,1,5,ㄘㄠ ㄕㄡˇ,cāo shǒu
9788,草率,7,,4,1,5,ㄘㄠˇ ㄕㄨㄞˋ,cǎo shuài
9789,嘈雜,7,,6,1,7,ㄘㄠˊ ㄗㄚˊ,cáo zá
9790,策動,7,,3,2,5,ㄘㄜˋ ㄉㄨㄥˋ,cè dòng
9791,側門,7,,3,1,4,ㄘㄜˋ ㄇㄣˊ,cè mén
9792,側目,7,,3,1,4,ㄘㄜˋ ㄇㄨˋ,cè mù
9793,側身,7,,3,1,4,ㄘㄜˋ ㄕㄣ,cè shēn
9794,參差不齊,7,,2,1,3,ㄘㄣ ㄘ ㄅㄨˋ ㄑㄧˊ,cēn cī bù qí
9795,層出不窮,7,,6,4,10,ㄘㄥˊ ㄔㄨ ㄅㄨˋ ㄑㄩㄥˊ,céng chū bù qióng
9796,曾幾何時,7,,2,3,5,ㄘㄥˊ ㄐㄧˇ ㄏㄜˊ ㄕˊ,céng jǐ hé shí
9797,插話,7,,4,1,5,ㄔㄚ ㄏㄨㄚˋ,chā huà
9798,茶几,7,,4,2,6,ㄔㄚˊ ㄐㄧ,chá jī
9799,剎那,7,,4,5,9,ㄔㄚˋ ㄋㄚˋ,chà nà
9800,察言觀色,7,,2,1,3,ㄔㄚˊ ㄧㄢˊ ㄍㄨㄢ ㄙㄜˋ,chá yán guān sè
9801,查閱,7,,4,1,5,ㄔㄚˊ ㄩㄝˋ,chá yuè
9802,查證,7,,4,2,6,ㄔㄚˊ ㄓㄥˋ,chá zhèng
9803,拆穿,7,,2,1,3,ㄔㄞ ㄔㄨㄢ,chāi chuān
9804,柴火,7,,5,5,10,ㄔㄞˊ ㄏㄨㄛˇ,chái huǒ
9805,拆解,7,,3,4,7,ㄔㄞ ㄐㄧㄝˇ,chāi jiě
9806,差遣,7,,3,1,4,ㄔㄞ ㄑㄧㄢˇ,chāi qiǎn
9807,拆散,7,,3,0,3,ㄔㄞ ㄙㄢˋ,chāi sàn
9808,饞,7,,3,1,4,ㄔㄢˊ,chán
9809,摻,7,,4,3,7,ㄔㄢ,chān
9810,潺潺,7,,3,4,7,ㄔㄢˊ ㄔㄢˊ,chán chán
9811,剷除,7,,5,2,7,ㄔㄢˇ ㄔㄨˊ,chǎn chú
9812,纏鬥,7,,3,1,4,ㄔㄢˊ ㄉㄡˋ,chán dòu
9813,攙扶,7,,3,1,4,ㄔㄢ ㄈㄨˊ,chān fú
9814,諂媚,7,,4,1,5,ㄔㄢˇ ㄇㄟˋ,chǎn mèi
9815,纏綿,7,,3,0,3,ㄔㄢˊ ㄇㄧㄢˊ,chán mián
9816,闡明,7,,5,1,6,ㄔㄢˇ ㄇㄧㄥˊ,chǎn míng
9817,纏繞,7,,5,2,7,ㄔㄢˊ ㄖㄠˋ,chán rào
9818,纏身,7,,4,4,8,ㄔㄢˊ ㄕㄣ,chán shēn
9819,禪師,7,,17,2,19,ㄔㄢˊ ㄕ,chán shī
9820,闡釋,7,,6,1,7,ㄔㄢˇ ㄕˋ,chǎn shì
9821,摻雜,7,,4,1,5,ㄔㄢ ㄗㄚˊ,chān zá
9822,鏟子,7,,4,3,7,ㄔㄢˇ ˙ㄗ,chǎn zi
9823,禪宗,7,,8,0,8,ㄔㄢˊ ㄗㄨㄥ,chán zōng
9824,長程,7,,3,2,5,ㄔㄤˊ ㄔㄥˊ,cháng chéng
9825,長存,7,,2,0,2,ㄔㄤˊ ㄘㄨㄣˊ,cháng cún
9826,倡導,7,,7,5,12,ㄔㄤˋ ㄉㄠˇ,chàng dǎo
9827,償還,7,,5,5,10,ㄔㄤˊ ㄏㄨㄢˊ,cháng huán
9828,猖獗,7,,3,4,7,ㄔㄤ ㄐㄩㄝˊ,chāng jué
9829,暢快,7,,3,2,5,ㄔㄤˋ ㄎㄨㄞˋ,chàng kuài
9830,長廊,7,,4,1,5,ㄔㄤˊ ㄌㄤˊ,cháng láng
9831,常理,7,,6,1,7,ㄔㄤˊ ㄌㄧˇ,cháng lǐ
9832,長眠,7,,3,2,5,ㄔㄤˊ ㄇㄧㄢˊ,cháng mián
9833,常年,7,,3,3,6,ㄔㄤˊ ㄋㄧㄢˊ,cháng nián
9834,長篇大論,7,,3,1,4,ㄔㄤˊ ㄆㄧㄢ ㄉㄚˋ ㄌㄨㄣˋ,cháng piān dà lùn
9835,常情,7,,4,1,5,ㄔㄤˊ ㄑㄧㄥˊ,cháng qíng
9836,悵然,7,,2,1,3,ㄔㄤˋ ㄖㄢˊ,chàng rán
9837,長生不老,7,,4,3,7,ㄔㄤˊ ㄕㄥ ㄅㄨˋ ㄌㄠˇ,cháng shēng bù lǎo
9838,長談,7,,3,1,4,ㄔㄤˊ ㄊㄢˊ,cháng tán
9839,暢談,7,,3,1,4,ㄔㄤˋ ㄊㄢˊ,chàng tán
9840,長途跋涉,7,,4,4,8,ㄔㄤˊ ㄊㄨˊ ㄅㄚˊ ㄕㄜˋ,cháng tú bá shè
9841,長矛,7,,4,0,4,ㄔㄤˊㄇㄠˊ,chángmáo
9842,長於,7,,3,0,3,ㄔㄤˊㄩˊ,chángyú
9843,朝拜,7,,3,1,4,ㄔㄠˊ ㄅㄞˋ,cháo bài
9844,超凡,7,,3,1,4,ㄔㄠ ㄈㄢˊ,chāo fán
9845,抄錄,7,,2,1,3,ㄔㄠ ㄌㄨˋ,chāo lù
9846,超群,7,,3,1,4,ㄔㄠ ㄑㄩㄣˊ,chāo qún
9847,超然,7,,5,0,5,ㄔㄠ ㄖㄢˊ,chāo rán
9848,朝聖,7,,4,22,26,ㄔㄠˊ ㄕㄥˋ,cháo shèng
9849,朝廷,7,,85,4,89,ㄔㄠˊ ㄊㄧㄥˊ,cháo tíng
9850,超脫,7,,4,2,6,ㄔㄠ ㄊㄨㄛ,chāo tuō
9851,抄襲,7,,4,3,7,ㄔㄠ ㄒㄧˊ,chāo xí
9852,巢穴,7,,3,1,4,ㄔㄠˊ ㄒㄩㄝˋ,cháo xuè
9853,朝政,7,,9,0,9,ㄔㄠˊ ㄓㄥˋ,cháo zhèng
9854,撤回,7,,3,1,4,ㄔㄜˋ ㄏㄨㄟˊ,chè huí
9855,扯上,7,,4,1,5,ㄔㄜˇㄕㄤˋ,chě shàng
9856,徹頭徹尾,7,,4,1,5,ㄔㄜˋ ㄊㄡˊ ㄔㄜˋ ㄨㄟˇ,chè tóu chè wěi
9857,塵埃,7,,6,1,7,ㄔㄣˊ ㄞ,chén āi
9858,沉澱,7,,6,18,24,ㄔㄣˊ ㄉㄧㄢˋ,chén diàn
9859,沉甸甸,7,,3,1,4,ㄔㄣˊ ㄉㄧㄢˋ ㄉㄧㄢˋ,chén diàn diàn
9860,塵封,7,,2,1,3,ㄔㄣˊ ㄈㄥ,chén fēng
9861,臣服,7,,6,2,8,ㄔㄣˊ ㄈㄨˊ,chén fú
9862,沉寂,7,,5,4,9,ㄔㄣˊ ㄐㄧˊ,chén jí
9863,晨間,7,,2,1,3,ㄔㄣˊ ㄐㄧㄢ,chén jiān
9864,沉靜,7,,6,2,8,ㄔㄣˊ ㄐㄧㄥˋ,chén jìng
9865,陳舊,7,,4,1,5,ㄔㄣˊ ㄐㄧㄡˋ,chén jiù
9866,沉淪,7,,4,2,6,ㄔㄣˊ ㄌㄨㄣˊ,chén lún
9867,沉悶,7,,6,1,7,ㄔㄣˊ ㄇㄣˋ,chén mèn
9868,沉沒,7,,4,2,6,ㄔㄣˊ ㄇㄛˋ,chén mò
9869,沉溺,7,,4,1,5,ㄔㄣˊ ㄋㄧˋ,chén nì
9870,陳年,7,,3,3,6,ㄔㄣˊ ㄋㄧㄢˊ,chén nián
9871,陳設,7,,4,2,6,ㄔㄣˊ ㄕㄜˋ ,chén shè 
9872,塵世,7,,4,1,5,ㄔㄣˊ ㄕˋ,chén shì
9873,趁勢,7,,3,1,4,ㄔㄣˋ ㄕˋ,chèn shì
9874,沉痛,7,,4,2,6,ㄔㄣˊ ㄊㄨㄥˋ,chén tòng
9875,襯托,7,,3,2,5,ㄔㄣˋ ㄊㄨㄛ,chèn tuō
9876,沉穩,7,,6,5,11,ㄔㄣˊ ㄨㄣˇ,chén wěn
9877,晨曦,7,,3,3,6,ㄔㄣˊ ㄒㄧ,chén xī
9878,沉吟,7,,4,0,4,ㄔㄣˊ ㄧㄣˊ,chén yín
9879,沉著,7,,7,2,9,ㄔㄣˊ ㄓㄨㄛˊ,chén zhuó
9880,臣子,7,,8,1,9,ㄔㄣˊ ㄗˇ,chén zǐ
9881,沉醉,7,,5,1,6,ㄔㄣˊ ㄗㄨㄟˋ,chén zuì
9882,秤/稱2,7,,192,87,279,ㄔㄥˋ,chèng
9883,逞,7,,4,3,7,ㄔㄥˇ,chěng
9884,稱霸,7,,5,1,6,ㄔㄥ ㄅㄚˋ,chēng bà
9885,承辦,7,,3,1,4,ㄔㄥˊ ㄅㄢˋ,chéng bàn
9886,呈報,7,,3,1,4,ㄔㄥˊ ㄅㄠˋ,chéng bào
9887,乘車,7,,3,1,4,ㄔㄥˊ ㄔㄜ,chéng chē
9888,城池,7,,9,3,12,ㄔㄥˊ ㄔˊ,chéng chí
9889,懲處,7,,4,1,5,ㄔㄥˊ ㄔㄨˇ,chéng chǔ
9890,稱道,7,,4,1,5,ㄔㄥ ㄉㄠˋ,chēng dào
9891,稱號,7,,7,8,15,ㄔㄥ ㄏㄠˋ,chēng hào
9892,成婚,7,,4,0,4,ㄔㄥˊ ㄏㄨㄣ,chéng hūn
9893,承繼,7,,4,2,6,ㄔㄥˊ ㄐㄧˋ,chéng jì
9894,承接,7,,3,8,11,ㄔㄥˊ ㄐㄧㄝ,chéng jiē
9895,乘涼,7,,3,4,7,ㄔㄥˊ ㄌㄧㄤˊ,chéng liáng
9896,承蒙,7,,2,1,3,ㄔㄥˊ ㄇㄥˊ,chéng méng
9897,瞠目結舌,7,,3,1,4,ㄔㄥ ㄇㄨˋ ㄐㄧㄝˊ ㄕㄜˊ,chēng mù jié shé
9898,稱奇,7,,2,0,2,ㄔㄥ ㄑㄧˊ,chēng qí
9899,逞強,7,,3,1,4,ㄔㄥˇ ㄑㄧㄤˊ,chěng qiáng
9900,成群結隊,7,,3,2,5,ㄔㄥˊ ㄑㄩㄣˊ ㄐㄧㄝˊ ㄉㄨㄟˋ,chéng qún jié duì
9901,乘勢,7,,3,0,3,ㄔㄥˊ ㄕˋ,chéng shì
9902,成事,7,,3,0,3,ㄔㄥˊ ㄕˋ,chéng shì
9903,稱頌,7,,3,1,4,ㄔㄥ ㄙㄨㄥˋ,chēng sòng
9904,稱謂,7,,4,0,4,ㄔㄥ ㄨㄟˋ,chēng wèi
9905,成文,7,,2,1,3,ㄔㄥˊ ㄨㄣˊ,chéng wén
9906,稱心,7,,3,1,4,ㄔㄥˋ ㄒㄧㄣ,chèng xīn 
9907,誠心誠意,7,,2,0,2,ㄔㄥˊ ㄒㄧㄣ ㄔㄥˊ ㄧˋ,chéng xīn chéng yì
9908,成行,7,,3,1,4,ㄔㄥˊ ㄒㄧㄥˊ,chéng xíng
9909,成性,7,,2,0,2,ㄔㄥˊ ㄒㄧㄥˋ,chéng xìng
9910,稱許,7,,2,0,2,ㄔㄥ ㄒㄩˇ,chēng xǔ
9911,撐腰,7,,2,4,6,ㄔㄥ ㄧㄠ,chēng yāo
9912,承載,7,,4,8,12,ㄔㄥˊ ㄗㄞˋ,chéng zài
9913,懲治,7,,4,1,5,ㄔㄥˊ ㄓˋ,chéng zhì
9914,稱職,7,,6,2,8,ㄔㄥˋ ㄓˊ,chèng zhí
9915,馳騁,7,,4,1,5,ㄔˊ ㄔㄥˇ,chí chěng
9916,吃喝玩樂,7,,2,2,4,ㄔ ㄏㄜ ㄨㄢˊ ㄌㄜˋ,chī hē wán lè
9917,持家,7,,3,3,6,ㄔˊ ㄐㄧㄚ,chí jiā
9918,吃緊,7,,2,3,5,ㄔ ㄐㄧㄣˇ,chī jǐn
9919,赤裸,7,,5,0,5,ㄔˋ ㄌㄨㄛˇ,chì luǒ
9920,持平,7,,4,1,5,ㄔˊ ㄆㄧㄥˊ,chí píng
9921,熾熱,7,,4,2,6,ㄔˋ ㄖㄜˋ,chì rè
9922,恥辱,7,,6,1,7,ㄔˇ ㄖㄨˋ,chǐ rù
9923,赤手空拳,7,,2,1,3,ㄔˋ ㄕㄡˇ ㄎㄨㄥ ㄑㄩㄢˊ,chì shǒu kōng quán
9924,吃香,7,,2,2,4,ㄔ ㄒㄧㄤ,chī xiāng
9925,恥笑,7,,2,1,3,ㄔˇ ㄒㄧㄠˋ,chǐ xiào
9926,嗤之以鼻,7,,5,1,6,ㄔ ㄓ ㄧˇ ㄅㄧˊ,chī zhī yǐ bí
9927,持之以恆,7,,3,2,5,ㄔˊ ㄓ ㄧˇ ㄏㄥˊ,chí zhī yǐ héng
9928,沖淡,7,,3,1,4,ㄔㄨㄥ ㄉㄢˋ,chōng dàn
9929,寵兒,7,,2,1,3,ㄔㄨㄥˇ ㄦˊ,chǒng ér
9930,充耳不聞,7,,2,0,2,ㄔㄨㄥ ㄦˇ ㄅㄨˋ ㄨㄣˊ,chōng ěr bù wén
9931,重估,7,,3,0,3,ㄔㄨㄥˊ ㄍㄨ,chóng gū
9932,充飢,7,,4,1,5,ㄔㄨㄥ ㄐㄧ,chōng jī
9933,崇敬,7,,6,2,8,ㄔㄨㄥˊ ㄐㄧㄥˋ,chóng jìng
9934,衝勁,7,,3,3,6,ㄔㄨㄥ ㄐㄧㄥˋ,chōng jìng
9935,憧憬,7,,7,6,13,ㄔㄨㄥ ㄐㄧㄥˇ,chōng jǐng
9936,重來,7,,4,3,7,ㄔㄨㄥˊ ㄌㄞˊ,chóng lái
9937,充其量,7,,5,1,6,ㄔㄨㄥ ㄑㄧˊ ㄌㄧㄤˋ,chōng qí liàng
9938,重申,7,,5,9,14,ㄔㄨㄥˊ ㄕㄣ,chóng shēn
9939,重塑,7,,3,4,7,ㄔㄨㄥˊㄙㄨˋ,chóng sù
9940,重圍,7,,4,1,5,ㄔㄨㄥˊ ㄨㄟˊ,chóng wéi
9941,重溫,7,,4,3,7,ㄔㄨㄥˊ ㄨㄣ,chóng wēn
9942,寵信,7,,4,0,4,ㄔㄨㄥˇ ㄒㄧㄣˋ,chǒng xìn
9943,重振,7,,4,4,8,ㄔㄨㄥˊ ㄓㄣˋ,chóng zhèn
9944,衝撞,7,,5,2,7,ㄔㄨㄥ ㄓㄨㄤˋ,chōng zhuàng
9945,稠,7,,2,4,6,ㄔㄡˊ,chóu
9946,瞅,7,,4,0,4,ㄔㄡˇ,chǒu
9947,籌辦,7,,3,1,4,ㄔㄡˊ ㄅㄢˋ,chóu bàn
9948,惆悵,7,,3,0,3,ㄔㄡˊ ㄔㄤˋ,chóu chàng
9949,躊躇,7,,6,1,7,ㄔㄡˊ ㄔㄨˊ,chóu chú
9950,籌措,7,,4,3,7,ㄔㄡˊ ㄘㄨㄛˋ,chóu cuò
9951,仇敵,7,,4,0,4,ㄔㄡˊ ㄉㄧˊ,chóu dí
9952,抽動,7,,3,0,3,ㄔㄡ ㄉㄨㄥˋ,chōu dòng
9953,綢緞,7,,5,1,6,ㄔㄡˊ ㄉㄨㄢˋ,chóu duàn
9954,抽筋,7,,4,2,6,ㄔㄡ ㄐㄧㄣ,chōu jīn
9955,愁苦,7,,3,1,4,ㄔㄡˊ ㄎㄨˇ,chóu kǔ
9956,酬勞,7,,4,2,6,ㄔㄡˊ ㄌㄠˊ,chóu láo
9957,愁眉苦臉,7,,4,3,7,ㄔㄡˊ ㄇㄟˊ ㄎㄨˇ ㄌㄧㄢˇ,chóu méi kǔ liǎn
9958,稠密,7,,2,5,7,ㄔㄡˊ ㄇㄧˋ,chóu mì
9959,臭氣,7,,3,2,5,ㄔㄡˋ ㄑㄧˋ,chòu qì
9960,籌錢,7,,2,1,3,ㄔㄡˊ ㄑㄧㄢˊ,chóu qián
9961,抽籤,7,,4,3,7,ㄔㄡ ㄑㄧㄢ,chōu qiān
9962,抽取,7,,4,6,10,ㄔㄡ ㄑㄩˇ,chōu qǔ
9963,愁容,7,,3,1,4,ㄔㄡˊ ㄖㄨㄥˊ,chóu róng
9964,抽身,7,,2,1,3,ㄔㄡ ㄕㄣ,chōu shēn
9965,仇視,7,,3,1,4,ㄔㄡˊ ㄕˋ,chóu shì
9966,抽絲剝繭,7,,2,1,3,ㄔㄡ ㄙ ㄅㄛ ㄐㄧㄢˇ,chōu sī bō jiǎn
9967,出醜,7,,2,0,2,ㄔㄨ ㄔㄡˇ,chū chǒu
9968,出道,7,,2,1,3,ㄔㄨ ㄉㄠˋ,chū dào
9969,觸犯,7,,5,1,6,ㄔㄨˋ ㄈㄢˋ,chù fàn
9970,出關,7,,2,2,4,ㄔㄨ ㄍㄨㄢ,chū guān
9971,出汗,7,,4,1,5,ㄔㄨ ㄏㄢˋ,chū hàn
9972,出類拔萃,7,,3,1,4,ㄔㄨ ㄌㄟˋ ㄅㄚˊ ㄘㄨㄟˋ,chū lèi bá cuì
9973,矗立,7,,6,6,12,ㄔㄨˋ ㄌㄧˋ,chù lì
9974,出籠,7,,4,1,5,ㄔㄨ ㄌㄨㄥˊ,chū lóng
9975,出沒,7,,6,3,9,ㄔㄨ ㄇㄛˋ,chū mò
9976,處女,7,,7,1,8,ㄔㄨˇ ㄋㄩˇ,chǔ nǚ
9977,出氣,7,,4,1,5,ㄔㄨ ㄑㄧˋ,chū qì
9978,出其不意,7,,4,1,5,ㄔㄨ ㄑㄧˊ ㄅㄨˋ ㄧˋ,chū qí bù yì
9979,出人意表,7,,3,0,3,ㄔㄨ ㄖㄣˊ ㄧˋ ㄅㄧㄠˇ,chū rén yì biǎo
9980,出神,7,,5,0,5,ㄔㄨ ㄕㄣˊ,chū shén
9981,畜生,7,,3,1,4,ㄔㄨˋ ㄕㄥ,chù shēng
9982,出示,7,,3,1,4,ㄔㄨ ㄕˋ,chū shì
9983,出使,7,,5,2,7,ㄔㄨ ㄕˇ,chū shǐ
9984,出師,7,,4,1,5,ㄔㄨ ㄕ,chū shī
9985,處所,7,,3,1,4,ㄔㄨˋ ㄙㄨㄛˇ,chù suǒ
9986,出庭,7,,3,0,3,ㄔㄨ ㄊㄧㄥˊ,chū tíng
9987,鋤頭,7,,7,12,19,ㄔㄨˊ ˙ㄊㄡ,chú tou
9988,出土,7,,6,9,15,ㄔㄨ ㄊㄨˇ,chū tǔ
9989,出息,7,,2,0,2,ㄔㄨ ˙ㄒㄧ,chū xi
9990,處心積慮,7,,3,1,4,ㄔㄨˇ ㄒㄧㄣ ㄐㄧ ㄌㄩˋ,chǔ xīn jī lǜ
9991,儲蓄,7,,5,3,8,ㄔㄨˊ ㄒㄩˋ,chú xù
9992,出戰,7,,4,0,4,ㄔㄨ ㄓㄢˋ,chū zhàn
9993,初衷,7,,6,5,11,ㄔㄨ ㄓㄨㄥ,chū zhōng
9994,踹,7,,3,1,4,ㄔㄨㄞˋ ,chuài
9995,揣測,7,,5,2,7,ㄔㄨㄞˇ ㄘㄜˋ,chuǎi cè
9996,揣摩,7,,5,4,9,ㄔㄨㄞˇ ㄇㄛˊ,chuǎi mó
9997,船艙,7,,3,1,4,ㄔㄨㄢˊ ㄘㄤ,chuán cāng
9998,穿插,7,,4,2,6,ㄔㄨㄢ ㄔㄚ,chuān chā
9999,傳喚,7,,3,1,4,ㄔㄨㄢˊ ㄏㄨㄢˋ,chuán huàn
10000,串連,7,,4,10,14,ㄔㄨㄢˋ ㄌㄧㄢˊ,chuàn lián
10001,傳令,7,,4,1,5,ㄔㄨㄢˊ ㄌㄧㄥˋ,chuán lìng
10002,川流不息,7,,2,3,5,ㄔㄨㄢ ㄌㄧㄡˊ ㄅㄨˋ ㄒㄧˊ,chuān liú bù xí
10003,傳人,7,,3,5,8,ㄔㄨㄢˊ ㄖㄣˊ,chuán rén
10004,傳神,7,,4,2,6,ㄔㄨㄢˊ ㄕㄣˊ,chuán shén
10005,傳世,7,,3,2,5,ㄔㄨㄢˊ ㄕˋ,chuán shì
10006,傳輸,7,,6,3,9,ㄔㄨㄢˊ ㄕㄨ,chuán shū
10007,穿梭,7,,12,21,33,ㄔㄨㄢ ㄙㄨㄛ,chuān suō
10008,傳宗接代,7,,3,3,6,ㄔㄨㄢˊ ㄗㄨㄥ ㄐㄧㄝ ㄉㄞˋ,chuán zōng jiē dài
10009,幢,7,,18,1,19,ㄔㄨㄤˊ,chuáng
10010,創見,7,,3,1,4,ㄔㄨㄤˋ ㄐㄧㄢˋ,chuàng jiàn
10011,創舉,7,,3,5,8,ㄔㄨㄤˋ ㄐㄩˇ,chuàng jǔ
10012,床鋪/床舖,7,,5,5,10,ㄔㄨㄤˊ ㄆㄨˋ,chuáng pù
10013,創始,7,,4,2,6,ㄔㄨㄤˋ ㄕˇ,chuàng shǐ
10014,窗台,7,,3,2,5,ㄔㄨㄤ ㄊㄞˊ,chuāng tái
10015,搥,7,,2,2,4,ㄔㄨㄟˊ,chuí
10016,錘,7,,4,1,5,ㄔㄨㄟˊ,chuí
10017,垂掛,7,,2,1,3,ㄔㄨㄟˊ ㄍㄨㄚˋ,chuí guà
10018,吹灰之力,7,,3,1,4,ㄔㄨㄟ ㄏㄨㄟ ㄓ ㄌㄧˋ,chuī huī zhī lì
10019,吹口哨,7,,4,0,4,ㄔㄨㄟ ㄎㄡˇ ㄕㄠˋ,chuī kǒu shào
10020,吹毛求疵,7,,3,1,4,ㄔㄨㄟ ㄇㄠˊ ㄑㄧㄡˊ ㄘ,chuī máo qiú cī
10021,吹捧,7,,3,1,4,ㄔㄨㄟ ㄆㄥˇ,chuī pěng
10022,垂死,7,,4,3,7,ㄔㄨㄟˊ ㄙˇ,chuí sǐ
10023,垂頭喪氣,7,,6,2,8,ㄔㄨㄟˊ ㄊㄡˊ ㄙㄤˋ ㄑㄧˋ,chuí tóu sàng qì
10024,垂涎,7,,3,1,4,ㄔㄨㄟˊ ㄒㄧㄢˊ,chuí xián
10025,吹噓,7,,6,1,7,ㄔㄨㄟ ㄒㄩ,chuī xū
10026,吹奏,7,,3,1,4,ㄔㄨㄟ ㄗㄡˋ,chuī zòu
10027,蠢蠢欲動,7,,2,3,5,ㄔㄨㄣˇ ㄔㄨㄣˇ ㄩˋ ㄉㄨㄥˋ,chǔn chǔn yù dòng
10028,純樸,7,,5,10,15,ㄔㄨㄣˊ ㄆㄨˊ,chún pú
10029,純然,7,,3,1,4,ㄔㄨㄣˊ ㄖㄢˊ,chún rán
10030,唇舌,7,,2,0,2,ㄔㄨㄣˊ ㄕㄜˊ,chún shé
10031,純熟,7,,3,1,4,ㄔㄨㄣˊ ㄕㄨˊ,chún shú
10032,純正,7,,4,1,5,ㄔㄨㄣˊ ㄓㄥˋ,chún zhèng
10033,啜,7,,4,0,4,ㄔㄨㄛˋ,chuò
10034,綽綽有餘,7,,3,1,4,ㄔㄨㄛˋ ㄔㄨㄛˋ ㄧㄡˇ ㄩˊ,chuò chuò yǒu yú
10035,戳破,7,,2,1,3,ㄔㄨㄛ ㄆㄛˋ,chuō pò
10036,啜泣,7,,6,1,7,ㄔㄨㄛˋ ㄑㄧˋ,chuò qì
10037,輟學,7,,4,7,11,ㄔㄨㄛˋ ㄒㄩㄝˊ,chuò xué
10038,辭別,7,,4,1,5,ㄘˊ ㄅㄧㄝˊ,cí bié
10039,刺穿,7,,3,1,4,ㄘˋ ㄔㄨㄢ,cì chuān
10040,次等,7,,2,1,3,ㄘˋ ㄉㄥˇ,cì děng
10041,詞典/辭典,7,,5,2,7,ㄘˊ ㄉㄧㄢˇ/ㄘˊ ㄉㄧㄢˇ,cí diǎn/cí diǎn
10042,刺骨,7,,4,3,7,ㄘˋ ㄍㄨˇ,cì gǔ
10043,辭彙,7,,4,0,4,ㄘˊ ㄏㄨㄟˋ,cí huì
10044,詞句,7,,4,2,6,ㄘˊ ㄐㄩˋ,cí jù
10045,慈母,7,,3,3,6,ㄘˊ ㄇㄨˇ,cí mǔ
10046,此起彼落,7,,4,2,6,ㄘˇ ㄑㄧˇ ㄅㄧˇ ㄌㄨㄛˋ,cǐ qǐ bǐ luò
10047,刺殺,7,,7,2,9,ㄘˋ ㄕㄚ,cì shā
10048,辭世,7,,3,1,4,ㄘˊ ㄕˋ,cí shì
10049,刺探,7,,2,0,2,ㄘˋ ㄊㄢˋ,cì tàn
10050,慈祥,7,,5,4,9,ㄘˊ ㄒㄧㄤˊ,cí xiáng
10051,刺繡,7,,4,8,12,ㄘˋ ㄒㄧㄡˋ,cì xiù
10052,刺眼,7,,4,2,6,ㄘˋ ㄧㄢˇ,cì yǎn
10053,詞語,7,,4,1,5,ㄘˊ ㄩˇ,cí yǔ
10054,匆匆,7,,24,4,28,ㄘㄨㄥ ㄘㄨㄥ,cōng cōng
10055,匆促,7,,2,1,3,ㄘㄨㄥ ㄘㄨˋ,cōng cù
10056,聰慧,7,,7,1,8,ㄘㄨㄥ ㄏㄨㄟˋ,cōng huì
10057,從軍,7,,5,2,7,ㄘㄨㄥˊ ㄐㄩㄣ,cóng jūn
10058,從容不迫,7,,3,0,3,ㄘㄨㄥ ㄖㄨㄥˊ ㄅㄨˋ ㄆㄛˋ,cōng róng bù pò
10059,叢生,7,,4,2,6,ㄘㄨㄥˊ ㄕㄥ,cóng shēng
10060,從天而降,7,,3,1,4,ㄘㄨㄥˊ ㄊㄧㄢ ㄦˊ ㄐㄧㄤˋ,cóng tiān ér jiàng
10061,從業,7,,3,4,7,ㄘㄨㄥˊ ㄧㄝˋ,cóng yè 
10062,聰穎,7,,3,0,3,ㄘㄨㄥ ㄧㄥˇ,cōng yǐng
10063,從政,7,,3,1,4,ㄘㄨㄥˊ ㄓㄥˋ,cóng zhèng
10064,湊近,7,,3,0,3,ㄘㄡˋ ㄐㄧㄣˋ,còu jìn
10065,湊熱鬧,7,,2,1,3,ㄘㄡˋ ㄖㄜˋ ㄋㄠˋ,còu rè nào
10066,蹙,7,,3,0,3,ㄘㄨˋ,cù
10067,粗獷,7,,3,2,5,ㄘㄨ ㄍㄨㄤˇ,cū guǎng
10068,粗略,7,,4,1,5,ㄘㄨ ㄌㄩㄝˋ,cū lüè
10069,粗聲粗氣,7,,1,0,1,ㄘㄨ ㄕㄥ ㄘㄨ ㄑㄧˋ,cū shēng cū qì
10070,粗俗,7,,4,1,5,ㄘㄨ ㄙㄨˊ,cū sú
10071,粗野,7,,3,1,4,ㄘㄨ ㄧㄝˇ,cū yě
10072,簇擁,7,,5,2,7,ㄘㄨˋ ㄩㄥˇ,cù yǒng
10073,粗壯,7,,4,1,5,ㄘㄨ ㄓㄨㄤˋ,cū zhuàng
10074,竄,7,,6,2,8,ㄘㄨㄢˋ,cuàn
10075,璀璨,7,,3,3,6,ㄘㄨㄟˇ ㄘㄢˋ,cuǐ càn
10076,摧殘,7,,5,5,10,ㄘㄨㄟ ㄘㄢˊ,cuī cán
10077,翠綠,7,,3,5,8,ㄘㄨㄟˋ ㄌㄩˋ,cuì lǜ
10078,存留,7,,4,1,5,ㄘㄨㄣˊ ㄌㄧㄡˊ,cún liú
10079,存亡,7,,5,2,7,ㄘㄨㄣˊ ㄨㄤˊ,cún wáng
10080,存疑,7,,4,1,5,ㄘㄨㄣˊ ㄧˊ,cún yí
10081,撮,7,,7,3,10,ㄘㄨㄛˋ,cuò
10082,措詞,7,,2,1,3,ㄘㄨㄛˋ ㄘˊ,cuò cí
10083,措辭,7,,4,2,6,ㄘㄨㄛˋ ㄘˊ,cuò cí
10084,錯愕,7,,3,3,6,ㄘㄨㄛˋ ㄜˋ,cuò è
10085,搓揉,7,,4,3,7,ㄘㄨㄛ ㄖㄡˊ,cuō róu
10086,磋商,7,,3,4,7,ㄘㄨㄛ ㄕㄤ,cuō shāng
10087,措手不及,7,,4,4,8,ㄘㄨㄛˋ ㄕㄡˇ ㄅㄨˋ ㄐㄧˊ,cuò shǒu bù jí
10088,錯綜複雜,7,,7,3,10,ㄘㄨㄛˋ ㄗㄨㄥˋ ㄈㄨˋ ㄗㄚˊ,cuò zòng fù zá
10089,大本營,7,,5,4,9,ㄉㄚˋ ㄅㄣˇ ㄧㄥˊ,dà běn yíng
10090,大臣,7,,116,8,124,ㄉㄚˋ ㄔㄣˊ,dà chén
10091,打點,7,,6,3,9,ㄉㄚˇ ˙ㄉㄧㄢ,dǎ dian
10092,大度,7,,3,1,4,ㄉㄚˋ ㄉㄨˋ,dà dù
10093,大發雷霆,7,,5,1,6,ㄉㄚˋ ㄈㄚ ㄌㄟˊ ㄊㄧㄥˊ,dà fā léi tíng
10094,大功告成,7,,4,6,10,ㄉㄚˋ ㄍㄨㄥ ㄍㄠˋ ㄔㄥˊ,dà gōng gào chéng
10095,打滾,7,,5,2,7,ㄉㄚˇ ㄍㄨㄣˇ,dǎ gǔn
10096,大亨,7,,5,1,6,ㄉㄚˋ ㄏㄥ,dà hēng
10097,大惑不解,7,,3,1,4,ㄉㄚˋ ㄏㄨㄛˋ ㄅㄨˋ ㄐㄧㄝˇ,dà huò bù jiě
10098,搭建,7,,4,8,12,ㄉㄚ ㄐㄧㄢˋ,dā jiàn
10099,打結,7,,3,3,6,ㄉㄚˇ ㄐㄧㄝˊ,dǎ jié
10100,大驚失色,7,,4,1,5,ㄉㄚˋ ㄐㄧㄥ ㄕ ㄙㄜˋ,dà jīng shī sè
10101,搭救,7,,4,1,5,ㄉㄚ ㄐㄧㄡˋ,dā jiù
10102,大可不必,7,,2,1,3,ㄉㄚˋ ㄎㄜˇ ㄅㄨˋ ㄅㄧˋ,dà kě bù bì
10103,打垮,7,,3,1,4,ㄉㄚˇ ㄎㄨㄚˇ,dǎ kuǎ
10104,大剌剌,7,,3,1,4,ㄉㄚˋ ㄌㄚˋ ㄌㄚˋ,dà là là
10105,大老,7,,4,1,5,ㄉㄚˋ ㄌㄠˇ,dà lǎo
10106,打雷,7,,3,13,16,ㄉㄚˇ ㄌㄟˊ,dǎ léi
10107,打理,7,,4,7,11,ㄉㄚˇ ㄌㄧˇ,dǎ lǐ
10108,大理石,7,,7,2,9,ㄉㄚˋ ㄌㄧˇ ㄕˊ,dà lǐ shí
10109,大麻,7,,5,2,7,ㄉㄚˋ ㄇㄚˊ,dà má
10110,大名鼎鼎,7,,3,1,4,ㄉㄚˋ ㄇㄧㄥˊ ㄉㄧㄥˇ ㄉㄧㄥˇ,dà míng dǐng dǐng
10111,大難,7,,4,2,6,ㄉㄚˋ ㄋㄢˋ,dà nàn
10112,大內,7,,3,1,4,ㄉㄚˋ ㄋㄟˋ,dà nèi
10113,打拚/打拼,7,,6,25,31,ㄉㄚˇ ㄆㄢˋ/ㄉㄚˇ ㄆㄧㄣ,dǎ pàn/dǎ pīn
10114,大器,7,,2,1,3,ㄉㄚˋ ㄑㄧˋ,dà qì
10115,打趣,7,,3,1,4,ㄉㄚˇ ㄑㄩˋ,dǎ qù
10116,大失所望,7,,4,1,5,ㄉㄚˋ ㄕ ㄙㄨㄛˇ ㄨㄤˋ,dà shī suǒ wàng
10117,大手筆,7,,2,1,3,ㄉㄚˋ ㄕㄡˇ ㄅㄧˇ,dà shǒu bǐ
10118,大肆,7,,12,7,19,ㄉㄚˋ ㄙˋ,dà sì
10119,打探,7,,5,1,6,ㄉㄚˇ ㄊㄢˋ,dǎ tàn
10120,大庭廣眾,7,,2,1,3,ㄉㄚˋ ㄊㄧㄥˊ ㄍㄨㄤˇ ㄓㄨㄥˋ,dà tíng guǎng zhòng
10121,大同,7,,8,2,10,ㄉㄚˋ ㄊㄨㄥˊ,dà tóng
10122,大屠殺,7,,6,4,10,ㄉㄚˋ ㄊㄨˊ ㄕㄚ,dà tú shā
10123,打退堂鼓,7,,2,1,3,ㄉㄚˇ ㄊㄨㄟˋ ㄊㄤˊ ㄍㄨˇ,dǎ tuì táng gǔ
10124,大相逕庭,7,,2,1,3,ㄉㄚˋ ㄒㄧㄤ ㄐㄧㄥˋ ㄊㄧㄥˊ,dà xiāng jìng tíng
10125,大興土木,7,,2,2,4,ㄉㄚˋ ㄒㄧㄥ ㄊㄨˇ ㄇㄨˋ,dà xīng tǔ mù
10126,打壓,7,,4,2,6,ㄉㄚˇ ㄧㄚ,dǎ yā
10127,大搖大擺,7,,3,1,4,ㄉㄚˋ ㄧㄠˊ ㄉㄚˋ ㄅㄞˇ,dà yáo dà bǎi
10128,大爺,7,,6,2,8,ㄉㄚˋ ㄧㄝˊ,dà yé
10129,大業,7,,11,8,19,ㄉㄚˋ ㄧㄝˋ,dà yè
10130,大義,7,,7,1,8,ㄉㄚˋ ㄧˋ,dà yì
10131,打住,7,,3,0,3,ㄉㄚˇ ㄓㄨˋ,dǎ zhù
10132,呆板,7,,3,1,4,ㄉㄞ ㄅㄢˇ,dāi bǎn
10133,怠惰,7,,3,1,4,ㄉㄞˋ ㄉㄨㄛˋ,dài duò
10134,帶過,7,,3,2,5,ㄉㄞˋ ㄍㄨㄛˋ,dài guò
10135,代勞,7,,3,3,6,ㄉㄞˋ ㄌㄠˊ,dài láo
10136,怠慢,7,,4,0,4,ㄉㄞˋ ㄇㄢˋ,dài màn
10137,待命,7,,4,4,8,ㄉㄞˋ ㄇㄧㄥˋ,dài mìng
10138,待人接物,7,,4,1,5,ㄉㄞˋ ㄖㄣˊ ㄐㄧㄝ ㄨˋ,dài rén jiē wù
10139,呆滯,7,,4,0,4,ㄉㄞ ㄓˋ,dāi zhì
10140,擔保,7,,6,2,8,ㄉㄢ ㄅㄠˇ,dān bǎo
10141,淡薄,7,,2,1,3,ㄉㄢˋ ㄅㄛˊ,dàn bó
10142,單薄,7,,4,1,5,ㄉㄢ ㄅㄛˊ,dān bó
10143,單車,7,,12,22,34,ㄉㄢ ㄔㄜ,dān chē
10144,擔負,7,,5,3,8,ㄉㄢ ㄈㄨˋ,dān fù
10145,單據,7,,2,1,3,ㄉㄢ ㄐㄩˋ,dān jù
10146,耽溺,7,,3,1,4,ㄉㄢ ㄋㄧˋ,dān nì
10147,淡然,7,,2,0,2,ㄉㄢˋ ㄖㄢˊ,dàn rán
10148,單身漢,7,,3,1,4,ㄉㄢ ㄕㄣ ㄏㄢˋ,dān shēn hàn
10149,膽識,7,,6,3,9,ㄉㄢˇ ㄕˋ,dǎn shì
10150,淡忘,7,,3,2,5,ㄉㄢˋ ㄨㄤˋ,dàn wàng
10151,旦夕,7,,4,1,5,ㄉㄢˋ ㄒㄧˋ,dàn xì
10152,單向,7,,4,2,6,ㄉㄢ ㄒㄧㄤˋ,dān xiàng
10153,膽小鬼,7,,3,2,5,ㄉㄢˇ ㄒㄧㄠˇ ㄍㄨㄟˇ,dǎn xiǎo guǐ
10154,彈藥,7,,4,2,6,ㄉㄢˋ ㄧㄠˋ,dàn yào
10155,膽戰心驚,7,,2,0,2,ㄉㄢˇ ㄓㄢˋ ㄒㄧㄣ ㄐㄧㄥ,dǎn zhàn xīn jīng
10156,當差,7,,3,0,3,ㄉㄤ ㄔㄞ,dāng chāi
10157,當紅,7,,3,1,4,ㄉㄤ ㄏㄨㄥˊ,dāng hóng
10158,當機立斷,7,,3,1,4,ㄉㄤ ㄐㄧ ㄌㄧˋ ㄉㄨㄢˋ,dāng jī lì duàn
10159,當權,7,,6,1,7,ㄉㄤ ㄑㄩㄢˊ,dāng quán
10160,蕩然無存,7,,3,2,5,ㄉㄤˋ ㄖㄢˊ ㄨˊ ㄘㄨㄣˊ,dàng rán wú cún
10161,當頭,7,,4,1,5,ㄉㄤ ㄊㄡˊ,dāng tóu
10162,當頭棒喝,7,,2,1,3,ㄉㄤ ㄊㄡˊ ㄅㄤˋ ㄏㄜˋ,dāng tóu bàng hè
10163,當務之急,7,,3,5,8,ㄉㄤ ㄨˋ ㄓ ㄐㄧˊ,dāng wù zhī jí
10164,搗,7,,6,2,8,ㄉㄠˇ,dǎo
10165,稻草,7,,5,13,18,ㄉㄠˋ ㄘㄠˇ,dào cǎo
10166,導讀,7,,6,0,6,ㄉㄠˇ ㄉㄨˊ,dǎo dú
10167,倒過來,7,,3,3,6,ㄉㄠˋ ㄍㄨㄛˋ ㄌㄞˊ,dào guò lái
10168,導航,7,,4,6,10,ㄉㄠˇ ㄏㄤˊ,dǎo háng
10169,道教,7,,8,2,10,ㄉㄠˋ ㄐㄧㄠˋ,dào jiào
10170,導覽,7,,4,12,16,ㄉㄠˇ ㄌㄢˇ,dǎo lǎn
10171,倒流,7,,3,1,4,ㄉㄠˋ ㄌㄧㄡˊ,dào liú
10172,搗亂,7,,3,2,5,ㄉㄠˇ ㄌㄨㄢˋ,dǎo luàn
10173,道貌岸然,7,,3,0,3,ㄉㄠˋ ㄇㄠˋ ㄢˋ ㄖㄢˊ,dào mào àn rán
10174,稻米,7,,8,45,53,ㄉㄠˋ ㄇㄧˇ,dào mǐ
10175,悼念,7,,3,2,5,ㄉㄠˋ ㄋㄧㄢˋ,dào niàn
10176,道義,7,,6,1,7,ㄉㄠˋ ㄧˋ,dào yì
10177,倒影,7,,3,1,4,ㄉㄠˋ ㄧㄥˇ,dào yǐng
10178,導遊,7,,4,4,8,ㄉㄠˇ ㄧㄡˊ,dǎo yóu
10179,盜賊,7,,6,2,8,ㄉㄠˋ ㄗㄟˊ,dào zéi
10180,倒轉,7,,2,1,3,ㄉㄠˋ ㄓㄨㄢˇ,dào zhuǎn
10181,得3,7,,2471,1542,4013,ㄉㄜˊ,dé
10182,得不償失,7,,2,1,3,ㄉㄜˊ ㄅㄨˋ ㄔㄤˊ ㄕ,dé bù cháng shī
10183,得逞,7,,5,1,6,ㄉㄜˊ ㄔㄥˇ,dé chěng
10184,得當,7,,5,1,6,ㄉㄜˊ ㄉㄤˋ,dé dàng
10185,得道,7,,3,1,4,ㄉㄜˊ ㄉㄠˋ,dé dào
10186,得了,7,,3,1,4,ㄉㄜˊ ˙ㄌㄜ,dé le
10187,得心應手,7,,3,2,5,ㄉㄜˊ ㄒㄧㄣ ㄧㄥˋ ㄕㄡˇ,dé xīn yìng shǒu
10188,德性,7,,4,0,4,ㄉㄜˊ ㄒㄧㄥˋ,dé xìng
10189,德行,7,,6,2,8,ㄉㄜˊ ㄒㄧㄥˋ,dé xìng
10190,得宜,7,,4,1,5,ㄉㄜˊ ㄧˊ,dé yí
10191,得意忘形,7,,2,1,3,ㄉㄜˊ ㄧˋ ㄨㄤˋ ㄒㄧㄥˊ,dé yì wàng xíng
10192,得意洋洋,7,,5,1,6,ㄉㄜˊ ㄧˋ ㄧㄤˊ ㄧㄤˊ,dé yì yáng yáng
10193,得志,7,,4,1,5,ㄉㄜˊ ㄓˋ,dé zhì
10194,蹬,7,,3,2,5,ㄉㄥˋ,dèng
10195,等號,7,,4,2,6,ㄉㄥˇ ㄏㄠˋ,děng hào
10196,登基,7,,10,4,14,ㄉㄥ ㄐㄧ,dēng jī
10197,登門,7,,5,0,5,ㄉㄥ ㄇㄣˊ,dēng mén
10198,登載,7,,2,0,2,ㄉㄥ ㄗㄞˋ,dēng zài
10199,地表,7,,5,33,38,ㄉㄧˋ ㄅㄧㄠˇ,dì biǎo
10200,地標,7,,3,9,12,ㄉㄧˋ ㄅㄧㄠ,dì biāo
10201,敵不過,7,,2,1,3,ㄉㄧˊㄅㄨˊㄍㄨㄛˋ,dí bú guò
10202,牴觸,7,,3,1,4,ㄉㄧˇ ㄔㄨˋ,dǐ chù
10203,低垂,7,,5,3,8,ㄉㄧ ㄔㄨㄟˊ,dī chuí
10204,地道,7,,4,1,5,(一)ㄉㄧˋ ㄉㄠˋ/(二)ㄉㄧˋ ˙ㄉㄠ,dì dào/dì dao
10205,地段,7,,2,2,4,ㄉㄧˋ ㄉㄨㄢˋ,dì duàn
10206,詆毀,7,,3,0,3,ㄉㄧˇ ㄏㄨㄟˇ,dǐ huǐ
10207,地基,7,,3,7,10,ㄉㄧˋ ㄐㄧ,dì jī
10208,遞減,7,,3,3,6,ㄉㄧˋ ㄐㄧㄢˇ,dì jiǎn
10209,地窖,7,,6,0,6,ㄉㄧˋ ㄐㄧㄠˋ,dì jiào
10210,締結,7,,6,1,7,ㄉㄧˋ ㄐㄧㄝˊ,dì jié
10211,低階,7,,4,2,6,ㄉㄧ ㄐㄧㄝ,dī jiē
10212,地雷,7,,3,3,6,ㄉㄧˋ ㄌㄟˊ,dì léi
10213,低劣,7,,3,0,3,ㄉㄧ ㄌㄧㄝˋ,dī liè
10214,低迷,7,,4,6,10,ㄉㄧ ㄇㄧˊ,dī mí
10215,敵視,7,,3,1,4,ㄉㄧˊ ㄕˋ,dí shì
10216,敵手,7,,4,1,5,ㄉㄧˊ ㄕㄡˇ,dí shǒu
10217,滴水,7,,3,4,7,ㄉㄧ ㄕㄨㄟˇ,dī shuǐ
10218,帝王,7,,23,5,28,ㄉㄧˋ ㄨㄤˊ,dì wáng
10219,底細,7,,4,1,5,ㄉㄧˇ ㄒㄧˋ,dǐ xì
10220,抵消,7,,3,2,5,ㄉㄧˇ ㄒㄧㄠ,dǐ xiāo
10221,抵銷,7,,3,1,4,ㄉㄧˇ ㄒㄧㄠ,dǐ xiāo
10222,抵押,7,,3,3,6,ㄉㄧˇ ㄧㄚ,dǐ yā
10223,抵禦,7,,5,3,8,ㄉㄧˇ ㄩˋ,dǐ yù
10224,締造,7,,5,5,10,ㄉㄧˋ ㄗㄠˋ,dì zào
10225,底子,7,,3,3,6,ㄉㄧˇ ˙ㄗ,dǐ zi
10226,殿,7,,27,4,31,ㄉㄧㄢˋ,diàn
10227,踮,7,,3,0,3,ㄉㄧㄢˋ,diàn
10228,顛簸,7,,5,4,9,ㄉㄧㄢ ㄅㄛˇ,diān bǒ
10229,點點滴滴,7,,5,1,6,ㄉㄧㄢˇ ㄉㄧㄢˇ ㄉㄧ ㄉㄧ,diǎn diǎn dī dī
10230,典故,7,,6,5,11,ㄉㄧㄢˇ ㄍㄨˋ,diǎn gù
10231,電擊,7,,9,2,11,ㄉㄧㄢˋ ㄐㄧˊ,diàn jí
10232,惦記,7,,3,2,5,ㄉㄧㄢˋ ㄐㄧˋ,diàn jì
10233,奠基,7,,5,1,6,ㄉㄧㄢˋ ㄐㄧ,diàn jī
10234,電機,7,,6,2,8,ㄉㄧㄢˋ ㄐㄧ,diàn jī
10235,典籍,7,,5,4,9,ㄉㄧㄢˇ ㄐㄧˊ,diǎn jí
10236,點亮,7,,4,3,7,ㄉㄧㄢˇ ㄌㄧㄤˋ,diǎn liàng
10237,顛沛流離,7,,2,1,3,ㄉㄧㄢ ㄆㄟˋ ㄌㄧㄡˊ ㄌㄧˊ,diān pèi liú lí
10238,店鋪/店舖,7,,10,2,12,ㄉㄧㄢˋ ㄆㄨˋ,diàn pù
10239,癲癇,7,,5,1,6,ㄉㄧㄢ ㄒㄧㄢˊ,diān xián
10240,電訊,7,,3,1,4,ㄉㄧㄢˋ ㄒㄩㄣˋ,diàn xùn
10241,電源,7,,3,5,8,ㄉㄧㄢˋ ㄩㄢˊ,diàn yuán
10242,店主,7,,4,1,5,ㄉㄧㄢˋ ㄓㄨˇ,diàn zhǔ
10243,墊子,7,,3,2,5,ㄉㄧㄢˋ ˙ㄗ,diàn zi
10244,調度,7,,5,4,9,ㄉㄧㄠˋ ㄉㄨˋ,diào dù
10245,調換,7,,2,1,3,ㄉㄧㄠˋ ㄏㄨㄢˋ,diào huàn
10246,凋零,7,,4,10,14,ㄉㄧㄠ ㄌㄧㄥˊ,diāo líng
10247,刁難,7,,3,1,4,ㄉㄧㄠ ㄋㄢˊ,diāo nán
10248,調配2,7,,4,7,11,ㄉㄧㄠˋ ㄆㄟˋ,diào pèi
10249,掉頭,7,,6,1,7,ㄉㄧㄠˋ ㄊㄡˊ,diào tóu
10250,掉以輕心,7,,3,5,8,ㄉㄧㄠˋ ㄧˇ ㄑㄧㄥ ㄒㄧㄣ,diào yǐ qīng xīn
10251,雕琢,7,,2,2,4,ㄉㄧㄠ ㄓㄨㄛˊ,diāo zhuó
10252,調子,7,,3,0,3,ㄉㄧㄠˋ ˙ㄗ,diào zi
10253,爹,7,,29,48,77,ㄉㄧㄝ,diē
10254,喋喋不休,7,,3,0,3,ㄉㄧㄝˊ ㄉㄧㄝˊ ㄅㄨˋ ㄒㄧㄡ,dié dié bù xiū
10255,跌跌撞撞,7,,6,1,7,ㄉㄧㄝˊ ㄉㄧㄝˊ ㄓㄨㄤˋ ㄓㄨㄤˋ,dié dié zhuàng zhuàng
10256,定案,7,,3,2,5,ㄉㄧㄥˋ ㄢˋ,dìng àn
10257,定點,7,,4,7,11,ㄉㄧㄥˋ ㄉㄧㄢˇ,dìng diǎn
10258,定額,7,,2,1,3,ㄉㄧㄥˋ ㄜˊ,dìng é
10259,鼎沸,7,,2,2,4,ㄉㄧㄥˇ ㄈㄟˋ,dǐng fèi
10260,頂峰,7,,5,1,6,ㄉㄧㄥˇ ㄈㄥ,dǐng fēng
10261,定睛,7,,3,0,3,ㄉㄧㄥˋ ㄐㄧㄥ,dìng jīng
10262,定局,7,,2,0,2,ㄉㄧㄥˋ ㄐㄩˊ,dìng jú
10263,訂立,7,,3,2,5,ㄉㄧㄥˋ ㄌㄧˋ,dìng lì
10264,定論,7,,7,5,12,ㄉㄧㄥˋ ㄌㄨㄣˋ,dìng lùn
10265,鼎盛,7,,4,4,8,ㄉㄧㄥˇ ㄕㄥˋ,dǐng shèng
10266,叮囑,7,,5,1,6,ㄉㄧㄥ ㄓㄨˇ,dīng zhǔ
10267,頂撞,7,,3,1,4,ㄉㄧㄥˇ ㄓㄨㄤˋ,dǐng zhuàng
10268,定罪,7,,4,0,4,ㄉㄧㄥˋ ㄗㄨㄟˋ,dìng zuì
10269,丟失,7,,3,0,3,ㄉㄧㄡ ㄕ,diū shī
10270,動筆,7,,4,1,5,ㄉㄨㄥˋ ㄅㄧˇ,dòng bǐ
10271,洞察,7,,5,1,6,ㄉㄨㄥˋ ㄔㄚˊ,dòng chá
10272,東倒西歪,7,,3,2,5,ㄉㄨㄥ ㄉㄠˇ ㄒㄧ ㄨㄞ,dōng dǎo xī wāi
10273,動工,7,,3,4,7,ㄉㄨㄥˋ ㄍㄨㄥ,dòng gōng
10274,恫嚇,7,,3,2,5,ㄉㄨㄥˋ ㄏㄜˋ,dòng hè
10275,凍結,7,,5,5,10,ㄉㄨㄥˋ ㄐㄧㄝˊ,dòng jié
10276,棟樑,7,,1,0,1,ㄉㄨㄥˋ ㄌㄧㄤˊ,dòng liáng
10277,動脈,7,,6,6,12,ㄉㄨㄥˋ ㄇㄞˋ,dòng mài
10278,動能,7,,8,2,10,ㄉㄨㄥˋ ㄋㄥˊ,dòng néng
10279,動怒,7,,3,0,3,ㄉㄨㄥˋ ㄋㄨˋ,dòng nù
10280,動容,7,,4,4,8,ㄉㄨㄥˋ ㄖㄨㄥˊ,dòng róng
10281,東山再起,7,,3,1,4,ㄉㄨㄥ ㄕㄢ ㄗㄞˋ ㄑㄧˇ,dōng shān zài qǐ
10282,動彈不得,7,,6,3,9,ㄉㄨㄥˋ ㄊㄢ ˊㄅㄨˋ ㄉㄜˊ,dòng tán bù dé
10283,洞悉,7,,5,1,6,ㄉㄨㄥˋ ㄒㄧ,dòng xī
10284,動輒,7,,6,4,10,ㄉㄨㄥˋ ㄓㄜˊ,dòng zhé
10285,斗,7,,9,7,16,ㄉㄡˇ,dǒu
10286,兜,7,,5,4,9,ㄉㄡ,dōu
10287,斗大,7,,3,2,5,ㄉㄡˇ ㄉㄚˋ,dǒu dà
10288,兜風,7,,3,1,4,ㄉㄡ ㄈㄥ,dōu fēng
10289,逗留,7,,6,2,8,ㄉㄡˋ ㄌㄧㄡˊ,dòu liú
10290,陡坡,7,,3,1,4,ㄉㄡˇ ㄆㄛ,dǒu pō
10291,陡峭,7,,6,6,12,ㄉㄡˇ ㄑㄧㄠˋ,dǒu qiào
10292,逗趣,7,,3,2,5,ㄉㄡˋ ㄑㄩˋ,dòu qù
10293,鬥士,7,,4,7,11,ㄉㄡˋ ㄕˋ,dòu shì
10294,兜售,7,,3,3,6,ㄉㄡ ㄕㄡˋ,dōu shòu
10295,鬥志,7,,7,3,10,ㄉㄡˋ ㄓˋ,dòu zhì
10296,鬥智,7,,3,0,3,ㄉㄡˋ ㄓˋ,dòu zhì
10297,獨霸,7,,3,1,4,ㄉㄨˊ ㄅㄚˋ,dú bà
10298,渡船,7,,3,1,4,ㄉㄨˋ ㄔㄨㄢˊ,dù chuán
10299,獨創,7,,3,2,5,ㄉㄨˊ ㄔㄨㄤˋ,dú chuàng
10300,督促,7,,5,5,10,ㄉㄨ ㄘㄨˋ,dū cù
10301,獨當一面,7,,3,2,5,ㄉㄨˊ ㄉㄤ ㄧˊ ㄇㄧㄢˋ,dú dāng yí miàn
10302,督導,7,,5,1,6,ㄉㄨ ㄉㄠˇ,dū dǎo
10303,篤定,7,,6,5,11,ㄉㄨˇ ㄉㄧㄥˋ,dǔ dìng
10304,獨斷,7,,3,0,3,ㄉㄨˊ ㄉㄨㄢˋ,dú duàn
10305,毒害,7,,4,3,7,ㄉㄨˊ ㄏㄞˋ,dú hài
10306,都會,7,,4,8,12,ㄉㄨ ㄏㄨㄟˋ,dū huì
10307,妒忌,7,,3,1,4,ㄉㄨˋ ㄐㄧˋ,dù jì
10308,鍍金,7,,3,1,4,ㄉㄨˋ ㄐㄧㄣ,dù jīn
10309,獨居,7,,4,13,17,ㄉㄨˊ ㄐㄩ,dú jū
10310,獨具,7,,4,1,5,ㄉㄨˊ ㄐㄩˋ,dú jù 
10311,杜絕,7,,4,2,6,ㄉㄨˋ ㄐㄩㄝˊ,dù jué
10312,獨門,7,,3,2,5,ㄉㄨˊ ㄇㄣˊ,dú mén
10313,嘟囔,7,,2,0,2,ㄉㄨ ˙ㄋㄤ,dū nang
10314,嘟噥,7,,3,0,3,ㄉㄨ ˙ㄋㄨㄥ,dū nong
10315,賭氣,7,,4,2,6,ㄉㄨˇ ㄑㄧˋ,dǔ qì
10316,獨身,7,,3,0,3,ㄉㄨˊ ㄕㄣ,dú shēn
10317,賭徒,7,,4,0,4,ㄉㄨˇ ㄊㄨˊ,dǔ tú
10318,獨享,7,,2,1,3,ㄉㄨˊ ㄒㄧㄤˇ,dú xiǎng
10319,篤信,7,,3,3,6,ㄉㄨˇ ㄒㄧㄣˋ,dǔ xìn
10320,獨行,7,,3,1,4,ㄉㄨˊ ㄒㄧㄥˊ,dú xíng
10321,獨佔/獨占,7,,8,3,11,ㄉㄨˊ ㄓㄢˋ,dú zhàn
10322,杜撰,7,,3,1,4,ㄉㄨˋ ㄓㄨㄢˋ,dù zhuàn
10323,端倪,7,,5,3,8,ㄉㄨㄢ ㄋㄧˊ,duān ní
10324,斷氣,7,,3,1,4,ㄉㄨㄢˋ ㄑㄧˋ,duàn qì
10325,端視,7,,3,0,3,ㄉㄨㄢ ㄕˋ,duān shì
10326,斷送,7,,3,0,3,ㄉㄨㄢˋ ㄙㄨㄥˋ,duàn sòng
10327,端詳,7,,9,2,11,ㄉㄨㄢ ㄒㄧㄤˊ,duān xiáng
10328,斷言,7,,5,1,6,ㄉㄨㄢˋ ㄧㄢˊ,duàn yán
10329,端正,7,,5,2,7,ㄉㄨㄢ ㄓㄥˋ,duān zhèng
10330,端莊,7,,4,2,6,ㄉㄨㄢ ㄓㄨㄤ,duān zhuāng
10331,堆疊,7,,4,4,8,ㄉㄨㄟ ㄉㄧㄝˊ,duī dié
10332,對聯,7,,6,2,8,ㄉㄨㄟˋ ㄌㄧㄢˊ,duì lián
10333,堆砌,7,,2,1,3,ㄉㄨㄟ ㄑㄧˋ,duī qì
10334,對望,7,,3,1,4,ㄉㄨㄟˋ ㄨㄤˋ,duì wàng
10335,兌現,7,,4,3,7,ㄉㄨㄟˋ ㄒㄧㄢˋ,duì xiàn
10336,對症下藥,7,,4,2,6,ㄉㄨㄟˋ ㄓㄥˋ ㄒㄧㄚˋ ㄧㄠˋ,duì zhèng xià yào
10337,鈍,7,,3,2,5,ㄉㄨㄣˋ,dùn
10338,敦促,7,,3,4,7,ㄉㄨㄣ ㄘㄨˋ,dūn cù
10339,敦厚,7,,3,0,3,ㄉㄨㄣ ㄏㄡˋ,dūn hòu
10340,盾牌,7,,3,3,6,ㄉㄨㄣˋ ㄆㄞˊ,dùn pái
10341,頓悟,7,,6,2,8,ㄉㄨㄣˋ ㄨˋ,dùn wù
10342,舵,7,,3,1,4,ㄉㄨㄛˋ,duò
10343,踱步,7,,5,1,6,ㄉㄨㄛˋ ㄅㄨˋ,duò bù
10344,多才多藝,7,,3,1,4,ㄉㄨㄛ ㄘㄞˊ ㄉㄨㄛ ㄧˋ,duō cái duō yì
10345,多愁善感,7,,3,1,4,ㄉㄨㄛ ㄔㄡˊ ㄕㄢˋ ㄍㄢˇ,duō chóu shàn gǎn
10346,多端,7,,3,0,3,ㄉㄨㄛ ㄉㄨㄢ,duō duān
10347,咄咄逼人,7,,3,3,6,ㄉㄨㄛˋ ㄉㄨㄛˋ ㄅㄧ ㄖㄣˊ,duò duò bī rén
10348,跺腳,7,,3,1,4,ㄉㄨㄛˋ ㄐㄧㄠˇ,duò jiǎo
10349,多媒體,7,,6,2,8,ㄉㄨㄛ ㄇㄟˊ ㄊㄧˇ,duō méi tǐ
10350,奪目,7,,4,1,5,ㄉㄨㄛˊ ㄇㄨˋ,duó mù
10351,多難,7,,3,2,5,ㄉㄨㄛ ㄋㄢˋ,duō nàn
10352,哆嗦,7,,4,0,4,ㄉㄨㄛ ˙ㄙㄨㄛ,duō suo
10353,多疑,7,,4,0,4,ㄉㄨㄛ ㄧˊ,duō yí
10354,惡棍,7,,4,0,4,ㄜˋ ㄍㄨㄣˋ,è gùn
10355,惡果,7,,3,2,5,ㄜˋ ㄍㄨㄛˇ,è guǒ
10356,噩耗,7,,3,1,4,ㄜˋ ㄏㄠˋ,è hào
10357,惡狠狠,7,,4,0,4,ㄜˋ ㄏㄣˇ ㄏㄣˇ,è hěn hěn
10358,惡名,7,,3,0,3,ㄜˋ ㄇㄧㄥˊ,è míng
10359,愕然,7,,2,0,2,ㄜˋ ㄖㄢˊ,è rán
10360,扼殺,7,,5,2,7,ㄜˋ ㄕㄚ,è shā
10361,扼腕,7,,2,1,3,ㄜˋ ㄨㄢˋ,è wàn
10362,惡行,7,,5,1,6,ㄜˋ ㄒㄧㄥˋ,è xìng
10363,惡言,7,,4,1,5,ㄜˋ ㄧㄢˊ,è yán
10364,扼要,7,,5,1,6,ㄜˋ ㄧㄠˋ,è yào
10365,鱷魚,7,,5,4,9,ㄜˋ ㄩˊ,è yú
10366,阿諛,7,,3,1,4,ㄜ ㄩˊ,ē yú
10367,厄運,7,,5,1,6,ㄜˋ ㄩㄣˋ,è yùn
10368,遏止,7,,4,4,8,ㄜˋ ㄓˇ,è zhǐ
10369,恩惠,7,,4,1,5,ㄣ ㄏㄨㄟˋ,ēn huì
10370,恩情,7,,4,3,7,ㄣ ㄑㄧㄥˊ,ēn qíng
10371,恩師,7,,3,1,4,ㄣ ㄕ,ēn shī
10372,恩賜,7,,5,3,8,ㄣ ㄙˋ,ēn sì
10373,恩怨,7,,4,3,7,ㄣ ㄩㄢˋ,ēn yuàn
10374,貳,7,,3,1,4,ㄦˋ,èr
10375,餌,7,,5,3,8,ㄦˇ,ěr
10376,爾後,7,,4,2,6,ㄦˇ ㄏㄡˋ,ěr hòu
10377,二話不說,7,,4,3,7,ㄦˋ ㄏㄨㄚˋ ㄅㄨˋ ㄕㄨㄛ,èr huà bù shuō
10378,耳目一新,7,,2,3,5,ㄦˇ ㄇㄨˋ ㄧ ㄒㄧㄣ,ěr mù yī xīn
10379,耳熟能詳,7,,4,4,8,ㄦˇ ㄕㄨˊ ㄋㄥˊ ㄒㄧㄤˊ,ěr shú néng xiáng
10380,耳提面命,7,,2,2,4,ㄦˇ ㄊㄧˊ ㄇㄧㄢˋ ㄇㄧㄥˋ,ěr tí miàn mìng
10381,耳聞,7,,4,1,5,ㄦˇ ㄨㄣˊ,ěr wén
10382,兒戲,7,,3,1,4,ㄦˊ ㄒㄧˋ,ér xì
10383,耳語,7,,5,2,7,ㄦˇ ㄩˇ,ěr yǔ
10384,發飆,7,,2,1,3,ㄈㄚ ㄅㄧㄠ,fā biāo
10385,法定,7,,6,2,8,ㄈㄚˇ ㄉㄧㄥˋ,fǎ dìng
10386,發號施令,7,,6,1,7,ㄈㄚ ㄏㄠˋ ㄕ ㄌㄧㄥˋ,fā hào shī lìng
10387,發慌,7,,2,0,2,ㄈㄚ ㄏㄨㄤ,fā huāng
10388,發跡,7,,4,1,5,ㄈㄚ ㄐㄧ,fā jī
10389,法力,7,,3,1,4,ㄈㄚˇ ㄌㄧˋ,fǎ lì
10390,發麻,7,,3,1,4,ㄈㄚ ㄇㄚˊ,fā má
10391,發難,7,,3,1,4,ㄈㄚ ㄋㄢˋ,fā nàn
10392,發人深省,7,,3,1,4,ㄈㄚ ㄖㄣˊ ㄕㄣ ㄒㄧㄥˇ,fā rén shēn xǐng
10393,法術,7,,6,0,6,ㄈㄚˇ ㄕㄨˋ,fǎ shù
10394,發言人,7,,4,7,11,ㄈㄚ ㄧㄢˊ ㄖㄣˊ,fā yán rén
10395,發揚,7,,4,3,7,ㄈㄚ ㄧㄤˊ,fā yáng
10396,發癢,7,,3,1,4,ㄈㄚ ㄧㄤˇ,fā yǎng
10397,發揚光大,7,,4,5,9,ㄈㄚ ㄧㄤˊ ㄍㄨㄤ ㄉㄚˋ,fā yáng guāng dà
10398,發源地,7,,2,7,9,ㄈㄚ ㄩㄢˊ ㄉㄧˋ,fā yuán dì
10399,翻版,7,,3,1,4,ㄈㄢ ㄅㄢˇ,fān bǎn
10400,範本,7,,7,2,9,ㄈㄢˋ ㄅㄣˇ,fàn běn
10401,帆布,7,,4,4,8,ㄈㄢ ㄅㄨˋ,fān bù
10402,反動,7,,7,0,7,ㄈㄢˇ ㄉㄨㄥˋ,fǎn dòng
10403,繁多,7,,5,3,8,ㄈㄢˊ ㄉㄨㄛ,fán duō
10404,凡夫俗子,7,,2,0,2,ㄈㄢˊ ㄈㄨ ㄙㄨˊ ㄗˇ,fán fū sú zǐ
10405,反覆無常,7,,2,1,3,ㄈㄢˇ ㄈㄨˋ ㄨˊ ㄔㄤˊ,fǎn fù wú cháng
10406,反攻,7,,7,1,8,ㄈㄢˇ ㄍㄨㄥ,fǎn gōng
10407,泛黃,7,,2,2,4,ㄈㄢˋ ㄏㄨㄤˊ,fàn huáng
10408,反悔,7,,3,2,5,ㄈㄢˇ ㄏㄨㄟˇ,fǎn huǐ
10409,翻來覆去,7,,3,1,4,ㄈㄢ ㄌㄞˊ ㄈㄨˋ ㄑㄩˋ,fān lái fù qù
10410,泛濫,7,,2,1,3,ㄈㄢˋ ㄌㄢˋ,fàn làn
10411,藩籬,7,,3,5,8,ㄈㄢˊ ㄌㄧˊ,fán lí
10412,繁茂,7,,3,3,6,ㄈㄢˊ ㄇㄠˋ,fán mào
10413,煩悶,7,,3,0,3,ㄈㄢˊ ㄇㄣˋ,fán mèn
10414,反撲,7,,3,3,6,ㄈㄢˇ ㄆㄨ,fǎn pū
10415,繁瑣,7,,4,4,8,ㄈㄢˊ ㄙㄨㄛˇ,fán suǒ
10416,翻騰,7,,5,1,6,ㄈㄢ ㄊㄥˊ,fān téng
10417,反胃,7,,3,0,3,ㄈㄢˇ ㄨㄟˋ,fǎn wèi
10418,翻新,7,,3,1,4,ㄈㄢ ㄒㄧㄣ,fān xīn
10419,繁星,7,,3,1,4,ㄈㄢˊ ㄒㄧㄥ,fán xīng
10420,繁衍,7,,6,12,18,ㄈㄢˊ ㄧㄢˇ,fán yǎn
10421,泛指,7,,2,1,3,ㄈㄢˋ ㄓˇ,fàn zhǐ
10422,繁重,7,,3,3,6,ㄈㄢˊ ㄓㄨㄥˋ,fán zhòng
10423,翻轉,7,,5,2,7,ㄈㄢ ㄓㄨㄢˇ,fān zhuǎn
10424,方程式,7,,11,2,13,ㄈㄤ ㄔㄥˊ ㄕˋ,fāng chéng shì
10425,放大鏡,7,,3,6,9,ㄈㄤˋ ㄉㄚˋ ㄐㄧㄥˋ,fàng dà jìng
10426,放蕩,7,,4,0,4,ㄈㄤˋ ㄉㄤˋ,fàng dàng
10427,防空,7,,1,2,3,ㄈㄤˊ ㄎㄨㄥ,fáng kōng
10428,放牧,7,,5,6,11,ㄈㄤˋ ㄇㄨˋ,fàng mù
10429,放射,7,,4,1,5,ㄈㄤˋ ㄕㄜˋ,fàng shè
10430,放肆,7,,4,1,5,ㄈㄤˋ ㄙˋ,fàng sì
10431,防線,7,,6,3,9,ㄈㄤˊ ㄒㄧㄢˋ,fáng xiàn
10432,仿效,7,,6,4,10,ㄈㄤˇ ㄒㄧㄠˋ,fǎng xiào
10433,芳心,7,,3,0,3,ㄈㄤ ㄒㄧㄣ,fāng xīn
10434,放映,7,,4,3,7,ㄈㄤˋ ㄧㄥˋ,fàng yìng
10435,方圓,7,,5,2,7,ㄈㄤ ㄩㄢˊ,fāng yuán
10436,仿照,7,,3,1,4,ㄈㄤˇ ㄓㄠˋ,fǎng zhào
10437,方正,7,,3,1,4,ㄈㄤ ㄓㄥˋ,fāng zhèng
10438,防治,7,,8,45,53,ㄈㄤˊ ㄓˋ,fáng zhì
10439,放逐,7,,5,1,6,ㄈㄤˋ ㄓㄨˊ,fàng zhú
10440,誹謗,7,,4,0,4,ㄈㄟˇ ㄅㄤˋ,fěi bàng
10441,非比尋常,7,,4,2,6,ㄈㄟ ㄅㄧˇ ㄒㄩㄣˊ ㄔㄤˊ,fēi bǐ xún cháng
10442,飛馳,7,,3,0,3,ㄈㄟ ㄔˊ,fēi chí
10443,肥大,7,,4,2,6,ㄈㄟˊ ㄉㄚˋ,féi dà
10444,沸沸揚揚,7,,2,1,3,ㄈㄟˋ ㄈㄟˋ ㄧㄤˊ ㄧㄤˊ,fèi fèi yáng yáng
10445,肺腑,7,,3,1,4,ㄈㄟˋ ㄈㄨˇ,fèi fǔ
10446,費解,7,,4,1,5,ㄈㄟˋ ㄐㄧㄝˇ,fèi jiě
10447,肺結核,7,,3,3,6,ㄈㄟˋ ㄐㄧㄝˊ ㄏㄜˊ,fèi jié hé
10448,費勁,7,,3,1,4,ㄈㄟˋ ㄐㄧㄣˋ,fèi jìn
10449,肥料,7,,7,87,94,ㄈㄟˊ ㄌㄧㄠˋ,féi liào
10450,廢寢忘食,7,,3,1,4,ㄈㄟˋ ㄑㄧㄣˇ ㄨㄤˋ ㄕˊ,fèi qǐn wàng shí
10451,斐然,7,,2,0,2,ㄈㄟˇ ㄖㄢˊ,fěi rán
10452,非同小可,7,,4,1,5,ㄈㄟ ㄊㄨㄥˊ ㄒㄧㄠˇ ㄎㄜˇ,fēi tóng xiǎo kě
10453,肥沃,7,,5,11,16,ㄈㄟˊ ㄨㄛˋ,féi wò
10454,非議,7,,3,0,3,ㄈㄟ ㄧˋ,fēi yì
10455,匪夷所思,7,,5,1,6,ㄈㄟˇ ㄧˊ ㄙㄨㄛˇ ㄙ,fěi yí suǒ sī
10456,飛越,7,,4,5,9,ㄈㄟ ㄩㄝˋ,fēi yuè
10457,飛躍,7,,3,1,4,ㄈㄟ ㄩㄝˋ,fēi yuè
10458,廢止,7,,4,1,5,ㄈㄟˋ ㄓˇ,fèi zhǐ
10459,粉筆,7,,3,4,7,ㄈㄣˇ ㄅㄧˇ,fěn bǐ
10460,糞便,7,,7,4,11,ㄈㄣˋ ㄅㄧㄢˋ,fèn biàn
10461,奮不顧身,7,,2,1,3,ㄈㄣˋ ㄅㄨˊ ㄍㄨˋ ㄕㄣ,fèn bú gù shēn
10462,分寸,7,,5,4,9,ㄈㄣ ㄘㄨㄣˋ,fēn cùn
10463,分道揚鑣,7,,3,1,4,ㄈㄣ ㄉㄠˋ ㄧㄤˊ ㄅㄧㄠ,fēn dào yáng biāo
10464,分段,7,,4,1,5,ㄈㄣ ㄉㄨㄢˋ,fēn duàn
10465,奮發,7,,3,2,5,ㄈㄣˋ ㄈㄚ,fèn fā
10466,分發,7,,3,1,4,ㄈㄣ ㄈㄚ,fēn fā
10467,芬芳,7,,4,2,6,ㄈㄣ ㄈㄤ,fēn fāng
10468,紛飛,7,,3,3,6,ㄈㄣ ㄈㄟ,fēn fēi
10469,忿忿不平,7,,2,1,3,ㄈㄣˋ ㄈㄣˋ ㄅㄨˋ ㄆㄧㄥˊ,fèn fèn bù píng
10470,憤憤不平,7,,2,1,3,ㄈㄣˋ ㄈㄣˋ ㄅㄨˋ ㄆㄧㄥˊ,fèn fèn bù píng
10471,分工合作,7,,3,3,6,ㄈㄣ ㄍㄨㄥ ㄏㄜˊ ㄗㄨㄛˋ,fēn gōng hé zuò
10472,憤恨,7,,5,0,5,ㄈㄣˋ ㄏㄣˋ,fèn hèn
10473,焚毀,7,,3,2,5,ㄈㄣˊ ㄏㄨㄟˇ,fén huǐ
10474,分際,7,,3,1,4,ㄈㄣˋ ㄐㄧˋ,fèn jì
10475,分解,7,,7,50,57,ㄈㄣ ㄐㄧㄝˇ,fēn jiě
10476,分居,7,,3,1,4,ㄈㄣ ㄐㄩ,fēn jū
10477,憤慨,7,,5,0,5,ㄈㄣˋ ㄎㄞˇ,fèn kǎi
10478,紛亂,7,,5,2,7,ㄈㄣ ㄌㄨㄢˋ,fēn luàn
10479,憤懣,7,,2,0,2,ㄈㄣˋ ㄇㄣˋ,fèn mèn
10480,分門別類,7,,3,2,5,ㄈㄣ ㄇㄣˊ ㄅㄧㄝˊ ㄌㄟˋ,fēn mén bié lèi
10481,粉末,7,,4,4,8,ㄈㄣˇ ㄇㄛˋ,fěn mò
10482,奮起,7,,3,2,5,ㄈㄣˋ ㄑㄧˇ,fèn qǐ
10483,紛擾,7,,4,3,7,ㄈㄣ ㄖㄠˇ,fēn rǎo
10484,分身,7,,4,2,6,ㄈㄣ ㄕㄣ,fēn shēn
10485,粉身碎骨,7,,3,1,4,ㄈㄣˇ ㄕㄣ ㄙㄨㄟˋ ㄍㄨˇ,fěn shēn suì gǔ
10486,粉飾,7,,2,0,2,ㄈㄣˇ ㄕˋ,fěn shì
10487,憤世嫉俗,7,,3,1,4,ㄈㄣˋ ㄕˋ ㄐㄧˊ ㄙㄨˊ,fèn shì jí sú
10488,粉刷,7,,3,1,4,ㄈㄣˇ ㄕㄨㄚ,fěn shuā
10489,分水嶺,7,,2,2,4,ㄈㄣ ㄕㄨㄟˇ ㄌㄧㄥˇ,fēn shuǐ lǐng
10490,分攤,7,,3,5,8,ㄈㄣ ㄊㄢ,fēn tān
10491,分外/份外,7,,4,1,5,ㄈㄣˋ ㄨㄞˋ,fèn wài
10492,焚香,7,,3,1,4,ㄈㄣˊ ㄒㄧㄤ,fén xiāng
10493,奮勇,7,,3,1,4,ㄈㄣˋ ㄩㄥˇ,fèn yǒng
10494,分支,7,,5,5,10,ㄈㄣ ㄓ,fēn zhī
10495,奉,7,,31,7,38,ㄈㄥˋ,fèng
10496,風采,7,,4,3,7,ㄈㄥ ㄘㄞˇ,fēng cǎi
10497,奉承,7,,6,2,8,ㄈㄥˋ ㄔㄥˊ,fèng chéng
10498,風吹草動,7,,2,2,4,ㄈㄥ ㄔㄨㄟ ㄘㄠˇ ㄉㄨㄥˋ,fēng chuī cǎo dòng
10499,風範,7,,5,4,9,ㄈㄥ ㄈㄢˋ,fēng fàn
10500,豐功偉業,7,,2,1,3,ㄈㄥ ㄍㄨㄥ ㄨㄟˇ ㄧㄝˋ,fēng gōng wěi yè
10501,風寒,7,,3,4,7,ㄈㄥ ㄏㄢˊ,fēng hán
10502,封號,7,,5,4,9,ㄈㄥ ㄏㄠˋ,fēng hào
10503,豐厚,7,,7,4,11,ㄈㄥ ㄏㄡˋ,fēng hòu
10504,風華,7,,4,5,9,ㄈㄥ ㄏㄨㄚˊ,fēng huá
10505,烽火,7,,3,5,8,ㄈㄥ ㄏㄨㄛˇ,fēng huǒ
10506,俸祿,7,,7,1,8,ㄈㄥˋ ㄌㄨˋ,fèng lù
10507,鋒芒,7,,2,0,2,ㄈㄥ ㄇㄤˊ,fēng máng
10508,風貌,7,,6,11,17,ㄈㄥ ㄇㄠˋ,fēng mào
10509,風靡,7,,4,3,7,ㄈㄥ ㄇㄧˇ,fēng mǐ
10510,豐沛,7,,4,12,16,ㄈㄥ ㄆㄟˋ,fēng pèi
10511,風平浪靜,7,,3,1,4,ㄈㄥ ㄆㄧㄥˊ ㄌㄤˋ ㄐㄧㄥˋ,fēng píng làng jìng
10512,風起雲湧,7,,2,3,5,ㄈㄥ ㄑㄧˇ ㄩㄣˊ ㄩㄥˇ,fēng qǐ yún yǒng
10513,奉勸,7,,3,2,5,ㄈㄥˋ ㄑㄩㄢˋ,fèng quàn
10514,豐饒,7,,2,3,5,ㄈㄥ ㄖㄠˊ,fēng ráo
10515,縫紉,7,,3,2,5,ㄈㄥˊ ㄖㄣˋ,féng rèn
10516,風騷,7,,3,1,4,ㄈㄥ ㄙㄠ,fēng sāo
10517,風尚,7,,2,1,3,ㄈㄥ ㄕㄤˋ,fēng shàng
10518,風霜,7,,3,2,5,ㄈㄥ ㄕㄨㄤ,fēng shuāng
10519,豐碩,7,,4,3,7,ㄈㄥ ㄕㄨㄛˋ,fēng shuò
10520,風調雨順,7,,2,6,8,ㄈㄥ ㄊㄧㄠˊ ㄩˇ ㄕㄨㄣˋ,fēng tiáo yǔ shùn
10521,風頭,7,,2,2,4,ㄈㄥ ㄊㄡˊ/ㄈㄥ ˙ㄊㄡ,fēng tóu/fēng tou
10522,奉養,7,,3,3,6,ㄈㄥˋ ㄧㄤˋ,fèng yàng
10523,逢迎,7,,3,0,3,ㄈㄥˊ ㄧㄥˊ,féng yíng
10524,蜂擁,7,,5,1,6,ㄈㄥ ㄩㄥˇ,fēng yǒng
10525,風雲,7,,6,5,11,ㄈㄥ ㄩㄣˊ,fēng yún
10526,風雲人物,7,,3,1,4,ㄈㄥ ㄩㄣˊ ㄖㄣˊ ㄨˋ,fēng yún rén wù
10527,縫製,7,,3,4,7,ㄈㄥˊ ㄓˋ,féng zhì
10528,豐足,7,,4,1,5,ㄈㄥ ㄗㄨˊ,fēng zú
10529,佛法,7,,10,28,38,ㄈㄛˊ ㄈㄚˇ,fó fǎ
10530,佛門,7,,4,2,6,ㄈㄛˊ ㄇㄣˊ,fó mén
10531,拂,7,,6,2,8,ㄈㄨˊ,fú
10532,賦,7,,5,2,7,ㄈㄨˋ,fù
10533,甫,7,,8,1,9,ㄈㄨˇ,fǔ
10534,浮動,7,,3,2,5,ㄈㄨˊ ㄉㄨㄥˋ,fú dòng
10535,復發,7,,7,5,12,ㄈㄨˋ ㄈㄚ,fù fā
10536,復古,7,,3,2,5,ㄈㄨˋ ㄍㄨˇ,fù gǔ
10537,富含,7,,4,10,14,ㄈㄨˋ ㄏㄢˊ,fù hán
10538,俯瞰,7,,6,5,11,ㄈㄨˇ ㄎㄢˋ,fǔ kàn
10539,浮誇,7,,2,0,2,ㄈㄨˊ ㄎㄨㄚ,fú kuā
10540,富麗堂皇,7,,3,1,4,ㄈㄨˋ ㄌㄧˋ ㄊㄤˊ ㄏㄨㄤˊ,fù lì táng huáng
10541,駙馬,7,,5,0,5,ㄈㄨˋ ㄇㄚˇ,fù mǎ
10542,富饒,7,,2,2,4,ㄈㄨˋ ㄖㄠˊ,fù ráo
10543,府上,7,,3,0,3,ㄈㄨˇ ㄕㄤˋ,fǔ shàng
10544,輻射,7,,7,45,52,ㄈㄨˊ ㄕㄜˋ,fú shè
10545,附設,7,,3,3,6,ㄈㄨˋ ㄕㄜˋ,fù shè
10546,附身,7,,4,1,5,ㄈㄨˋ ㄕㄣ,fù shēn
10547,俯身,7,,6,0,6,ㄈㄨˇ ㄕㄣ,fǔ shēn
10548,浮生,7,,3,1,4,ㄈㄨˊ ㄕㄥ,fú shēng
10549,腐蝕,7,,3,5,8,ㄈㄨˇ ㄕˊ,fǔ shí
10550,俯視,7,,4,1,5,ㄈㄨˇ ㄕˋ,fǔ shì
10551,俯首,7,,3,0,3,ㄈㄨˇ ㄕㄡˇ,fǔ shǒu
10552,服輸,7,,3,2,5,ㄈㄨˊ ㄕㄨ,fú shū
10553,富庶,7,,3,3,6,ㄈㄨˋ ㄕㄨˋ,fù shù
10554,賦稅,7,,6,1,7,ㄈㄨˋ ㄕㄨㄟˋ,fù shuì
10555,覆亡,7,,3,0,3,ㄈㄨˋ ㄨㄤˊ,fù wáng
10556,腹瀉,7,,7,4,11,ㄈㄨˋ ㄒㄧㄝˋ,fù xiè
10557,服刑,7,,3,4,7,ㄈㄨˊ ㄒㄧㄥˊ,fú xíng
10558,腐朽,7,,5,4,9,ㄈㄨˇ ㄒㄧㄡˇ,fǔ xiǔ
10559,夫婿,7,,3,1,4,ㄈㄨ ㄒㄩˋ,fū xù
10560,服役,7,,6,2,8,ㄈㄨˊ ㄧˋ,fú yì
10561,服膺,7,,2,0,2,ㄈㄨˊ ㄧㄥ,fú yīng
10562,富於,7,,5,1,6,ㄈㄨˋ ㄩˊ,fù yú
10563,撫育,7,,3,2,5,ㄈㄨˇ ㄩˋ,fǔ yù
10564,浮雲,7,,2,0,2,ㄈㄨˊ ㄩㄣˊ,fú yún
10565,浮躁,7,,3,2,5,ㄈㄨˊ ㄗㄠˋ,fú zào
10566,福祉,7,,6,3,9,ㄈㄨˊ ㄓˇ,fú zhǐ
10567,付諸,7,,11,6,17,ㄈㄨˋ ㄓㄨ,fù zhū
10568,概括,7,,6,1,7,ㄍㄞˋ ㄍㄨㄚ,gài guā
10569,改嫁,7,,3,1,4,ㄍㄞˇ ㄐㄧㄚˋ,gǎi jià
10570,改建,7,,4,5,9,ㄍㄞˇ ㄐㄧㄢˋ,gǎi jiàn
10571,改口,7,,4,0,4,ㄍㄞˇ ㄎㄡˇ,gǎi kǒu
10572,概略,7,,2,0,2,ㄍㄞˋ ㄌㄩㄝˋ,gài lüè
10573,蓋世,7,,4,1,5,ㄍㄞˋ ㄕˋ,gài shì
10574,改頭換面,7,,2,3,5,ㄍㄞˇ ㄊㄡˊ ㄏㄨㄢˋ ㄇㄧㄢˋ,gǎi tóu huàn miàn
10575,感觸,7,,7,15,22,ㄍㄢˇ ㄔㄨˋ,gǎn chù
10576,趕工,7,,2,3,5,ㄍㄢˇ ㄍㄨㄥ,gǎn gōng
10577,感官,7,,26,7,33,ㄍㄢˇ ㄍㄨㄢ,gǎn guān
10578,乾涸,7,,3,8,11,ㄍㄢ ㄏㄜˊ,gān hé
10579,乾枯,7,,4,4,8,ㄍㄢ ㄎㄨ,gān kū
10580,幹練,7,,4,1,5,ㄍㄢˋ ㄌㄧㄢˋ,gàn liàn
10581,感念,7,,4,6,10,ㄍㄢˇ ㄋㄧㄢˋ,gǎn niàn
10582,感佩,7,,2,4,6,ㄍㄢˇ ㄆㄟˋ,gǎn pèi
10583,甘甜,7,,3,7,10,ㄍㄢ ㄊㄧㄢˊ,gān tián
10584,感同身受,7,,5,6,11,ㄍㄢˇ ㄊㄨㄥˊ ㄕㄣ ㄕㄡˋ,gǎn tóng shēn shòu
10585,肝臟,7,,10,16,26,ㄍㄢ ㄗㄤˋ,gān zàng
10586,感召,7,,3,1,4,ㄍㄢˇ ㄓㄠˋ,gǎn zhào
10587,甘蔗,7,,8,18,26,ㄍㄢ ㄓㄜˋ,gān zhè
10588,鋼筆,7,,4,1,5,ㄍㄤ ㄅㄧˇ,gāng bǐ
10589,槓桿,7,,5,1,6,ㄍㄤˋ ㄍㄢˇ,gàng gǎn
10590,綱領,7,,3,2,5,ㄍㄤ ㄌㄧㄥˇ,gāng lǐng
10591,剛強,7,,4,2,6,ㄍㄤ ㄑㄧㄤˊ,gāng qiáng
10592,剛毅,7,,4,1,5,ㄍㄤ ㄧˋ,gāng yì
10593,高傲,7,,6,1,7,ㄍㄠ ㄠˋ,gāo ào
10594,高唱,7,,3,1,4,ㄍㄠ ㄔㄤˋ,gāo chàng
10595,高檔,7,,4,1,5,ㄍㄠ ㄉㄤˇ ,gāo dǎng
10596,高額,7,,3,3,6,ㄍㄠ ㄜˊ,gāo é
10597,告發,7,,6,1,7,ㄍㄠˋ ㄈㄚ,gào fā
10598,高高在上,7,,5,4,9,ㄍㄠ ㄍㄠ ㄗㄞˋ ㄕㄤˋ,gāo gāo zài shàng
10599,高估,7,,4,1,5,ㄍㄠ ㄍㄨ,gāo gū
10600,搞混,7,,3,1,4,ㄍㄠˇ ㄏㄨㄣˋ,gǎo hùn
10601,高見,7,,2,0,2,ㄍㄠ ㄐㄧㄢˋ,gāo jiàn
10602,高亢,7,,4,2,6,ㄍㄠ ㄎㄤˋ,gāo kàng
10603,告密,7,,3,0,3,ㄍㄠˋ ㄇㄧˋ,gào mì
10604,高人,7,,3,0,3,ㄍㄠ ㄖㄣˊ,gāo rén
10605,高人一等,7,,3,1,4,ㄍㄠ ㄖㄣˊ ㄧˋ ㄉㄥˇ,gāo rén yì děng
10606,高深,7,,4,1,5,ㄍㄠ ㄕㄣ,gāo shēn
10607,告示,7,,4,1,5,ㄍㄠˋ ㄕˋ,gào shì
10608,高談闊論,7,,3,1,4,ㄍㄠ ㄊㄢˊ ㄎㄨㄛˋ ㄌㄨㄣˋ,gāo tán kuò lùn
10609,告退,7,,2,0,2,ㄍㄠˋ ㄊㄨㄟˋ,gào tuì
10610,高壓,7,,6,21,27,ㄍㄠ ㄧㄚ,gāo yā
10611,羔羊,7,,3,1,4,ㄍㄠ ㄧㄤˊ,gāo yáng
10612,搞砸,7,,6,1,7,ㄍㄠˇ ㄗㄚˊ,gǎo zá
10613,高照,7,,3,2,5,ㄍㄠ ㄓㄠˋ,gāo zhào
10614,告終,7,,4,1,5,ㄍㄠˋ ㄓㄨㄥ,gào zhōng
10615,胳膊,7,,5,0,5,ㄍㄜ ㄅㄛˊ,gē bó
10616,割草,7,,3,8,11,ㄍㄜ ㄘㄠˇ,gē cǎo
10617,疙瘩,7,,3,1,4,ㄍㄜ ˙ㄉㄚ,gē da
10618,格調,7,,3,1,4,ㄍㄜˊ ㄉㄧㄠˋ,gé diào
10619,格格不入,7,,6,2,8,ㄍㄜˊ ㄍㄜˊ ㄅㄨˊ ㄖㄨˋ,gé gé bú rù
10620,割據,7,,7,3,10,ㄍㄜ ㄐㄩˋ,gē jù
10621,隔日,7,,2,2,4,ㄍㄜˊ ㄖˋ,gé rì
10622,割捨,7,,5,4,9,ㄍㄜ ㄕㄜˇ,gē shě
10623,歌頌,7,,7,2,9,ㄍㄜ ㄙㄨㄥˋ,gē sòng
10624,個頭,7,,3,3,6,ㄍㄜˋ ㄊㄡˊ,gè tóu
10625,閣下,7,,29,1,30,ㄍㄜˊ ㄒㄧㄚˋ,gé xià
10626,擱下,7,,3,0,3,ㄍㄜ ㄒㄧㄚˋ,gē xià
10627,格言,7,,5,1,6,ㄍㄜˊ ㄧㄢˊ,gé yán
10628,歌謠,7,,4,4,8,ㄍㄜ ㄧㄠˊ,gē yáo
10629,革職,7,,5,0,5,ㄍㄜˊ ㄓˊ,gé zhí
10630,擱置,7,,5,3,8,ㄍㄜ ㄓˋ,gē zhì
10631,根除,7,,2,3,5,ㄍㄣ ㄔㄨˊ,gēn chú
10632,根據地,7,,8,3,11,ㄍㄣ ㄐㄩˋ ㄉㄧˋ,gēn jù dì
10633,根深蒂固,7,,4,3,7,ㄍㄣ ㄕㄣ ㄉㄧˋ ㄍㄨˋ,gēn shēn dì gù
10634,根深柢固,7,,4,1,5,ㄍㄣ ㄕㄣ ㄉㄧˇ ㄍㄨˋ,gēn shēn dǐ gù
10635,根植,7,,2,0,2,ㄍㄣ ㄓˊ,gēn zhí
10636,更2,7,,1457,1320,2777,ㄍㄥ,gēng
10637,羹,7,,4,3,7,ㄍㄥ,gēng
10638,更迭,7,,3,4,7,ㄍㄥ ㄉㄧㄝˊ,gēng dié
10639,更動,7,,4,1,5,ㄍㄥ ㄉㄨㄥˋ,gēng dòng
10640,耿耿於懷,7,,3,2,5,ㄍㄥˇ ㄍㄥˇ ㄩˊ ㄏㄨㄞˊ,gěng gěng yú huái
10641,更替,7,,2,0,2,ㄍㄥ ㄊㄧˋ,gēng tì
10642,耕田,7,,3,4,7,ㄍㄥ ㄊㄧㄢˊ,gēng tián
10643,更形,7,,4,2,6,ㄍㄥˋ ㄒㄧㄥˊ,gèng xíng
10644,哽咽,7,,6,2,8,ㄍㄥˇ ㄧㄝˋ,gěng yè
10645,更衣,7,,3,1,4,ㄍㄥ ㄧ,gēng yī
10646,耿直,7,,2,1,3,ㄍㄥˇ ㄓˊ,gěng zhí
10647,拱,7,,4,3,7,ㄍㄨㄥˇ,gǒng
10648,功不可沒,7,,2,1,3,ㄍㄨㄥ ㄅㄨˋ ㄎㄜˇ ㄇㄛˋ,gōng bù kě mò
10649,功成名就,7,,2,1,3,ㄍㄨㄥ ㄔㄥˊ ㄇㄧㄥˊ ㄐㄧㄡˋ,gōng chéng míng jiù
10650,公道,7,,6,4,10,ㄍㄨㄥ ㄉㄠˋ/ㄍㄨㄥ ˙ㄉㄠ,gōng dào/gōng dao
10651,功德,7,,6,14,20,ㄍㄨㄥ ㄉㄜˊ,gōng dé
10652,宮殿,7,,17,4,21,ㄍㄨㄥ ㄉㄧㄢˋ,gōng diàn
10653,功績,7,,6,1,7,ㄍㄨㄥ ㄐㄧ,gōng jī
10654,公家,7,,5,3,8,ㄍㄨㄥ ㄐㄧㄚ,gōng jiā 
10655,攻訐,7,,2,0,2,ㄍㄨㄥ ㄐㄧㄝˊ,gōng jié
10656,公爵,7,,10,2,12,ㄍㄨㄥ ㄐㄩㄝˊ,gōng jué
10657,攻克,7,,4,1,5,ㄍㄨㄥ ㄎㄜˋ,gōng kè
10658,功虧一簣,7,,2,1,3,ㄍㄨㄥ ㄎㄨㄟ ㄧ ㄎㄨㄟˋ,gōng kuī yī kuì
10659,公頃,7,,5,38,43,ㄍㄨㄥ ㄑㄧㄥˇ,gōng qǐng
10660,公使,7,,9,0,9,ㄍㄨㄥ ㄕˇ,gōng shǐ
10661,拱手,7,,7,2,9,ㄍㄨㄥˇ ㄕㄡˇ,gǒng shǒu
10662,宮廷,7,,27,5,32,ㄍㄨㄥ ㄊㄧㄥˊ,gōng tíng
10663,公文,7,,7,1,8,ㄍㄨㄥ ㄨㄣˊ,gōng wén
10664,功勳,7,,4,0,4,ㄍㄨㄥ ㄒㄩㄣ,gōng xūn
10665,供養,7,,5,9,14,ㄍㄨㄥˋ ㄧㄤˋ,gòng yàng
10666,公義,7,,3,1,4,ㄍㄨㄥ ㄧˋ,gōng yì
10667,公約,7,,4,20,24,ㄍㄨㄥ ㄩㄝ,gōng yuē
10668,公允,7,,3,0,3,ㄍㄨㄥ ㄩㄣˇ,gōng yǔn
10669,攻佔,7,,5,1,6,ㄍㄨㄥ ㄓㄢˋ,gōng zhàn
10670,工整,7,,3,2,5,ㄍㄨㄥ ㄓㄥˇ,gōng zhěng
10671,公諸於世,7,,2,0,2,ㄍㄨㄥ ㄓㄨ ㄩˊ ㄕˋ,gōng zhū yú shì
10672,鉤,7,,4,2,6,ㄍㄡ,gōu
10673,勾當,7,,5,0,5,ㄍㄡˋ ㄉㄤˋ,gòu dàng
10674,夠格,7,,2,0,2,ㄍㄡˋ ㄍㄜˊ,gòu gé
10675,勾勒,7,,2,2,4,ㄍㄡ ㄌㄜˋ,gōu lè
10676,苟且,7,,2,0,2,ㄍㄡˇ ㄑㄧㄝˇ,gǒu qiě
10677,苟同,7,,2,1,3,ㄍㄡˇ ㄊㄨㄥˊ,gǒu tóng
10678,苟延殘喘,7,,2,1,3,ㄍㄡˇ ㄧㄢˊ ㄘㄢˊ ㄔㄨㄢˇ,gǒu yán cán chuǎn
10679,勾引,7,,3,2,5,ㄍㄡ ㄧㄣˇ,gōu yǐn
10680,購置,7,,3,2,5,ㄍㄡˋ ㄓˋ,gòu zhì
10681,顧不得,7,,6,2,8,ㄍㄨˋ ㄅㄨˋ ˙ㄉㄜ,gù bù de
10682,孤島,7,,4,2,6,ㄍㄨ ㄉㄠˇ,gū dǎo
10683,古董,7,,6,3,9,ㄍㄨˇ ㄉㄨㄥˇ,gǔ dǒng
10684,孤兒院,7,,5,4,9,ㄍㄨ ㄦˊ ㄩㄢˋ,gū ér yuàn
10685,骨幹,7,,5,0,5,ㄍㄨˇ ㄍㄢˋ,gǔ gàn
10686,蠱惑,7,,2,1,3,ㄍㄨˇ ㄏㄨㄛˋ,gǔ huò
10687,古籍,7,,6,4,10,ㄍㄨˇ ㄐㄧˊ,gǔ jí
10688,孤寂,7,,7,4,11,ㄍㄨ ㄐㄧˊ,gū jí
10689,骨架,7,,4,3,7,ㄍㄨˇ ㄐㄧㄚˋ,gǔ jià
10690,孤軍,7,,6,8,14,ㄍㄨ ㄐㄩㄣ,gū jūn
10691,孤苦,7,,2,2,4,ㄍㄨ ㄎㄨˇ,gū kǔ
10692,估量,7,,3,1,4,ㄍㄨ ㄌㄧㄤˋ,gū liàng
10693,孤零零,7,,4,1,5,ㄍㄨ ㄌㄧㄥˊ ㄌㄧㄥˊ,gū líng líng
10694,顧名思義,7,,4,7,11,ㄍㄨˋ ㄇㄧㄥˊ ㄙ ㄧˋ,gù míng sī yì
10695,孤僻,7,,4,1,5,ㄍㄨ ㄆㄧˋ,gū pì
10696,骨氣,7,,4,1,5,ㄍㄨˇ ㄑㄧˋ,gǔ qì
10697,故人,7,,3,1,4,ㄍㄨˋ ㄖㄣˊ,gù rén
10698,孤身,7,,3,1,4,ㄍㄨ ㄕㄣ,gū shēn
10699,固守,7,,6,1,7,ㄍㄨˋ ㄕㄡˇ,gù shǒu
10700,骨瘦如柴,7,,3,1,4,ㄍㄨˇ ㄕㄡˋ ㄖㄨˊ ㄔㄞˊ,gǔ shòu rú chái
10701,骨髓,7,,7,6,13,ㄍㄨˇ ㄙㄨㄟˇ,gǔ suǐ
10702,雇員,7,,3,2,5,ㄍㄨˋ ㄩㄢˊ,gù yuán
10703,骨折,7,,7,11,18,ㄍㄨˇ ㄓㄜˊ,gǔ zhé
10704,鼓足,7,,2,1,3,ㄍㄨˇㄗㄨˊ,gǔ zú
10705,瓜分,7,,4,2,6,ㄍㄨㄚ ㄈㄣ,guā fēn
10706,瓜葛,7,,3,1,4,ㄍㄨㄚ ㄍㄜˊ,guā gé
10707,刮目相看,7,,4,1,5,ㄍㄨㄚ ㄇㄨˋ ㄒㄧㄤ ㄎㄢˋ,guā mù xiāng kàn
10708,掛念,7,,3,5,8,ㄍㄨㄚˋ ㄋㄧㄢˋ,guà niàn
10709,掛帥,7,,3,1,4,ㄍㄨㄚˋ ㄕㄨㄞˋ,guà shuài
10710,怪誕,7,,3,0,3,ㄍㄨㄞˋ ㄉㄢˋ,guài dàn
10711,怪胎,7,,3,0,3,ㄍㄨㄞˋ ㄊㄞ,guài tāi
10712,拐彎抹角,7,,2,0,2,ㄍㄨㄞˇ ㄨㄢ ㄇㄛˋ ㄐㄧㄠˇ,guǎi wān mò jiǎo
10713,冠,7,,8,8,16,ㄍㄨㄢˋ,guàn
10714,慣,7,,6,4,10,ㄍㄨㄢˋ,guàn
10715,觀測,7,,7,26,33,ㄍㄨㄢ ㄘㄜˋ,guān cè
10716,貫穿,7,,6,5,11,ㄍㄨㄢˋ ㄔㄨㄢ,guàn chuān
10717,官邸,7,,3,2,5,ㄍㄨㄢ ㄉㄧˇ,guān dǐ
10718,官府,7,,13,1,14,ㄍㄨㄢ ㄈㄨˇ,guān fǔ
10719,灌溉,7,,7,42,49,ㄍㄨㄢˋ ㄍㄞˋ,guàn gài
10720,關乎,7,,4,3,7,ㄍㄨㄢ ㄏㄨ,guān hū
10721,關鍵點,7,,3,2,5,ㄍㄨㄢ ㄐㄧㄢˋㄉㄧㄢˇ,guān jiàn diǎn
10722,關鍵字,7,,3,3,6,ㄍㄨㄢ ㄐㄧㄢˋㄗˋ,guān jiàn zì
10723,關節炎,7,,7,2,9,ㄍㄨㄢ ㄐㄧㄝˊ ㄧㄢˊ,guān jié yán
10724,官吏,7,,15,0,15,ㄍㄨㄢ ㄌㄧˋ,guān lì
10725,冠冕堂皇,7,,3,1,4,ㄍㄨㄢ ㄇㄧㄢˇ ㄊㄤˊ ㄏㄨㄤˊ,guān miǎn táng huáng
10726,觀摩,7,,3,6,9,ㄍㄨㄢ ㄇㄛˊ,guān mó
10727,灌木,7,,4,2,6,ㄍㄨㄢˋ ㄇㄨˋ,guàn mù
10728,灌木叢,7,,5,1,6,ㄍㄨㄢˋ ㄇㄨˋ ㄘㄨㄥˊ,guàn mù cóng
10729,官能,7,,6,1,7,ㄍㄨㄢ ㄋㄥˊ,guān néng
10730,灌輸,7,,7,6,13,ㄍㄨㄢˋ ㄕㄨ,guàn shū
10731,管束,7,,3,1,4,ㄍㄨㄢˇ ㄕㄨˋ,guǎn shù
10732,關稅,7,,4,3,7,ㄍㄨㄢ ㄕㄨㄟˋ,guān shuì
10733,貫通,7,,2,1,3,ㄍㄨㄢˋ ㄊㄨㄥ,guàn tōng
10734,管線,7,,3,8,11,ㄍㄨㄢˇ ㄒㄧㄢˋ,guǎn xiàn
10735,慣性,7,,6,3,9,ㄍㄨㄢˋ ㄒㄧㄥˋ,guàn xìng
10736,慣於,7,,3,0,3,ㄍㄨㄢˋ ㄩˊ,guàn yú
10737,觀照,7,,6,2,8,ㄍㄨㄢ ㄓㄠˋ,guān zhào
10738,觀眾席,7,,4,2,6,ㄍㄨㄢ ㄓㄨㄥˋㄒㄧˊ,guān zhòng xí
10739,廣博,7,,3,1,4,ㄍㄨㄤˇ ㄅㄛˊ,guǎng bó
10740,光采,7,,3,1,4,ㄍㄨㄤ ㄘㄞˇ,guāng cǎi
10741,光碟,7,,5,2,7,ㄍㄨㄤ ㄉㄧㄝˊ,guāng dié
10742,光復,7,,4,6,10,ㄍㄨㄤ ㄈㄨˋ,guāng fù
10743,光環,7,,6,2,8,ㄍㄨㄤ ㄏㄨㄢˊ,guāng huán
10744,光景,7,,6,2,8,ㄍㄨㄤ ㄐㄧㄥˇ,guāng jǐng
10745,光明正大,7,,3,1,4,ㄍㄨㄤ ㄇㄧㄥˊ ㄓㄥˋ ㄉㄚˋ,guāng míng zhèng dà
10746,光譜,7,,5,2,7,ㄍㄨㄤ ㄆㄨˇ,guāng pǔ
10747,光天化日,7,,2,1,3,ㄍㄨㄤ ㄊㄧㄢ ㄏㄨㄚˋ ㄖˋ,guāng tiān huà rì
10748,光頭,7,,4,4,8,ㄍㄨㄤ ㄊㄡˊ,guāng tóu
10749,光禿禿,7,,4,4,8,ㄍㄨㄤ ㄊㄨ ㄊㄨ,guāng tū tū
10750,光鮮,7,,3,3,6,ㄍㄨㄤ ㄒㄧㄢ,guāng xiān
10751,光影,7,,4,5,9,ㄍㄨㄤ ㄧㄥˇ,guāng yǐng
10752,光澤,7,,5,2,7,ㄍㄨㄤ ㄗㄜˊ,guāng zé
10753,跪拜,7,,4,2,6,ㄍㄨㄟˋ ㄅㄞˋ,guì bài
10754,規避,7,,3,1,4,ㄍㄨㄟ ㄅㄧˋ,guī bì
10755,貴妃,7,,17,0,17,ㄍㄨㄟˋ ㄈㄟ,guì fēi
10756,桂冠,7,,3,2,5,ㄍㄨㄟˋ ㄍㄨㄢ,guì guān
10757,鬼鬼祟祟,7,,3,1,4,ㄍㄨㄟˇ ㄍㄨㄟˇ ㄙㄨㄟˋ ㄙㄨㄟˋ,guǐ guǐ suì suì
10758,鬼話,7,,4,1,5,ㄍㄨㄟˇ ㄏㄨㄚˋ,guǐ huà
10759,鬼魂,7,,6,0,6,ㄍㄨㄟˇ ㄏㄨㄣˊ,guǐ hún
10760,鬼混,7,,3,1,4,ㄍㄨㄟˇ ㄏㄨㄣˋ,guǐ hùn
10761,歸咎,7,,3,1,4,ㄍㄨㄟ ㄐㄧㄡˋ,guī jiù
10762,詭譎,7,,3,1,4,ㄍㄨㄟˇ ㄐㄩㄝˊ,guǐ jué
10763,瑰麗,7,,2,2,4,ㄍㄨㄟ ㄌㄧˋ,guī lì
10764,鬼魅,7,,3,0,3,ㄍㄨㄟˇ ㄇㄟˋ,guǐ mèi
10765,圭臬,7,,2,1,3,ㄍㄨㄟ ㄋㄧㄝˋ,guī niè
10766,規勸,7,,4,1,5,ㄍㄨㄟ ㄑㄩㄢˋ,guī quàn
10767,貴人,7,,7,5,12,ㄍㄨㄟˋ ㄖㄣˊ,guì rén
10768,歸屬,7,,6,4,10,ㄍㄨㄟ ㄕㄨˇ,guī shǔ
10769,歸宿,7,,4,3,7,ㄍㄨㄟ ㄙㄨˋ,guī sù
10770,歸途,7,,3,1,4,ㄍㄨㄟ ㄊㄨˊ,guī tú
10771,鮭魚,7,,4,13,17,ㄍㄨㄟ ㄩˊ,guī yú
10772,規章,7,,5,2,7,ㄍㄨㄟ ㄓㄤ,guī zhāng
10773,棍棒,7,,3,3,6,ㄍㄨㄣˋ ㄅㄤˋ,gùn bàng
10774,滾燙,7,,3,1,4,ㄍㄨㄣˇ ㄊㄤˋ,gǔn tàng
10775,國父,7,,4,8,12,ㄍㄨㄛˊ ㄈㄨˋ,guó fù
10776,過火,7,,3,1,4,ㄍㄨㄛˋ ㄏㄨㄛˇ,guò huǒ
10777,國界,7,,4,20,24,ㄍㄨㄛˊ ㄐㄧㄝˋ,guó jiè
10778,過節,7,,7,5,12,ㄍㄨㄛˋ ㄐㄧㄝˊ,guò jié
10779,果決,7,,3,1,4,ㄍㄨㄛˇ ㄐㄩㄝˊ,guǒ jué
10780,國君,7,,19,1,20,ㄍㄨㄛˊ ㄐㄩㄣ,guó jūn
10781,過客,7,,3,1,4,ㄍㄨㄛˋ ㄎㄜˋ,guò kè
10782,國庫,7,,5,3,8,ㄍㄨㄛˊ ㄎㄨˋ,guó kù
10783,過路財神,7,,0,0,0,ㄍㄨㄛˋ ㄌㄨˋ ㄘㄞˊ ㄕㄣˊ,guò lù cái shén
10784,過目,7,,4,1,5,ㄍㄨㄛˋ ㄇㄨˋ,guò mù
10785,國情,7,,3,2,5,ㄍㄨㄛˊ ㄑㄧㄥˊ,guó qíng
10786,過意不去,7,,3,0,3,ㄍㄨㄛˋ ㄧˋ ㄅㄨˊ ㄑㄩˋ,guò yì bú qù
10787,裹足不前,7,,2,1,3,ㄍㄨㄛˇ ㄗㄨˊ ㄅㄨˋ ㄑㄧㄢˊ,guǒ zú bù qián
10788,海岸線,7,,3,27,30,ㄏㄞˇ ㄢˋ ㄒㄧㄢˋ,hǎi àn xiàn
10789,海濱,7,,5,2,7,ㄏㄞˇ ㄅㄧㄣ,hǎi bīn
10790,駭人,7,,5,1,6,ㄏㄞˋ ㄖㄣˊ,hài rén
10791,駭人聽聞,7,,3,2,5,ㄏㄞˋ ㄖㄣˊ ㄊㄧㄥ ㄨㄣˊ,hài rén tīng wén
10792,孩提,7,,4,0,4,ㄏㄞˊ ㄊㄧˊ,hái tí
10793,海嘯,7,,5,100,105,ㄏㄞˇ ㄒㄧㄠˋ,hǎi xiào
10794,海域,7,,7,31,38,ㄏㄞˇ ㄩˋ,hǎi yù
10795,孩子氣,7,,4,1,5,ㄏㄞˊ ˙ㄗ ㄑㄧˋ,hái zi qì
10796,漢代,7,,6,7,13,ㄏㄢˋ ㄉㄞˋ,hàn dài
10797,撼動,7,,5,3,8,ㄏㄢˋ ㄉㄨㄥˋ,hàn dòng
10798,喊話,7,,2,3,5,ㄏㄢˇ ㄏㄨㄚˋ,hǎn huà
10799,含淚,7,,4,1,5,ㄏㄢˊ ㄌㄟˋ,hán lèi
10800,汗流浹背,7,,5,1,6,ㄏㄢˋ ㄌㄧㄡˊ ㄐㄧㄚˊ ㄅㄟˋ,hàn liú jiá bèi
10801,寒氣,7,,4,2,6,ㄏㄢˊ ㄑㄧˋ,hán qì
10802,鼾聲,7,,3,0,3,ㄏㄢ ㄕㄥ,hān shēng
10803,漢文,7,,9,1,10,ㄏㄢˋ ㄨㄣˊ,hàn wén
10804,含笑,7,,4,1,5,ㄏㄢˊ ㄒㄧㄠˋ,hán xiào
10805,寒心,7,,2,0,2,ㄏㄢˊ ㄒㄧㄣ,hán xīn
10806,含蓄,7,,5,1,6,ㄏㄢˊ ㄒㄩˋ,hán xù
10807,寒暄,7,,6,1,7,ㄏㄢˊ ㄒㄩㄢ,hán xuān
10808,涵養,7,,3,10,13,ㄏㄢˊ ㄧㄤˇ,hán yǎng
10809,寒意,7,,3,3,6,ㄏㄢˊ ㄧˋ,hán yì
10810,涵義,7,,7,3,10,ㄏㄢˊ ㄧˋ,hán yì
10811,寒顫,7,,3,1,4,ㄏㄢˊ ㄓㄢˋ,hán zhàn
10812,汗珠,7,,4,1,5,ㄏㄢˋ ㄓㄨ,hàn zhū
10813,漢子,7,,8,1,9,ㄏㄢˋ ˙ㄗ,hàn zi
10814,行家,7,,3,1,4,ㄏㄤˊ ㄐㄧㄚ,háng jiā
10815,航線,7,,4,4,8,ㄏㄤˊ ㄒㄧㄢˋ,háng xiàn
10816,毫,7,,4,3,7,ㄏㄠˊ,háo
10817,號2,7,,73,295,368,ㄏㄠˊ,háo
10818,浩大,7,,5,5,10,ㄏㄠˋ ㄉㄚˋ,hào dà
10819,好歹,7,,4,1,5,ㄏㄠˇ ㄉㄞˇ,hǎo dǎi
10820,好端端,7,,2,1,3,ㄏㄠˇ ㄉㄨㄢ ㄉㄨㄢ,hǎo duān duān
10821,浩瀚,7,,5,3,8,ㄏㄠˋ ㄏㄢˋ,hào hàn
10822,浩浩蕩蕩,7,,4,3,7,ㄏㄠˋ ㄏㄠˋ ㄉㄤˋ ㄉㄤˋ,hào hào dàng dàng
10823,號角,7,,3,1,4,ㄏㄠˋ ㄐㄧㄠˇ,hào jiǎo
10824,浩劫,7,,4,7,11,ㄏㄠˋ ㄐㄧㄝˊ,hào jié
10825,號令,7,,5,1,6,ㄏㄠˋ ㄌㄧㄥˋ,hào lìng
10826,豪邁,7,,4,2,6,ㄏㄠˊ ㄇㄞˋ,háo mài
10827,豪門,7,,3,1,4,ㄏㄠˊ ㄇㄣˊ,háo mén
10828,豪氣,7,,5,1,6,ㄏㄠˊ ㄑㄧˋ,háo qì
10829,好色,7,,4,1,5,ㄏㄠˋ ㄙㄜˋ,hào sè
10830,好生,7,,4,1,5,ㄏㄠˇ ㄕㄥ,hǎo shēng
10831,好受,7,,4,1,5,ㄏㄠˇ ㄕㄡˋ,hǎo shòu
10832,豪爽,7,,3,1,4,ㄏㄠˊ ㄕㄨㄤˇ,háo shuǎng
10833,好說,7,,4,2,6,ㄏㄠˇ ㄕㄨㄛ,hǎo shuō
10834,耗損,7,,3,3,6,ㄏㄠˋ ㄙㄨㄣˇ,hào sǔn
10835,嚎啕大哭,7,,3,2,5,ㄏㄠˊ ㄊㄠˊ ㄉㄚˋ ㄎㄨ,háo táo dà kū
10836,好逸惡勞,7,,2,1,3,ㄏㄠˋ ㄧˋ ㄨˋ ㄌㄠˊ,hào yì wù láo
10837,荷,7,,5,5,10,ㄏㄜˊ,hé
10838,鶴,7,,9,2,11,ㄏㄜˋ,hè
10839,和藹,7,,6,1,7,ㄏㄜˊ ㄞˇ,hé ǎi
10840,和藹可親,7,,4,0,4,ㄏㄜˊ ㄞˇ ㄎㄜˇ ㄑㄧㄣ,hé ǎi kě qīn
10841,喝采,7,,6,1,7,ㄏㄜˋ ㄘㄞˇ,hè cǎi
10842,合唱,7,,4,2,6,ㄏㄜˊ ㄔㄤˋ,hé chàng
10843,河道,7,,4,16,20,ㄏㄜˊ ㄉㄠˋ,hé dào
10844,核定,7,,2,1,3,ㄏㄜˊ ㄉㄧㄥˋ,hé dìng
10845,核對,7,,4,2,6,ㄏㄜˊ ㄉㄨㄟˋ,hé duì
10846,合而為一,7,,5,1,6,ㄏㄜˊ ㄦˊ ㄨㄟˊ ㄧ,hé ér wéi yī
10847,何妨,7,,4,1,5,ㄏㄜˊ ㄈㄤˊ,hé fáng
10848,何故,7,,4,0,4,ㄏㄜˊ ㄍㄨˋ,hé gù
10849,河谷,7,,6,8,14,ㄏㄜˊ ㄍㄨˇ,hé gǔ
10850,赫赫,7,,4,1,5,ㄏㄜˋ ㄏㄜˋ,hè hè
10851,赫赫有名,7,,3,2,5,ㄏㄜˋ ㄏㄜˋ ㄧㄡˇ ㄇㄧㄥˊ,hè hè yǒu míng
10852,和緩,7,,4,2,6,ㄏㄜˊ ㄏㄨㄢˇ,hé huǎn
10853,何苦,7,,3,0,3,ㄏㄜˊ ㄎㄨˇ,hé kǔ
10854,和樂,7,,3,5,8,ㄏㄜˊ ㄌㄜˋ,hé lè
10855,何其,7,,7,3,10,ㄏㄜˊ ㄑㄧˊ,hé qí
10856,何去何從,7,,3,3,6,ㄏㄜˊ ㄑㄩˋ ㄏㄜˊ ㄘㄨㄥˊ,hé qù hé cóng
10857,赫然,7,,7,1,8,ㄏㄜˋ ㄖㄢˊ,hè rán
10858,合身,7,,3,1,4,ㄏㄜˊ ㄕㄣ,hé shēn
10859,合十,7,,4,7,11,ㄏㄜˊ ㄕˊ,hé shí
10860,核桃,7,,4,3,7,ㄏㄜˊ ㄊㄠˊ,hé táo
10861,和顏悅色,7,,2,1,3,ㄏㄜˊ ㄧㄢˊ ㄩㄝˋ ㄙㄜˋ,hé yán yuè sè
10862,核准,7,,4,2,6,ㄏㄜˊ ㄓㄨㄣˇ,hé zhǔn
10863,黑漆漆,7,,2,3,5,ㄏㄟ ㄑㄧ ㄑㄧ,hēi qī qī
10864,黑手,7,,2,3,5,ㄏㄟ ㄕㄡˇ,hēi shǒu
10865,狠毒,7,,4,0,4,ㄏㄣˇ ㄉㄨˊ,hěn dú
10866,狠心,7,,5,1,6,ㄏㄣˇ ㄒㄧㄣ,hěn xīn
10867,橫衝直撞,7,,2,1,3,ㄏㄥˊ ㄔㄨㄥ ㄓˊ ㄓㄨㄤˋ,héng chōng zhí zhuàng
10868,橫掃,7,,4,6,10,ㄏㄥˊ ㄙㄠˇ,héng sǎo
10869,橫生,7,,3,0,3,ㄏㄥˊ ㄕㄥ,héng shēng
10870,虹,7,,5,2,7,ㄏㄨㄥˊ,hóng
10871,紅塵,7,,3,2,5,ㄏㄨㄥˊ ㄔㄣˊ,hóng chén
10872,宏大,7,,4,1,5,ㄏㄨㄥˊ ㄉㄚˋ,hóng dà
10873,轟動一時,7,,3,1,4,ㄏㄨㄥ ㄉㄨㄥˋㄧˋ ㄕˊ,hōng dòng yì shí
10874,鴻溝,7,,6,2,8,ㄏㄨㄥˊ ㄍㄡ,hóng gōu
10875,轟轟烈烈,7,,4,2,6,ㄏㄨㄥ ㄏㄨㄥ ㄌㄧㄝˋ ㄌㄧㄝˋ,hōng hōng liè liè
10876,宏亮,7,,2,0,2,ㄏㄨㄥˊ ㄌㄧㄤˋ,hóng liàng
10877,洪流,7,,6,5,11,ㄏㄨㄥˊ ㄌㄧㄡˊ,hóng liú
10878,轟隆隆,7,,3,1,4,ㄏㄨㄥ ㄌㄨㄥˊㄌㄨㄥˊ,hōng lónglóng
10879,哄騙,7,,2,0,2,ㄏㄨㄥˇ ㄆㄧㄢˋ,hǒng piàn
10880,轟然,7,,3,1,4,ㄏㄨㄥ ㄖㄢˊ,hōng rán
10881,紅潤,7,,4,1,5,ㄏㄨㄥˊ ㄖㄨㄣˋ,hóng rùn
10882,哄堂大笑,7,,2,1,3,ㄏㄨㄥ ㄊㄤˊ ㄉㄚˋ ㄒㄧㄠˋ,hōng táng dà xiào
10883,宏偉,7,,5,2,7,ㄏㄨㄥˊ ㄨㄟˇ,hóng wěi
10884,紅暈,7,,3,0,3,ㄏㄨㄥˊ ㄩㄣˋ,hóng yùn
10885,後輩,7,,2,2,4,ㄏㄡˋ ㄅㄟˋ,hòu bèi
10886,候補,7,,4,1,5,ㄏㄡˋ ㄅㄨˇ,hòu bǔ
10887,後塵,7,,2,2,4,ㄏㄡˋ ㄔㄣˊ,hòu chén
10888,厚道,7,,4,1,5,ㄏㄡˋ ㄉㄠˋ,hòu dào
10889,後盾,7,,6,7,13,ㄏㄡˋ ㄉㄨㄣˋ,hòu dùn
10890,後宮,7,,12,1,13,ㄏㄡˋ ㄍㄨㄥ,hòu gōng
10891,後患,7,,3,1,4,ㄏㄡˋ ㄏㄨㄢˋ,hòu huàn
10892,後記,7,,5,1,6,ㄏㄡˋ ㄐㄧˋ,hòu jì
10893,後勤,7,,4,2,6,ㄏㄡˋ ㄑㄧㄣˊ,hòu qín
10894,後生,7,,11,1,12,ㄏㄡˋ ㄕㄥ,hòu shēng
10895,吼聲,7,,3,0,3,ㄏㄡˇ ㄕㄥ,hǒu shēng
10896,厚實,7,,4,3,7,ㄏㄡˋ ˙ㄕ,hòu shi
10897,後事,7,,4,2,6,ㄏㄡˋ ㄕˋ,hòu shì
10898,喉頭,7,,3,0,3,ㄏㄡˊ ㄊㄡˊ,hóu tóu
10899,厚顏,7,,2,0,2,ㄏㄡˋ ㄧㄢˊ,hòu yán
10900,後裔,7,,9,10,19,ㄏㄡˋ ㄧˋ,hòu yì
10901,唬,7,,3,0,3,ㄏㄨˇ,hǔ
10902,湖泊,7,,5,15,20,ㄏㄨˊ ㄅㄛˊ,hú bó
10903,胡扯,7,,4,1,5,ㄏㄨˊ ㄔㄜˇ,hú chě
10904,互惠,7,,3,2,5,ㄏㄨˋ ㄏㄨㄟˋ,hù huì
10905,呼救,7,,3,1,4,ㄏㄨ ㄐㄧㄡˋ,hū jiù
10906,餬口,7,,3,3,6,ㄏㄨˊ ㄎㄡˇ,hú kǒu
10907,葫蘆,7,,20,5,25,ㄏㄨˊ ˙ㄌㄨ,hú lu
10908,護身符,7,,3,3,6,ㄏㄨˋ ㄕㄣ ㄈㄨˊ,hù shēn fú
10909,虎視眈眈,7,,3,1,4,ㄏㄨˇ ㄕˋ ㄉㄢ ㄉㄢ,hǔ shì dān dān
10910,護送,7,,7,3,10,ㄏㄨˋ ㄙㄨㄥˋ,hù sòng
10911,互通,7,,3,2,5,ㄏㄨˋ ㄊㄨㄥ,hù tōng
10912,護衛,7,,7,2,9,ㄏㄨˋ ㄨㄟˋ,hù wèi
10913,互信,7,,4,6,10,ㄏㄨˋ ㄒㄧㄣˋ,hù xìn
10914,胡言亂語,7,,4,0,4,ㄏㄨˊ ㄧㄢˊ ㄌㄨㄢˋ ㄩˇ,hú yán luàn yǔ
10915,狐疑,7,,7,1,8,ㄏㄨˊ ㄧˊ,hú yí
10916,胡作非為,7,,3,1,4,ㄏㄨˊ ㄗㄨㄛˋ ㄈㄟ ㄨㄟˊ,hú zuò fēi wéi
10917,花白,7,,3,1,4,ㄏㄨㄚ ㄅㄞˊ,huā bái
10918,畫筆,7,,4,5,9,ㄏㄨㄚˋㄅㄧˇ,huà bǐ
10919,花叢,7,,3,1,4,ㄏㄨㄚ ㄘㄨㄥˊ,huā cóng
10920,華貴,7,,3,1,4,ㄏㄨㄚˊ ㄍㄨㄟˋ,huá guì
10921,花花公子,7,,5,0,5,ㄏㄨㄚ ㄏㄨㄚ ㄍㄨㄥ ㄗˇ,huā huā gōng zǐ
10922,花卉,7,,3,7,10,ㄏㄨㄚ ㄏㄨㄟˋ,huā huì
10923,畫龍點睛,7,,2,1,3,ㄏㄨㄚˋ ㄌㄨㄥˊ ㄉㄧㄢˇ ㄐㄧㄥ,huà lóng diǎn jīng
10924,譁然,7,,3,2,5,ㄏㄨㄚˊ ㄖㄢˊ,huá rán
10925,花色,7,,2,2,4,ㄏㄨㄚ ㄙㄜˋ,huā sè
10926,劃時代,7,,4,2,6,ㄏㄨㄚˋ ㄕˊ ㄉㄞˋ,huà shí dài
10927,化為烏有,7,,2,1,3,ㄏㄨㄚˋ ㄨㄟˊ ㄨ ㄧㄡˇ,huà wéi wū yǒu
10928,滑行,7,,3,1,4,ㄏㄨㄚˊ ㄒㄧㄥˊ,huá xíng
10929,花言巧語,7,,2,3,5,ㄏㄨㄚ ㄧㄢˊ ㄑㄧㄠˇ ㄩˇ,huā yán qiǎo yǔ
10930,花招,7,,5,2,7,ㄏㄨㄚ ㄓㄠ,huā zhāo
10931,化作/化做,7,,8,4,12,ㄏㄨㄚˋ ㄗㄨㄛˋ,huà zuò
10932,懷恨,7,,4,1,5,ㄏㄨㄞˊ ㄏㄣˋ,huái hèn
10933,懷舊,7,,4,2,6,ㄏㄨㄞˊ ㄐㄧㄡˋ,huái jiù
10934,環抱,7,,4,2,6,ㄏㄨㄢˊ ㄅㄠˋ,huán bào
10935,緩步,7,,3,1,4,ㄏㄨㄢˇ ㄅㄨˋ,huǎn bù
10936,幻燈片,7,,4,2,6,ㄏㄨㄢˋ ㄉㄥ ㄆㄧㄢˋ,huàn dēng piàn
10937,煥發,7,,3,1,4,ㄏㄨㄢˋ ㄈㄚ,huàn fā
10938,宦官,7,,18,1,19,ㄏㄨㄢˋ ㄍㄨㄢ,huàn guān
10939,環環相扣,7,,3,4,7,ㄏㄨㄢˊ ㄏㄨㄢˊ ㄒㄧㄤ ㄎㄡˋ,huán huán xiāng kòu
10940,歡快,7,,3,0,3,ㄏㄨㄢ ㄎㄨㄞˋ,huān kuài
10941,幻滅,7,,3,1,4,ㄏㄨㄢˋ ㄇㄧㄝˋ,huàn miè
10942,患難,7,,4,2,6,ㄏㄨㄢˋ ㄋㄢˋ,huàn nàn
10943,煥然一新,7,,3,2,5,ㄏㄨㄢˋ ㄖㄢˊ ㄧ ㄒㄧㄣ,huàn rán yī xīn
10944,渙散,7,,4,1,5,ㄏㄨㄢˋ ㄙㄢˋ,huàn sàn
10945,環視,7,,5,0,5,ㄏㄨㄢˊ ㄕˋ,huán shì
10946,歡欣,7,,4,1,5,ㄏㄨㄢ ㄒㄧㄣ,huān xīn
10947,歡欣鼓舞,7,,2,2,4,ㄏㄨㄢ ㄒㄧㄣ ㄍㄨˇ ㄨˇ,huān xīn gǔ wǔ
10948,豢養,7,,3,1,4,ㄏㄨㄢˋ ㄧㄤˇ,huàn yǎng
10949,幻影,7,,6,1,7,ㄏㄨㄢˋ ㄧㄥˇ,huàn yǐng
10950,歡愉,7,,4,2,6,ㄏㄨㄢ ㄩˊ,huān yú
10951,還原,7,,4,6,10,ㄏㄨㄢˊ ㄩㄢˊ,huán yuán
10952,荒誕,7,,5,1,6,ㄏㄨㄤ ㄉㄢˋ,huāng dàn
10953,荒地,7,,3,4,7,ㄏㄨㄤ ㄉㄧˋ,huāng dì
10954,黃豆,7,,5,27,32,ㄏㄨㄤˊ ㄉㄡˋ,huáng dòu
10955,皇宮,7,,21,4,25,ㄏㄨㄤˊ ㄍㄨㄥ,huáng gōng
10956,黃瓜,7,,4,5,9,ㄏㄨㄤˊ ㄍㄨㄚ,huáng guā
10957,皇冠,7,,3,1,4,ㄏㄨㄤˊ ㄍㄨㄢ,huáng guān
10958,皇家,7,,21,10,31,ㄏㄨㄤˊ ㄐㄧㄚ,huáng jiā
10959,惶恐,7,,7,3,10,ㄏㄨㄤˊ ㄎㄨㄥˇ,huáng kǒng
10960,遑論,7,,5,2,7,ㄏㄨㄤˊ ㄌㄨㄣˋ,huáng lùn
10961,荒山,7,,3,2,5,ㄏㄨㄤ ㄕㄢ,huāng shān
10962,皇上,7,,81,5,86,ㄏㄨㄤˊ ㄕㄤˋ,huáng shang
10963,皇室,7,,14,22,36,ㄏㄨㄤˊ ㄕˋ,huáng shì
10964,皇太后,7,,37,1,38,ㄏㄨㄤˊ ㄊㄞˋ ㄏㄡˋ,huáng tài hòu
10965,荒蕪,7,,5,5,10,ㄏㄨㄤ ㄨˊ,huāng wú
10966,晦暗,7,,2,1,3,ㄏㄨㄟˋ ㄢˋ,huì àn
10967,彙編,7,,4,0,4,ㄏㄨㄟˋ ㄅㄧㄢ,huì biān
10968,迴盪,7,,6,4,10,ㄏㄨㄟˊ ㄉㄤˋ,huí dàng
10969,悔改,7,,2,4,6,ㄏㄨㄟˇ ㄍㄞˇ,huǐ gǎi
10970,悔恨,7,,7,1,8,ㄏㄨㄟˇ ㄏㄣˋ,huǐ hèn
10971,毀壞,7,,4,4,8,ㄏㄨㄟˇ ㄏㄨㄞˋ,huǐ huài
10972,揮霍,7,,4,2,6,ㄏㄨㄟ ㄏㄨㄛˋ,huī huò
10973,匯集,7,,5,7,12,ㄏㄨㄟˋ ㄐㄧˊ,huì jí
10974,會見,7,,7,3,10,ㄏㄨㄟˋ ㄐㄧㄢˋ,huì jiàn
10975,灰燼,7,,6,8,14,ㄏㄨㄟ ㄐㄧㄣˋ,huī jìn
10976,回敬,7,,3,1,4,ㄏㄨㄟˊ ㄐㄧㄥˋ,huí jìng
10977,回絕,7,,4,1,5,ㄏㄨㄟˊ ㄐㄩㄝˊ,huí jué
10978,匯票,7,,1,0,1,ㄏㄨㄟˋ ㄆㄧㄠˋ,huì piào
10979,揮灑,7,,4,4,8,ㄏㄨㄟ ㄙㄚˇ,huī sǎ
10980,回聲,7,,3,1,4,ㄏㄨㄟˊ ㄕㄥ,huí shēng
10981,回溯,7,,5,5,10,ㄏㄨㄟˊ ㄙㄨˋ,huí sù
10982,毀損,7,,2,7,9,ㄏㄨㄟˇ ㄙㄨㄣˇ,huǐ sǔn
10983,會同,7,,3,1,4,ㄏㄨㄟˋ ㄊㄨㄥˊ,huì tóng
10984,麾下,7,,4,0,4,ㄏㄨㄟ ㄒㄧㄚˋ,huī xià
10985,迴響/回響,7,,10,10,20,ㄏㄨㄟˊ ㄒㄧㄤˇ ,huí xiǎng 
10986,詼諧,7,,4,2,6,ㄏㄨㄟ ㄒㄧㄝˊ,huī xié
10987,會心,7,,4,1,5,ㄏㄨㄟˋ ㄒㄧㄣ,huì xīn
10988,迴旋,7,,4,2,6,ㄏㄨㄟˊ ㄒㄩㄢˊ,huí xuán
10989,慧眼,7,,4,1,5,ㄏㄨㄟˋ ㄧㄢˇ,huì yǎn
10990,輝映,7,,2,2,4,ㄏㄨㄟ ㄧㄥˋ,huī yìng
10991,毀於一旦,7,,0,0,0,ㄏㄨㄟˇ ㄩˊ ㄧ ㄉㄢˋ,huǐ yú yī dàn
10992,揮之不去,7,,6,3,9,ㄏㄨㄟ ㄓ ㄅㄨˋ ㄑㄩˋ,huī zhī bù qù
10993,迴路,7,,15,4,19,ㄏㄨㄟˊㄌㄨˋ,huílù
10994,混沌,7,,6,2,8,ㄏㄨㄣˋ ㄉㄨㄣˋ,hùn dùn
10995,魂魄,7,,3,1,4,ㄏㄨㄣˊ ㄆㄛˋ,hún pò
10996,渾然,7,,6,1,7,ㄏㄨㄣˊ ㄖㄢˊ,hún rán
10997,混入,7,,3,1,4,ㄏㄨㄣˋ ㄖㄨˋ,hùn rù
10998,渾身解數,7,,2,0,2,ㄏㄨㄣˊ ㄕㄣ ㄐㄧㄝˇ ㄕㄨˋ,hún shēn jiě shù
10999,昏睡,7,,3,1,4,ㄏㄨㄣ ㄕㄨㄟˋ,hūn shuì
11000,婚約,7,,4,0,4,ㄏㄨㄣ ㄩㄝ,hūn yuē
11001,混濁,7,,4,5,9,ㄏㄨㄣˋ ㄓㄨㄛˊ,hùn zhuó 
11002,活蹦亂跳,7,,2,2,4,ㄏㄨㄛˊ ㄅㄥˋ ㄌㄨㄢˋ ㄊㄧㄠˋ,huó bèng luàn tiào
11003,火柴,7,,6,4,10,ㄏㄨㄛˇ ㄔㄞˊ,huǒ chái
11004,豁達,7,,4,6,10,ㄏㄨㄛˋ ㄉㄚˊ,huò dá
11005,禍福,7,,4,2,6,ㄏㄨㄛˋ ㄈㄨˊ,huò fú
11006,禍害,7,,4,1,5,ㄏㄨㄛˋ ㄏㄞˋ,huò hai
11007,火紅,7,,3,2,5,ㄏㄨㄛˇ ㄏㄨㄥˊ,huǒ hóng
11008,夥計/伙計,7,,9,2,11,ㄏㄨㄛˇ ㄐㄧˋ,huǒ jì
11009,活靈活現,7,,2,1,3,ㄏㄨㄛˊ ㄌㄧㄥˊ ㄏㄨㄛˊ ㄒㄧㄢˋ,huó líng huó xiàn
11010,活路,7,,4,1,5,ㄏㄨㄛˊ ㄌㄨˋ,huó lù
11011,火爐,7,,7,6,13,ㄏㄨㄛˇ ㄌㄨˊ,huǒ lú
11012,火冒三丈,7,,4,1,5,ㄏㄨㄛˇ ㄇㄠˋ ㄙㄢ ㄓㄤˋ,huǒ mào sān zhàng
11013,豁然開朗,7,,3,2,5,ㄏㄨㄛˋ ㄖㄢˊ ㄎㄞ ㄌㄤˇ,huò rán kāi lǎng
11014,火熱,7,,3,1,4,ㄏㄨㄛˇ ㄖㄜˋ,huǒ rè
11015,貨色,7,,2,0,2,ㄏㄨㄛˋ ㄙㄜˋ,huò sè
11016,伙食,7,,2,1,3,ㄏㄨㄛˇ ˙ㄕ,huǒ shi
11017,火勢,7,,3,8,11,ㄏㄨㄛˇ ㄕˋ,huǒ shì
11018,火速,7,,4,1,5,ㄏㄨㄛˇ ㄙㄨˋ,huǒ sù
11019,獲悉,7,,3,1,4,ㄏㄨㄛˋ ㄒㄧ,huò xī
11020,火星,7,,11,39,50,ㄏㄨㄛˇ ㄒㄧㄥ,huǒ xīng
11021,火藥,7,,5,9,14,ㄏㄨㄛˇ ㄧㄠˋ,huǒ yào
11022,獲益,7,,7,1,8,ㄏㄨㄛˋ ㄧˋ,huò yì
11023,獲益良多,7,,0,0,0,ㄏㄨㄛˋ ㄧˋ ㄌㄧㄤˊ ㄉㄨㄛ,huò yì liáng duō
11024,激昂,7,,6,2,8,ㄐㄧ ㄤˊ,jī áng
11025,羈絆,7,,3,1,4,ㄐㄧ ㄅㄢˋ,jī bàn
11026,計策,7,,4,1,5,ㄐㄧˋ ㄘㄜˋ,jì cè
11027,積存,7,,4,1,5,ㄐㄧ ㄘㄨㄣˊ,jī cún
11028,集大成,7,,2,1,3,ㄐㄧˊ ㄉㄚˋ ㄔㄥˊ,jí dà chéng
11029,既得利益,7,,4,0,4,ㄐㄧˋ ㄉㄜˊ ㄌㄧˋ ㄧˋ,jì dé lì yì
11030,基調,7,,4,1,5,ㄐㄧ ㄉㄧㄠˋ,jī diào
11031,悸動,7,,3,3,6,ㄐㄧˋ ㄉㄨㄥˋ,jì dòng
11032,機動,7,,4,3,7,ㄐㄧ ㄉㄨㄥˋ,jī dòng
11033,嫉惡如仇,7,,1,0,1,ㄐㄧˊ ㄜˋ ㄖㄨˊ ㄔㄡˊ,jí è rú chóu
11034,激憤,7,,3,0,3,ㄐㄧ ㄈㄣˋ,jī fèn
11035,譏諷,7,,5,1,6,ㄐㄧ ㄈㄥˋ,jī fèng
11036,急功近利,7,,2,1,3,ㄐㄧˊ ㄍㄨㄥ ㄐㄧㄣˋ ㄌㄧˋ,jí gōng jìn lì
11037,機關槍,7,,3,1,4,ㄐㄧ ㄍㄨㄢ ㄑㄧㄤ,jī guān qiāng
11038,饑荒,7,,5,13,18,ㄐㄧ ㄏㄨㄤ,jī huāng
11039,岌岌可危,7,,3,5,8,ㄐㄧˊ ㄐㄧˊ ㄎㄜˇ ㄨㄟˊ,jí jí kě wéi
11040,機警,7,,4,1,5,ㄐㄧ ㄐㄧㄥˇ,jī jǐng
11041,急劇,7,,4,1,5,ㄐㄧˊ ㄐㄩˋ,jí jù
11042,急遽,7,,4,4,8,ㄐㄧˊ ㄐㄩˋ,jí jù
11043,寄居,7,,3,2,5,ㄐㄧˋ ㄐㄩ,jì jū
11044,飢渴,7,,4,1,5,ㄐㄧ ㄎㄜˇ,jī kě
11045,疾苦,7,,3,2,5,ㄐㄧˊ ㄎㄨˇ,jí kǔ
11046,擊垮,7,,3,1,4,ㄐㄧˊ ㄎㄨㄚˇ,jí kuǎ
11047,擊潰,7,,5,0,5,ㄐㄧˊ ㄎㄨㄟˋ,jí kuì
11048,伎倆,7,,5,1,6,ㄐㄧˋ ㄌㄧㄤˇ,jì liǎng
11049,計量,7,,4,1,5,ㄐㄧˋ ㄌㄧㄤˊ/ㄐㄧˋ ㄌㄧㄤˋ,jì liáng/jì liàng
11050,機靈,7,,6,1,7,ㄐㄧ ㄌㄧㄥˊ,jī líng
11051,雞毛蒜皮,7,,2,0,2,ㄐㄧ ㄇㄠˊ ㄙㄨㄢˋ ㄆㄧˊ,jī máo suàn pí
11052,機敏,7,,4,0,4,ㄐㄧ ㄇㄧㄣˇ,jī mǐn
11053,積木,7,,7,7,14,ㄐㄧ ㄇㄨˋ,jī mù
11054,雞皮疙瘩,7,,2,3,5,ㄐㄧ ㄆㄧˊ ㄍㄜ ˙ㄉㄚ,jī pí gē da
11055,急迫,7,,4,3,7,ㄐㄧˊ ㄆㄛˋ,jí pò
11056,擊破,7,,4,1,5,ㄐㄧˊ ㄆㄛˋ,jí pò
11057,記取,7,,3,4,7,ㄐㄧˋ ㄑㄩˇ,jì qǔ
11058,極權,7,,3,1,4,ㄐㄧˊ ㄑㄩㄢˊ,jí quán
11059,激賞,7,,4,1,5,ㄐㄧ ㄕㄤˇ,jī shǎng
11060,躋身,7,,3,1,4,ㄐㄧ ㄕㄣ,jī shēn
11061,寄生,7,,4,2,6,ㄐㄧˋ ㄕㄥ,jì shēng
11062,寄生蟲,7,,3,4,7,ㄐㄧˋ ㄕㄥ ㄔㄨㄥˊ,jì shēng chóng
11063,計數,7,,5,1,6,ㄐㄧˋㄕㄨˇ,jì shǔ
11064,奇數,7,,2,0,2,ㄐㄧ ㄕㄨˋ,jī shù
11065,積水,7,,4,17,21,ㄐㄧ ㄕㄨㄟˇ,jī shuǐ
11066,激素,7,,8,24,32,ㄐㄧ ㄙㄨˋ,jī sù
11067,擊退,7,,5,1,6,ㄐㄧˊ ㄊㄨㄟˋ,jí tuì
11068,寄望,7,,4,3,7,ㄐㄧˋ ㄨㄤˋ,jì wàng
11069,雞尾酒,7,,4,2,6,ㄐㄧ ㄨㄟˇ ㄐㄧㄡˇ,jī wěi jiǔ
11070,吉祥,7,,6,7,13,ㄐㄧˊ ㄒㄧㄤˊ,jí xiáng
11071,即興,7,,6,2,8,ㄐㄧˊ ㄒㄧㄥˋ,jí xìng
11072,記性,7,,3,2,5,ㄐㄧˋ ㄒㄧㄥˋ,jì xìng
11073,積雪,7,,6,6,12,ㄐㄧ ㄒㄩㄝˇ,jī xuě
11074,積壓,7,,3,1,4,ㄐㄧ ㄧㄚ,jī yā
11075,記憶猶新,7,,3,4,7,ㄐㄧˋ ㄧˋ ㄧㄡˊ ㄒㄧㄣ,jì yì yóu xīn
11076,覬覦,7,,5,2,7,ㄐㄧˋ ㄩˊ,jì yú
11077,際遇,7,,6,4,10,ㄐㄧˋ ㄩˋ,jì yù
11078,寄予,7,,3,2,5,ㄐㄧˋ ㄩˇ,jì yǔ
11079,機遇,7,,3,1,4,ㄐㄧ ㄩˋ,jī yù
11080,紀元,7,,6,1,7,ㄐㄧˋ ㄩㄢˊ,jì yuán
11081,激增,7,,3,4,7,ㄐㄧ ㄗㄥ,jī zēng
11082,激戰,7,,5,2,7,ㄐㄧ ㄓㄢˋ,jī zhàn
11083,急轉直下,7,,3,0,3,ㄐㄧˊ ㄓㄨㄢˇ ㄓˊ ㄒㄧㄚˋ,jí zhuǎn zhí xià
11084,基準,7,,6,5,11,ㄐㄧ ㄓㄨㄣˇ,jī zhǔn
11085,假扮,7,,2,0,2,ㄐㄧㄚˇ ㄅㄢˋ,jiǎ bàn
11086,家常,7,,3,1,4,ㄐㄧㄚ ㄔㄤˊ,jiā cháng
11087,家常便飯,7,,3,4,7,ㄐㄧㄚ ㄔㄤˊ ㄅㄧㄢˋ ㄈㄢˋ,jiā cháng biàn fàn
11088,家畜,7,,4,4,8,ㄐㄧㄚ ㄔㄨˋ,jiā chù
11089,夾帶,7,,3,4,7,ㄐㄧㄚˊ ㄉㄞˋ,jiá dài
11090,夾攻,7,,3,0,3,ㄐㄧㄚˊ ㄍㄨㄥ,jiá gōng
11091,加害,7,,7,2,9,ㄐㄧㄚ ㄏㄞˋ,jiā hài
11092,佳話,7,,3,1,4,ㄐㄧㄚ ㄏㄨㄚˋ,jiā huà
11093,夾擊,7,,4,1,5,ㄐㄧㄚˊ ㄐㄧˊ,jiá jí
11094,家計,7,,3,2,5,ㄐㄧㄚ ㄐㄧˋ,jiā jì
11095,假借,7,,3,2,5,ㄐㄧㄚˇ ㄐㄧㄝˋ,jiǎ jiè
11096,家居,7,,4,0,4,ㄐㄧㄚ ㄐㄩ,jiā jū
11097,假冒,7,,3,1,4,ㄐㄧㄚˇ ㄇㄠˋ,jiǎ mào
11098,家門,7,,22,12,34,ㄐㄧㄚ ㄇㄣˊ,jiā mén
11099,假名,7,,3,1,4,ㄐㄧㄚˇ ㄇㄧㄥˊ,jiǎ míng
11100,家破人亡,7,,2,2,4,ㄐㄧㄚ ㄆㄛˋ ㄖㄣˊ ㄨㄤˊ,jiā pò rén wáng
11101,駕輕就熟,7,,2,1,3,ㄐㄧㄚˋ ㄑㄧㄥ ㄐㄧㄡˋ ㄕㄡˊ,jià qīng jiù shóu
11102,佳人,7,,4,1,5,ㄐㄧㄚ ㄖㄣˊ,jiā rén
11103,架勢,7,,3,1,4,ㄐㄧㄚˋ ㄕˋ,jià shì
11104,假說,7,,5,1,6,ㄐㄧㄚˇㄕㄨㄛ,jiǎ shuō
11105,枷鎖,7,,4,3,7,ㄐㄧㄚ ㄙㄨㄛˇ,jiā suǒ
11106,家徒四壁,7,,0,0,0,ㄐㄧㄚ ㄊㄨˊ ㄙˋ ㄅㄧˋ,jiā tú sì bì
11107,價位,7,,4,4,8,ㄐㄧㄚˋ ㄨㄟˋ,jià wèi
11108,家務事,7,,4,1,5,ㄐㄧㄚ ㄨˋ ㄕˋ,jiā wù shì
11109,加薪,7,,5,2,7,ㄐㄧㄚ ㄒㄧㄣ,jiā xīn
11110,嘉許,7,,2,0,2,ㄐㄧㄚ ㄒㄩˇ,jiā xǔ
11111,佳餚,7,,4,4,8,ㄐㄧㄚ ㄧㄠˊ,jiā yáo
11112,家業,7,,5,2,7,ㄐㄧㄚ ㄧㄝˋ,jiā yè
11113,假意,7,,3,1,4,ㄐㄧㄚˇ ㄧˋ,jiǎ yì
11114,加油添醋,7,,2,1,3,ㄐㄧㄚ ㄧㄡˊ ㄊㄧㄢ ㄘㄨˋ,jiā yóu tiān cù
11115,家喻戶曉,7,,5,2,7,ㄐㄧㄚ ㄩˋ ㄏㄨˋ ㄒㄧㄠˇ,jiā yù hù xiǎo
11116,駕照,7,,3,3,6,ㄐㄧㄚˋ ㄓㄠˋ,jià zhào
11117,佳作,7,,4,1,5,ㄐㄧㄚ ㄗㄨㄛˋ,jiā zuò
11118,濺,7,,5,1,6,ㄐㄧㄢˋ,jiàn
11119,鑑,7,,3,3,6,ㄐㄧㄢˋ,jiàn
11120,鹼,7,,6,21,27,ㄐㄧㄢˇ,jiǎn
11121,剪報,7,,3,1,4,ㄐㄧㄢˇ ㄅㄠˋ,jiǎn bào
11122,兼備,7,,3,2,5,ㄐㄧㄢ ㄅㄟˋ,jiān bèi
11123,箭步,7,,3,0,3,ㄐㄧㄢˋ ㄅㄨˋ,jiàn bù
11124,見不得人,7,,2,1,3,ㄐㄧㄢˋ ㄅㄨˋ ㄉㄜˊ ㄖㄣˊ,jiàn bù dé rén
11125,剪裁,7,,4,2,6,ㄐㄧㄢˇ ㄘㄞˊ,jiǎn cái
11126,監察,7,,5,0,5,ㄐㄧㄢ ㄔㄚˊ,jiān chá
11127,兼差,7,,3,1,4,ㄐㄧㄢ ㄔㄞ,jiān chāi
11128,奸臣,7,,5,0,5,ㄐㄧㄢ ㄔㄣˊ,jiān chén
11129,兼程,7,,3,1,4,ㄐㄧㄢ ㄔㄥˊ,jiān chéng
11130,堅稱,7,,4,1,5,ㄐㄧㄢ ㄔㄥ,jiān chēng
11131,漸次,7,,3,1,4,ㄐㄧㄢˋ ㄘˋ,jiàn cì
11132,見地,7,,2,0,2,ㄐㄧㄢˋ ㄉㄧˋ,jiàn dì
11133,間斷,7,,6,9,15,ㄐㄧㄢˋ ㄉㄨㄢˋ,jiàn duàn
11134,艦隊,7,,11,5,16,ㄐㄧㄢˋ ㄉㄨㄟˋ,jiàn duì
11135,見怪不怪,7,,2,0,2,ㄐㄧㄢˋ ㄍㄨㄞˋ ㄅㄨˊ ㄍㄨㄞˋ,jiàn guài bú guài
11136,監護人,7,,3,1,4,ㄐㄧㄢ ㄏㄨˋ ㄖㄣˊ,jiān hù rén
11137,健將,7,,3,1,4,ㄐㄧㄢˋ ㄐㄧㄤˋ,jiàn jiàng
11138,監禁,7,,6,5,11,ㄐㄧㄢ ㄐㄧㄣˋ,jiān jìn
11139,檢舉,7,,4,2,6,ㄐㄧㄢˇ ㄐㄩˇ,jiǎn jǔ
11140,艱鉅,7,,4,4,8,ㄐㄧㄢ ㄐㄩˋ,jiān jù
11141,監牢,7,,3,1,4,ㄐㄧㄢ ㄌㄠˊ,jiān láo
11142,簡略,7,,4,1,5,ㄐㄧㄢˇ ㄌㄩㄝˋ,jiǎn lüè
11143,殲滅,7,,8,2,10,ㄐㄧㄢ ㄇㄧㄝˋ,jiān miè
11144,簡明,7,,4,1,5,ㄐㄧㄢˇ ㄇㄧㄥˊ,jiǎn míng
11145,緘默,7,,4,1,5,ㄐㄧㄢ ㄇㄛˋ,jiān mò
11146,儉樸,7,,3,3,6,ㄐㄧㄢˇ ㄆㄨˊ,jiǎn pú
11147,簡樸,7,,6,11,17,ㄐㄧㄢˇ ㄆㄨˊ,jiǎn pú
11148,堅韌,7,,3,4,7,ㄐㄧㄢ ㄖㄣˋ,jiān rèn
11149,堅忍,7,,3,3,6,ㄐㄧㄢ ㄖㄣˇ,jiān rěn
11150,艱澀,7,,3,1,4,ㄐㄧㄢ ㄙㄜˋ,jiān sè
11151,鑑賞,7,,3,1,4,ㄐㄧㄢˋ ㄕㄤˇ,jiàn shǎng
11152,健身,7,,10,5,15,ㄐㄧㄢˋ ㄕㄣ,jiàn shēn
11153,撿拾,7,,4,7,11,ㄐㄧㄢˇ ㄕˊ,jiǎn shí
11154,堅實,7,,6,2,8,ㄐㄧㄢ ㄕˊ,jiān shí
11155,尖酸,7,,3,0,3,ㄐㄧㄢ ㄙㄨㄢ,jiān suān
11156,減損,7,,2,1,3,ㄐㄧㄢˇ ㄙㄨㄣˇ,jiǎn sǔn
11157,踐踏,7,,6,3,9,ㄐㄧㄢˋ ㄊㄚˋ,jiàn tà
11158,健忘,7,,4,2,6,ㄐㄧㄢˋ ㄨㄤˋ,jiàn wàng
11159,見效,7,,4,1,5,ㄐㄧㄢˋ ㄒㄧㄠˋ,jiàn xiào
11160,健行,7,,5,1,6,ㄐㄧㄢˋ ㄒㄧㄥˊ,jiàn xíng
11161,建言,7,,7,1,8,ㄐㄧㄢˋ ㄧㄢˊ,jiàn yán
11162,簡要,7,,4,1,5,ㄐㄧㄢˇ ㄧㄠˋ,jiǎn yào
11163,檢閱,7,,2,1,3,ㄐㄧㄢˇ ㄩㄝˋ,jiǎn yuè
11164,健在,7,,3,2,5,ㄐㄧㄢˋ ㄗㄞˋ,jiàn zài
11165,奸詐,7,,3,1,4,ㄐㄧㄢ ㄓㄚˋ,jiān zhà
11166,健壯,7,,7,2,9,ㄐㄧㄢˋ ㄓㄨㄤˋ,jiàn zhuàng
11167,強2,7,,141,158,299,ㄐㄧㄤˋ,jiàng
11168,江河日下,7,,1,0,1,ㄐㄧㄤ ㄏㄜˊ ㄖˋ ㄒㄧㄚˋ,jiāng hé rì xià
11169,疆界,7,,3,4,7,ㄐㄧㄤ ㄐㄧㄝˋ,jiāng jiè
11170,將士,7,,13,2,15,ㄐㄧㄤˋ ㄕˋ,jiàng shì
11171,講授,7,,4,1,5,ㄐㄧㄤˇ ㄕㄡˋ,jiǎng shòu
11172,江水,7,,5,1,6,ㄐㄧㄤ ㄕㄨㄟˇ,jiāng shuǐ
11173,疆土,7,,3,1,4,ㄐㄧㄤ ㄊㄨˇ,jiāng tǔ
11174,疆域,7,,5,2,7,ㄐㄧㄤ ㄩˋ,jiāng yù
11175,獎章,7,,4,2,6,ㄐㄧㄤˇ ㄓㄤ,jiǎng zhāng
11176,獎狀,7,,3,7,10,ㄐㄧㄤˇ ㄓㄨㄤˋ,jiǎng zhuàng
11177,嬌,7,,3,3,6,ㄐㄧㄠ,jiāo
11178,交保,7,,1,1,2,ㄐㄧㄠ ㄅㄠˇ,jiāo bǎo
11179,腳本,7,,5,1,6,ㄐㄧㄠˇ ㄅㄣˇ,jiǎo běn
11180,交差,7,,2,1,3,ㄐㄧㄠ ㄔㄞ,jiāo chāi
11181,交疊,7,,4,1,5,ㄐㄧㄠ ㄉㄧㄝˊ,jiāo dié
11182,校對,7,,3,1,4,ㄐㄧㄠˋ ㄉㄨㄟˋ,jiào duì
11183,交鋒,7,,5,2,7,ㄐㄧㄠ ㄈㄥ,jiāo fēng
11184,教父,7,,4,2,6,ㄐㄧㄠˋ ㄈㄨˋ,jiào fù
11185,教化,7,,7,6,13,ㄐㄧㄠˋ ㄏㄨㄚˋ,jiào huà
11186,叫喚,7,,3,0,3,ㄐㄧㄠˋ ㄏㄨㄢˋ,jiào huàn
11187,交會,7,,7,9,16,ㄐㄧㄠ ㄏㄨㄟˋ,jiāo huì
11188,攪和,7,,2,2,4,ㄐㄧㄠˇ ㄏㄨㄛˋ,jiǎo huò
11189,交加,7,,5,1,6,ㄐㄧㄠ ㄐㄧㄚ,jiāo jiā
11190,矯健,7,,2,1,3,ㄐㄧㄠˇ ㄐㄧㄢˋ,jiǎo jiàn
11191,繳交,7,,3,4,7,ㄐㄧㄠˇ ㄐㄧㄠ,jiǎo jiāo
11192,交界,7,,4,13,17,ㄐㄧㄠ ㄐㄧㄝˋ,jiāo jiè
11193,絞盡腦汁,7,,4,3,7,ㄐㄧㄠˇ ㄐㄧㄣˋ ㄋㄠˇ ㄓ,jiǎo jìn nǎo zhī
11194,焦距,7,,2,3,5,ㄐㄧㄠ ㄐㄩˋ,jiāo jù
11195,角力,7,,5,5,10,ㄐㄧㄠˇ ㄌㄧˋ  ,jiǎo lì  
11196,較量,7,,5,1,6,ㄐㄧㄠˋ ㄌㄧㄤˋ,jiào liàng
11197,繳納,7,,4,1,5,ㄐㄧㄠˇ ㄋㄚˋ,jiǎo nà
11198,交配,7,,6,8,14,ㄐㄧㄠ ㄆㄟˋ,jiāo pèi
11199,交融,7,,4,3,7,ㄐㄧㄠ ㄖㄨㄥˊ,jiāo róng
11200,教士,7,,7,1,8,ㄐㄧㄠˋ ㄕˋ,jiào shì
11201,腳踏實地,7,,6,3,9,ㄐㄧㄠˇ ㄊㄚˋ ㄕˊ ㄉㄧˋ,jiǎo tà shí dì
11202,叫囂,7,,3,2,5,ㄐㄧㄠˋ ㄒㄧㄠ,jiào xiāo
11203,郊遊,7,,3,3,6,ㄐㄧㄠ ㄧㄡˊ,jiāo yóu
11204,狡詐,7,,4,0,4,ㄐㄧㄠˇ ㄓㄚˋ,jiǎo zhà
11205,腳掌,7,,13,2,15,ㄐㄧㄠˇ ㄓㄤˇ,jiǎo zhǎng
11206,教主,7,,6,1,7,ㄐㄧㄠˋ ㄓㄨˇ,jiào zhǔ
11207,膠著,7,,2,2,4,ㄐㄧㄠ ㄓㄨㄛˊ,jiāo zhuó
11208,叫座,7,,3,0,3,ㄐㄧㄠˋ ㄗㄨㄛˋ,jiào zuò
11209,介,7,,4,3,7,ㄐㄧㄝˋ,jiè
11210,結案,7,,3,1,4,ㄐㄧㄝˊ ㄢˋ,jié àn
11211,結伴,7,,5,3,8,ㄐㄧㄝˊ ㄅㄢˋ,jié bàn
11212,戒備,7,,6,7,13,ㄐㄧㄝˋ ㄅㄟˋ,jiè bèi
11213,揭穿,7,,3,0,3,ㄐㄧㄝ ㄔㄨㄢ,jiē chuān
11214,皆大歡喜,7,,2,1,3,ㄐㄧㄝ ㄉㄚˋ ㄏㄨㄢ ㄒㄧˇ,jiē dà huān xǐ
11215,借貸,7,,3,5,8,ㄐㄧㄝˋ ㄉㄞˋ,jiè dài
11216,芥蒂,7,,2,1,3,ㄐㄧㄝˋ ㄉㄧˋ,jiè dì
11217,截斷,7,,4,1,5,ㄐㄧㄝˊ ㄉㄨㄢˋ,jié duàn
11218,街坊,7,,4,2,6,ㄐㄧㄝ ㄈㄤ,jiē fāng
11219,接縫,7,,1,2,3,ㄐㄧㄝ ㄈㄥˋ,jiē fèng
11220,藉故,7,,2,1,3,ㄐㄧㄝˋ ㄍㄨˋ,jiè gù
11221,解雇,7,,5,1,6,ㄐㄧㄝˇ ㄍㄨˋ,jiě gù
11222,節骨眼,7,,3,2,5,ㄐㄧㄝˊ ˙ㄍㄨ ㄧㄢˇ,jié gu yǎn
11223,接管,7,,7,5,12,ㄐㄧㄝ ㄍㄨㄢˇ,jiē guǎn
11224,接軌,7,,3,6,9,ㄐㄧㄝ ㄍㄨㄟˇ,jiē guǐ
11225,解惑,7,,2,1,3,ㄐㄧㄝˇ ㄏㄨㄛˋ,jiě huò
11226,接濟,7,,3,1,4,ㄐㄧㄝ ㄐㄧˋ,jiē jì
11227,竭盡,7,,7,2,9,ㄐㄧㄝˊ ㄐㄧㄣˋ,jié jìn
11228,借鏡,7,,4,6,10,ㄐㄧㄝˋ ㄐㄧㄥˋ,jiè jìng
11229,拮据,7,,3,4,7,ㄐㄧㄝˊ ㄐㄩ,jié jū
11230,接口,7,,3,0,3,ㄐㄧㄝ ㄎㄡˇ,jiē kǒu
11231,竭力,7,,11,1,12,ㄐㄧㄝˊ ㄌㄧˋ,jié lì
11232,戒律,7,,5,4,9,ㄐㄧㄝˋ ㄌㄩˋ,jiè lǜ
11233,睫毛,7,,4,1,5,ㄐㄧㄝˊ ㄇㄠˊ,jié máo
11234,節拍,7,,3,4,7,ㄐㄧㄝˊ ㄆㄞ,jié pāi
11235,解剖,7,,7,6,13,ㄐㄧㄝˇ ㄆㄡˇ,jiě pǒu
11236,接洽,7,,3,3,6,ㄐㄧㄝ ㄑㄧㄚˋ,jiē qià
11237,戒慎,7,,3,7,10,ㄐㄧㄝˋ ㄕㄣˋ,jiè shèn
11238,揭示,7,,6,1,7,ㄐㄧㄝ ㄕˋ,jiē shì
11239,借宿,7,,3,1,4,ㄐㄧㄝˋ ㄙㄨˋ,jiè sù
11240,接聽,7,,3,1,4,ㄐㄧㄝ ㄊㄧㄥ,jiē tīng
11241,解圍,7,,3,0,3,ㄐㄧㄝˇ ㄨㄟˊ,jiě wéi
11242,揭曉,7,,3,6,9,ㄐㄧㄝ ㄒㄧㄠˇ,jiē xiǎo
11243,接續,7,,4,5,9,ㄐㄧㄝ ㄒㄩˋ,jiē xù
11244,戒嚴,7,,4,2,6,ㄐㄧㄝˋ ㄧㄢˊ,jiè yán
11245,街友,7,,1,3,4,ㄐㄧㄝ ㄧㄡˇ,jiē yǒu
11246,結語,7,,5,1,6,ㄐㄧㄝˊ ㄩˇ,jié yǔ
11247,介於,7,,10,7,17,ㄐㄧㄝˋ ㄩˊ,jiè yú
11248,接掌,7,,3,2,5,ㄐㄧㄝ ㄓㄤˇ,jiē zhǎng
11249,借重,7,,4,2,6,ㄐㄧㄝˋ ㄓㄨㄥˋ,jiè zhòng
11250,接踵而來,7,,2,1,3,ㄐㄧㄝ ㄓㄨㄥˇ ㄦˊ ㄌㄞˊ,jiē zhǒng ér lái
11251,接踵而至,7,,2,1,3,ㄐㄧㄝ ㄓㄨㄥˇ ㄦˊ ㄓˋ,jiē zhǒng ér zhì
11252,借助,7,,6,6,12,ㄐㄧㄝˋ ㄓㄨˋ,jiè zhù
11253,藉助,7,,4,3,7,ㄐㄧㄝˋ ㄓㄨˋ,jiè zhù
11254,揭櫫,7,,2,0,2,ㄐㄧㄝ ㄓㄨ,jiē zhū
11255,謹,7,,9,2,11,ㄐㄧㄣˇ,jǐn
11256,進逼,7,,3,2,5,ㄐㄧㄣˋ ㄅㄧ,jìn bī
11257,金碧輝煌,7,,3,1,4,ㄐㄧㄣ ㄅㄧˋ ㄏㄨㄟ ㄏㄨㄤˊ,jīn bì huī huáng
11258,禁不起,7,,2,2,4,ㄐㄧㄣ ㄅㄨˋ ㄑㄧˇ,jīn bù qǐ
11259,進餐,7,,3,1,4,ㄐㄧㄣˋ ㄘㄢ,jìn cān
11260,進場,7,,5,4,9,ㄐㄧㄣˋ ㄔㄤˊ,jìn cháng
11261,晉朝,7,,3,1,4,ㄐㄧㄣˋ ㄔㄠˊ,jìn cháo
11262,矜持,7,,2,2,4,ㄐㄧㄣ ㄔˊ,jīn chí
11263,緊湊,7,,5,3,8,ㄐㄧㄣˇ ㄘㄡˋ,jǐn còu
11264,金剛,7,,12,5,17,ㄐㄧㄣ ㄍㄤ,jīn gāng
11265,禁錮,7,,5,1,6,ㄐㄧㄣˋ ㄍㄨˋ,jìn gù
11266,筋骨,7,,5,2,7,ㄐㄧㄣ ㄍㄨˇ,jīn gǔ
11267,金光閃閃,7,,0,0,0,ㄐㄧㄣ ㄍㄨㄤ ㄕㄢˇ ㄕㄢˇ,jīn guāng shǎn shǎn
11268,晉見,7,,4,1,5,ㄐㄧㄣˋ ㄐㄧㄢˋ,jìn jiàn
11269,近郊,7,,3,6,9,ㄐㄧㄣˋ ㄐㄧㄠ,jìn jiāo
11270,進階,7,,3,3,6,ㄐㄧㄣˋ ㄐㄧㄝ,jìn jiē
11271,緊接,7,,3,2,5,ㄐㄧㄣˇ ㄐㄧㄝ,jǐn jiē
11272,斤斤計較,7,,3,3,6,ㄐㄧㄣ ㄐㄧㄣ ㄐㄧˋ ㄐㄧㄠˋ,jīn jīn jì jiào
11273,津津樂道,7,,4,2,6,ㄐㄧㄣ ㄐㄧㄣ ㄌㄜˋ ㄉㄠˋ,jīn jīn lè dào
11274,緊鄰,7,,3,5,8,ㄐㄧㄣˇ ㄌㄧㄣˊ,jǐn lín
11275,禁令,7,,6,5,11,ㄐㄧㄣˋ ㄌㄧㄥˋ,jìn lìng
11276,筋疲力竭,7,,5,1,6,ㄐㄧㄣ ㄆㄧˊ ㄌㄧˋ ㄐㄧㄝˊ,jīn pí lì jié
11277,筋疲力盡,7,,5,0,5,ㄐㄧㄣ ㄆㄧˊ ㄌㄧˋ ㄐㄧㄣˋ,jīn pí lì jìn
11278,盡其所能,7,,2,1,3,ㄐㄧㄣˋ ㄑㄧˊ ㄙㄨㄛˇ ㄋㄥˊ,jìn qí suǒ néng
11279,近親,7,,4,3,7,ㄐㄧㄣˋ ㄑㄧㄣ,jìn qīn
11280,進取,7,,7,2,9,ㄐㄧㄣˋ ㄑㄩˇ,jìn qǔ
11281,錦上添花,7,,2,0,2,ㄐㄧㄣˇ ㄕㄤˋ ㄊㄧㄢ ㄏㄨㄚ,jǐn shàng tiān huā
11282,晉升,7,,6,1,7,ㄐㄧㄣˋ ㄕㄥ,jìn shēng
11283,進士,7,,11,1,12,ㄐㄧㄣˋ ㄕˋ,jìn shì
11284,盡失,7,,4,1,5,ㄐㄧㄣˋ ㄕ,jìn shī
11285,謹守,7,,3,2,5,ㄐㄧㄣˇ ㄕㄡˇ,jǐn shǒu
11286,緊縮,7,,4,8,12,ㄐㄧㄣˇ ㄙㄨㄛ,jǐn suō
11287,進退兩難,7,,3,1,4,ㄐㄧㄣˋ ㄊㄨㄟˋ ㄌㄧㄤˇ ㄋㄢˊ,jìn tuì liǎng nán
11288,盡興,7,,4,1,5,ㄐㄧㄣˋ ㄒㄧㄥˋ,jìn xìng
11289,浸淫,7,,4,1,5,ㄐㄧㄣˋ ㄧㄣˊ,jìn yín
11290,金銀財寶,7,,4,1,5,ㄐㄧㄣ ㄧㄣˊㄘㄞˊ ㄅㄠˇ,jīn yín cái bǎo
11291,近在咫尺,7,,3,2,5,ㄐㄧㄣˋ ㄗㄞˋ ㄓˇ ㄔˇ,jìn zài zhǐ chǐ
11292,盡責,7,,4,4,8,ㄐㄧㄣˋ ㄗㄜˊ,jìn zé
11293,緊張兮兮,7,,2,1,3,ㄐㄧㄣˇ ㄓㄤ ㄒㄧ ㄒㄧ,jǐn zhāng xī xī
11294,盡忠,7,,4,1,5,ㄐㄧㄣˋ ㄓㄨㄥ,jìn zhōng
11295,緊追不捨,7,,2,0,2,ㄐㄧㄣˇ ㄓㄨㄟ ㄅㄨˋ ㄕㄜˇ,jǐn zhuī bù shě
11296,莖,7,,6,16,22,ㄐㄧㄥ,jīng
11297,精兵,7,,5,1,6,ㄐㄧㄥ ㄅㄧㄥ,jīng bīng
11298,驚詫,7,,3,0,3,ㄐㄧㄥ ㄔㄚˋ,jīng chà
11299,警車,7,,4,4,8,ㄐㄧㄥˇ ㄔㄜ,jǐng chē
11300,京城,7,,34,2,36,ㄐㄧㄥ ㄔㄥˊ,jīng chéng
11301,境地,7,,7,0,7,ㄐㄧㄥˋ ㄉㄧˋ,jìng dì
11302,驚動,7,,7,2,9,ㄐㄧㄥ ㄉㄨㄥˋ,jīng dòng
11303,驚愕,7,,5,0,5,ㄐㄧㄥ ㄜˋ,jīng è
11304,精光,7,,5,1,6,ㄐㄧㄥ ㄍㄨㄤ,jīng guāng
11305,驚惶,7,,4,1,5,ㄐㄧㄥ ㄏㄨㄤˊ,jīng huáng
11306,驚慌失措,7,,5,3,8,ㄐㄧㄥ ㄏㄨㄤ ㄕ ㄘㄨㄛˋ,jīng huāng shī cuò
11307,驚魂,7,,3,2,5,ㄐㄧㄥ ㄏㄨㄣˊ,jīng hún
11308,荊棘,7,,5,1,6,ㄐㄧㄥ ㄐㄧˊ,jīng jí
11309,警戒,7,,7,13,20,ㄐㄧㄥˇ ㄐㄧㄝˋ,jǐng jiè
11310,兢兢業業,7,,3,3,6,ㄐㄧㄥ ㄐㄧㄥ ㄧㄝˋ ㄧㄝˋ,jīng jīng yè yè
11311,井井有條,7,,2,1,3,ㄐㄧㄥˇ ㄐㄧㄥˇ ㄧㄡˇ ㄊㄧㄠˊ,jǐng jǐng yǒu tiáo
11312,驚懼,7,,3,0,3,ㄐㄧㄥ ㄐㄩˋ,jīng jù
11313,驚覺,7,,4,2,6,ㄐㄧㄥ ㄐㄩㄝˊ,jīng jué
11314,境況,7,,3,0,3,ㄐㄧㄥˋ ㄎㄨㄤˋ,jìng kuàng
11315,景況,7,,4,5,9,ㄐㄧㄥˇ ㄎㄨㄤˋ,jǐng kuàng
11316,精良,7,,4,3,7,ㄐㄧㄥ ㄌㄧㄤˊ,jīng liáng
11317,精靈,7,,12,8,20,ㄐㄧㄥ ㄌㄧㄥˊ,jīng líng
11318,痙攣,7,,9,1,10,ㄐㄧㄥˋ ㄌㄨㄢˊ,jìng luán
11319,靜脈,7,,6,3,9,ㄐㄧㄥˋ ㄇㄞˋ,jìng mài
11320,靜謐,7,,4,3,7,ㄐㄧㄥˋ ㄇㄧˋ,jìng mì
11321,經年累月,7,,3,3,6,ㄐㄧㄥ ㄋㄧㄢˊ ㄌㄟˇ ㄩㄝˋ,jīng nián lěi yuè
11322,精闢,7,,4,2,6,ㄐㄧㄥ ㄆㄧˋ,jīng pì
11323,精疲力竭,7,,4,0,4,ㄐㄧㄥ ㄆㄧˊ ㄌㄧˋ ㄐㄧㄝˊ,jīng pí lì jié
11324,精疲力盡,7,,2,1,3,ㄐㄧㄥ ㄆㄧˊ ㄌㄧˋ ㄐㄧㄣˋ,jīng pí lì jìn
11325,晶片,7,,14,7,21,ㄐㄧㄥ ㄆㄧㄢˋ,jīng piàn
11326,精巧,7,,6,2,8,ㄐㄧㄥ ㄑㄧㄠˇ,jīng qiǎo
11327,井然有序,7,,4,2,6,ㄐㄧㄥˇ ㄖㄢˊ ㄧㄡˇ ㄒㄩˋ,jǐng rán yǒu xù
11328,精銳,7,,7,1,8,ㄐㄧㄥ ㄖㄨㄟˋ,jīng ruì
11329,經商,7,,7,5,12,ㄐㄧㄥ ㄕㄤ,jīng shāng
11330,精神抖擻,7,,3,1,4,ㄐㄧㄥ ㄕㄣˊ ㄉㄡˇ ㄙㄡˇ,jīng shén dǒu sǒu
11331,京師,7,,20,0,20,ㄐㄧㄥ ㄕ,jīng shī
11332,經書,7,,4,2,6,ㄐㄧㄥ ㄕㄨ,jīng shū
11333,井水,7,,3,1,4,ㄐㄧㄥˇ ㄕㄨㄟˇ,jǐng shuǐ
11334,驚濤駭浪,7,,3,1,4,ㄐㄧㄥ ㄊㄠˊ ㄏㄞˋ ㄌㄤˋ,jīng táo hài làng
11335,驚天動地,7,,4,1,5,ㄐㄧㄥ ㄊㄧㄢ ㄉㄨㄥˋ ㄉㄧˋ,jīng tiān dòng dì
11336,經文,7,,7,19,26,ㄐㄧㄥ ㄨㄣˊ,jīng wén
11337,競相,7,,4,2,6,ㄐㄧㄥˋ ㄒㄧㄤ,jìng xiāng
11338,驚心動魄,7,,4,2,6,ㄐㄧㄥ ㄒㄧㄣ ㄉㄨㄥˋ ㄆㄛˋ,jīng xīn dòng pò
11339,驚豔,7,,3,4,7,ㄐㄧㄥ ㄧㄢˋ,jīng yàn
11340,敬仰,7,,3,0,3,ㄐㄧㄥˋ ㄧㄤˇ,jìng yǎng
11341,景仰,7,,4,2,6,ㄐㄧㄥˇ ㄧㄤˇ,jǐng yǎng
11342,敬業,7,,4,1,5,ㄐㄧㄥˋ ㄧㄝˋ,jìng yè
11343,精益求精,7,,2,1,3,ㄐㄧㄥ ㄧˋ ㄑㄧㄡˊ ㄐㄧㄥ,jīng yì qiú jīng
11344,晶瑩,7,,4,1,5,ㄐㄧㄥ ㄧㄥˊ,jīng yíng
11345,境遇,7,,4,1,5,ㄐㄧㄥˋ ㄩˋ,jìng yù
11346,精於,7,,4,2,6,ㄐㄧㄥ ㄩˊ,jīng yú
11347,精湛,7,,4,4,8,ㄐㄧㄥ ㄓㄢˋ,jīng zhàn
11348,景致,7,,5,5,10,ㄐㄧㄥˇ ㄓˋ,jǐng zhì
11349,逕自,7,,6,0,6,ㄐㄧㄥˋ ㄗˋ,jìng zì
11350,驚呆,7,,3,0,3,ㄐㄧㄥ ㄉㄞ,jīngdāi
11351,窘,7,,3,0,3,ㄐㄩㄥˇ,jiǒng
11352,窘境,7,,6,8,14,ㄐㄩㄥˇ ㄐㄧㄥˋ,jiǒng jìng
11353,窘迫,7,,3,1,4,ㄐㄩㄥˇ ㄆㄛˋ,jiǒng pò
11354,迥然不同,7,,3,1,4,ㄐㄩㄥˇ ㄖㄢˊ ㄅㄨˋ ㄊㄨㄥˊ,jiǒng rán bù tóng
11355,迥異,7,,4,1,5,ㄐㄩㄥˇ ㄧˋ,jiǒng yì
11356,玖,7,,1,0,1,ㄐㄧㄡˇ,jiǔ
11357,揪,7,,4,1,5,ㄐㄧㄡ,jiū
11358,糾葛,7,,4,3,7,ㄐㄧㄡ ㄍㄜˊ,jiū gé
11359,救濟,7,,6,13,19,ㄐㄧㄡˋ ㄐㄧˋ,jiù jì
11360,糾結,7,,7,5,12,ㄐㄧㄡ ㄐㄧㄝˊ,jiū jié
11361,久留,7,,2,0,2,ㄐㄧㄡˇ ㄌㄧㄡˊ,jiǔ liú
11362,就寢,7,,7,1,8,ㄐㄧㄡˋ ㄑㄧㄣˇ,jiù qǐn
11363,就事論事,7,,2,1,3,ㄐㄧㄡˋ ㄕˋ ㄌㄨㄣˋ ㄕˋ,jiù shì lùn shì
11364,九霄雲外,7,,2,0,2,ㄐㄧㄡˇ ㄒㄧㄠ ㄩㄣˊ ㄨㄞˋ,jiǔ xiāo yún wài
11365,救星,7,,2,3,5,ㄐㄧㄡˋ ㄒㄧㄥ,jiù xīng
11366,就緒,7,,5,1,6,ㄐㄧㄡˋ ㄒㄩˋ,jiù xù
11367,極為,7,,59,7,66,ㄐㄧˊㄨㄟˊ,jíwéi
11368,菊,7,,5,11,16,ㄐㄩˊ,jú
11369,鉅,7,,5,3,8,ㄐㄩˋ,jù
11370,鋸,7,,3,11,14,ㄐㄩˋ,jù
11371,侷促,7,,2,1,3,ㄐㄩˊ ㄘㄨˋ,jú cù
11372,句點,7,,4,4,8,ㄐㄩˋ ㄉㄧㄢˇ,jù diǎn
11373,鉅額,7,,3,1,4,ㄐㄩˋ ㄜˊ,jù é
11374,舉凡,7,,5,4,9,ㄐㄩˇ ㄈㄢˊ,jǔ fán
11375,颶風,7,,6,11,17,ㄐㄩˋ ㄈㄥ,jù fēng
11376,居高臨下,7,,2,1,3,ㄐㄩ ㄍㄠ ㄌㄧㄣˊ ㄒㄧㄚˋ,jū gāo lín xià
11377,拘禁,7,,3,1,4,ㄐㄩ ㄐㄧㄣˋ,jū jìn
11378,拘謹,7,,5,1,6,ㄐㄩ ㄐㄧㄣˇ,jū jǐn
11379,聚精會神,7,,4,2,6,ㄐㄩˋ ㄐㄧㄥ ㄏㄨㄟˋ ㄕㄣˊ,jù jīng huì shén
11380,聚落,7,,10,18,28,ㄐㄩˋ ㄌㄨㄛˋ,jù luò
11381,舉目,7,,3,2,5,ㄐㄩˇ ㄇㄨˋ,jǔ mù
11382,拘泥,7,,4,1,5,ㄐㄩ ㄋㄧˋ,jū nì
11383,據實,7,,3,1,4,ㄐㄩˋ ㄕˊ,jù shí
11384,舉世聞名,7,,2,1,3,ㄐㄩˇ ㄕˋ ㄨㄣˊ ㄇㄧㄥˊ,jǔ shì wén míng
11385,局外人,7,,4,1,5,ㄐㄩˊ ㄨㄞˋ ㄖㄣˊ,jú wài rén
11386,據悉,7,,1,0,1,ㄐㄩˋ ㄒㄧ,jù xī
11387,鉅細靡遺,7,,4,2,6,ㄐㄩˋ ㄒㄧˋ ㄇㄧˇ ㄧˊ,jù xì mǐ yí
11388,居心,7,,4,0,4,ㄐㄩ ㄒㄧㄣ,jū xīn
11389,巨著,7,,3,0,3,ㄐㄩˋ ㄓㄨˋ,jù zhù
11390,圈2,7,,51,56,107,ㄐㄩㄢˋ,juàn
11391,倦怠,7,,5,2,7,ㄐㄩㄢˋ ㄉㄞˋ,juàn dài
11392,眷戀,7,,4,2,6,ㄐㄩㄢˋ ㄌㄧㄢˋ,juàn liàn
11393,眷屬,7,,3,5,8,ㄐㄩㄢˋ ㄕㄨˇ,juàn shǔ
11394,捐獻,7,,3,2,5,ㄐㄩㄢ ㄒㄧㄢˋ,juān xiàn
11395,絕頂,7,,7,1,8,ㄐㄩㄝˊ ㄉㄧㄥˇ,jué dǐng
11396,決鬥,7,,5,1,6,ㄐㄩㄝˊ ㄉㄡˋ,jué dòu
11397,絕技,7,,6,1,7,ㄐㄩㄝˊ ㄐㄧˋ,jué jì
11398,絕跡,7,,3,4,7,ㄐㄩㄝˊ ㄐㄧ,jué jī
11399,絕境,7,,4,1,5,ㄐㄩㄝˊ ㄐㄧㄥˋ,jué jìng
11400,決裂,7,,3,1,4,ㄐㄩㄝˊ ㄌㄧㄝˋ,jué liè
11401,絕倫,7,,5,1,6,ㄐㄩㄝˊ ㄌㄨㄣˊ,jué lún
11402,攫取,7,,2,0,2,ㄐㄩㄝˊ ㄑㄩˇ,jué qǔ
11403,決然,7,,3,5,8,ㄐㄩㄝˊ ㄖㄢˊ,jué rán
11404,絕少,7,,2,1,3,ㄐㄩㄝˊ ㄕㄠˇ,jué shǎo
11405,爵位,7,,6,0,6,ㄐㄩㄝˊ ㄨㄟˋ,jué wèi
11406,絕無僅有,7,,3,1,4,ㄐㄩㄝˊ ㄨˊ ㄐㄧㄣˇ ㄧㄡˇ,jué wú jǐn yǒu
11407,決意,7,,4,1,5,ㄐㄩㄝˊ ㄧˋ,jué yì
11408,絕招,7,,5,1,6,ㄐㄩㄝˊ ㄓㄠ,jué zhāo
11409,絕症,7,,3,3,6,ㄐㄩㄝˊ ㄓㄥˋ,jué zhèng
11410,軍備,7,,2,4,6,ㄐㄩㄣ ㄅㄟˋ,jūn bèi
11411,軍閥,7,,19,4,23,ㄐㄩㄣ ㄈㄚˊ,jūn fá
11412,軍法,7,,4,0,4,ㄐㄩㄣ ㄈㄚˇ,jūn fǎ
11413,軍艦,7,,7,6,13,ㄐㄩㄣ ㄐㄧㄢˋ,jūn jiàn
11414,駿馬,7,,7,0,7,ㄐㄩㄣˋ ㄇㄚˇ,jùn mǎ
11415,俊美,7,,3,0,3,ㄐㄩㄣˋ ㄇㄟˇ,jùn měi
11416,俊俏,7,,3,0,3,ㄐㄩㄣˋ ㄑㄧㄠˋ,jùn qiào
11417,軍士,7,,11,1,12,ㄐㄩㄣ ㄕˋ,jūn shì
11418,軍心,7,,4,1,5,ㄐㄩㄣ ㄒㄧㄣ,jūn xīn
11419,軍營,7,,7,3,10,ㄐㄩㄣ ㄧㄥˊ,jūn yíng
11420,軍政,7,,7,1,8,ㄐㄩㄣ ㄓㄥˋ,jūn zhèng
11421,據以,7,,3,0,3,ㄐㄩˋㄧˇ,jùyǐ
11422,開採,7,,3,13,16,ㄎㄞ ㄘㄞˇ,kāi cǎi
11423,開場白,7,,4,1,5,ㄎㄞ ㄔㄤˊ ㄅㄞˊ,kāi cháng bái
11424,開導,7,,3,2,5,ㄎㄞ ㄉㄠˇ,kāi dǎo
11425,開工,7,,3,6,9,ㄎㄞ ㄍㄨㄥ,kāi gōng
11426,開墾,7,,7,15,22,ㄎㄞ ㄎㄣˇ,kāi kěn
11427,開口,7,,67,22,89,ㄎㄞ ㄎㄡˇ,kāi kǒu
11428,開溜,7,,2,0,2,ㄎㄞ ㄌㄧㄡ,kāi liū
11429,開路,7,,4,1,5,ㄎㄞ ㄌㄨˋ ,kāi lù
11430,開門見山,7,,3,1,4,ㄎㄞ ㄇㄣˊ ㄐㄧㄢˋ ㄕㄢ,kāi mén jiàn shān
11431,楷模,7,,5,2,7,ㄎㄞˇ ㄇㄛˊ,kǎi mó
11432,開竅,7,,5,2,7,ㄎㄞ ㄑㄧㄠˋ,kāi qiào
11433,慨然,7,,2,0,2,ㄎㄞˇ ㄖㄢˊ,kǎi rán
11434,開通,7,,3,4,7,ㄎㄞ ㄊㄨㄥ ,kāi tōng 
11435,開脫,7,,3,0,3,ㄎㄞ ㄊㄨㄛ,kāi tuō
11436,開宗明義,7,,3,2,5,ㄎㄞ ㄗㄨㄥ ㄇㄧㄥˊ ㄧˋ,kāi zōng míng yì
11437,砍伐,7,,4,14,18,ㄎㄢˇ ㄈㄚ,kǎn fā
11438,看管,7,,4,1,5,ㄎㄢ ㄍㄨㄢˇ,kān guǎn
11439,侃侃而談,7,,4,3,7,ㄎㄢˇ ㄎㄢˇ ㄦˊ ㄊㄢˊ,kǎn kǎn ér tán
11440,坎坷,7,,5,5,10,ㄎㄢˇ ㄎㄜˇ,kǎn kě
11441,看準,7,,3,4,7,ㄎㄢˋ ㄓㄨㄣˇ,kàn zhǔn
11442,炕,7,,6,3,9,ㄎㄤˋ,kàng
11443,亢奮,7,,7,1,8,ㄎㄤˋ ㄈㄣˋ,kàng fèn
11444,抗衡,7,,7,5,12,ㄎㄤˋ ㄏㄥˊ,kàng héng
11445,抗生素,7,,9,7,16,ㄎㄤˋ ㄕㄥ ㄙㄨˋ,kàng shēng sù
11446,靠不住,7,,2,0,2,ㄎㄠˋ ㄅㄨˊ ㄓㄨˋ,kào bú zhù
11447,拷打,7,,3,0,3,ㄎㄠˇ ㄉㄚˇ,kǎo dǎ
11448,考古,7,,7,15,22,ㄎㄠˇ ㄍㄨˇ,kǎo gǔ
11449,考核,7,,7,1,8,ㄎㄠˇ ㄏㄜˊ,kǎo hé
11450,靠攏,7,,4,1,5,ㄎㄠˋ ㄌㄨㄥˇ,kào lǒng
11451,靠山,7,,4,3,7,(一)ㄎㄠˋ ㄕㄢ ,kào shān 
11452,犒賞,7,,3,3,6,ㄎㄠˋ ㄕㄤˇ,kào shǎng
11453,克敵,7,,3,1,4,ㄎㄜˋ ㄉㄧˊ,kè dí
11454,刻骨銘心,7,,2,2,4,ㄎㄜˋ ㄍㄨˇ ㄇㄧㄥˊ ㄒㄧㄣ,kè gǔ míng xīn
11455,窠臼,7,,3,1,4,ㄎㄜ ㄐㄧㄡˋ,kē jiù
11456,科舉,7,,11,2,13,ㄎㄜ ㄐㄩˇ,kē jǔ
11457,苛刻,7,,5,1,6,ㄎㄜ ㄎㄜˋ,kē kè
11458,可蘭經,7,,1,2,3,ㄎㄜˇ ㄌㄢˊ ㄐㄧㄥ,kě lán jīng
11459,顆粒,7,,7,9,16,ㄎㄜ ㄌㄧˋ,kē lì
11460,苛求,7,,3,1,4,ㄎㄜ ㄑㄧㄡˊ,kē qiú
11461,可取,7,,3,1,4,ㄎㄜˇ ㄑㄩˇ,kě qǔ
11462,客套,7,,3,0,3,ㄎㄜˋ ㄊㄠˋ,kè tào
11463,磕頭,7,,7,1,8,ㄎㄜ ㄊㄡˊ,kē tóu
11464,可望,7,,4,7,11,ㄎㄜˇ ㄨㄤˋ,kě wàng
11465,嗑藥,7,,5,0,5,ㄎㄜˋ ㄧㄠˋ,kè yào
11466,苛責,7,,3,1,4,ㄎㄜ ㄗㄜˊ,kē zé
11467,懇切,7,,4,1,5,ㄎㄣˇ ㄑㄧㄝˋ,kěn qiè
11468,鏗鏘,7,,3,3,6,ㄎㄥ ㄑㄧㄤ,kēng qiāng
11469,吭聲,7,,5,1,6,ㄎㄥ ㄕㄥ,kēng shēng
11470,空檔2,7,,9,8,17,ㄎㄨㄥˋ ㄉㄤˇ,kòng dǎng
11471,控管,7,,4,6,10,ㄎㄨㄥˋ ㄍㄨㄢˇ,kòng guǎn
11472,恐懼症,7,,5,1,6,ㄎㄨㄥˇ ㄐㄩˋ ㄓㄥˋ,kǒng jù zhèng
11473,空空如也,7,,2,0,2,ㄎㄨㄥ ㄎㄨㄥ ㄖㄨˊ ㄧㄝˇ,kōng kōng rú yě
11474,空曠,7,,4,5,9,ㄎㄨㄥ ㄎㄨㄤˋ,kōng kuàng
11475,恐龍,7,,7,21,28,ㄎㄨㄥˇ ㄌㄨㄥˊ,kǒng lóng
11476,空前絕後,7,,3,1,4,ㄎㄨㄥ ㄑㄧㄢˊ ㄐㄩㄝˊ ㄏㄡˋ,kōng qián jué hòu
11477,空缺,7,,3,1,4,ㄎㄨㄥˋ ㄑㄩㄝ,kòng quē
11478,空無一人,7,,3,0,3,ㄎㄨㄥ ㄨˊ ㄧˋ ㄖㄣˊ,kōng wú yì rén
11479,空隙,7,,5,4,9,ㄎㄨㄥˋ ㄒㄧˋ,kòng xì
11480,空襲,7,,3,18,21,ㄎㄨㄥ ㄒㄧˊ,kōng xí
11481,叩,7,,8,4,12,ㄎㄡˋ,kòu
11482,扣除,7,,3,2,5,ㄎㄡˋ ㄔㄨˊ,kòu chú
11483,口紅,7,,4,3,7,ㄎㄡˇ ㄏㄨㄥˊ,kǒu hóng
11484,口角,7,,3,1,4,ㄎㄡˇ ㄐㄧㄠˇ,kǒu jiǎo
11485,口徑,7,,3,3,6,ㄎㄡˇ ㄐㄧㄥˋ,kǒu jìng
11486,口口聲聲,7,,3,0,3,ㄎㄡˇ ㄎㄡˇ ㄕㄥ ㄕㄥ,kǒu kǒu shēng shēng
11487,口舌,7,,3,1,4,ㄎㄡˇ ㄕㄜˊ,kǒu shé
11488,口頭禪,7,,3,1,4,ㄎㄡˇ ㄊㄡˊ ㄔㄢˊ,kǒu tóu chán
11489,酷愛,7,,3,1,4,ㄎㄨˋ ㄞˋ,kù ài
11490,苦不堪言,7,,3,3,6,ㄎㄨˇ ㄅㄨˋ ㄎㄢ ㄧㄢˊ,kǔ bù kān yán
11491,苦差事,7,,2,1,3,ㄎㄨˇ ㄔㄞ  ㄕˋ,kǔ chāi shì
11492,苦楚,7,,3,1,4,ㄎㄨˇ ㄔㄨˇ,kǔ chǔ
11493,苦讀,7,,4,3,7,ㄎㄨˇ ㄉㄨˊ,kǔ dú
11494,苦幹,7,,3,1,4,ㄎㄨˇ ㄍㄢˋ,kǔ gàn
11495,苦海,7,,3,2,5,ㄎㄨˇ ㄏㄞˇ,kǔ hǎi
11496,枯黃,7,,2,3,5,ㄎㄨ ㄏㄨㄤˊ,kū huáng
11497,枯竭,7,,4,5,9,ㄎㄨ ㄐㄧㄝˊ,kū jié
11498,苦口婆心,7,,2,1,3,ㄎㄨˇ ㄎㄡˇ ㄆㄛˊ ㄒㄧㄣ,kǔ kǒu pó xīn
11499,哭哭啼啼,7,,4,1,5,ㄎㄨ ㄎㄨ ㄊㄧˊ ㄊㄧˊ,kū kū tí tí
11500,窟窿,7,,4,1,5,ㄎㄨ ˙ㄌㄨㄥ,kū long
11501,苦澀,7,,5,6,11,ㄎㄨˇ ㄙㄜˋ,kǔ sè
11502,苦水,7,,2,4,6,ㄎㄨˇ ㄕㄨㄟˇ,kǔ shuǐ
11503,酷似,7,,3,1,4,ㄎㄨˋ ㄙˋ,kù sì
11504,苦思,7,,4,1,5,ㄎㄨˇ ㄙ,kǔ sī
11505,枯萎,7,,5,5,10,ㄎㄨ ㄨㄟ,kū wēi
11506,哭笑不得,7,,2,1,3,ㄎㄨ ㄒㄧㄠˋ ㄅㄨˋ ㄉㄜˊ,kū xiào bù dé
11507,酷刑,7,,4,1,5,ㄎㄨˋ ㄒㄧㄥˊ,kù xíng
11508,苦於,7,,3,1,4,ㄎㄨˇ ㄩˊ,kǔ yú
11509,苦戰,7,,3,0,3,ㄎㄨˇ ㄓㄢˋ,kǔ zhàn
11510,苦衷,7,,3,1,4,ㄎㄨˇ ㄓㄨㄥ,kǔ zhōng
11511,誇口,7,,2,1,3,ㄎㄨㄚ ㄎㄡˇ,kuā kǒu
11512,誇耀,7,,4,1,5,ㄎㄨㄚ ㄧㄠˋ,kuā yào
11513,誇讚,7,,4,1,5,ㄎㄨㄚ ㄗㄢˋ,kuā zàn
11514,塊頭,7,,4,0,4,ㄎㄨㄞˋ ㄊㄡˊ,kuài tóu
11515,膾炙人口,7,,4,1,5,ㄎㄨㄞˋ ㄓˋ ㄖㄣˊ ㄎㄡˇ,kuài zhì rén kǒu
11516,劊子手,7,,3,2,5,ㄎㄨㄞˋ ˙ㄗ ㄕㄡˇ,kuài zi shǒu
11517,寬慰,7,,3,1,4,ㄎㄨㄢ ㄨㄟˋ,kuān wèi
11518,款項,7,,4,2,6,ㄎㄨㄢˇ ㄒㄧㄤˋ,kuǎn xiàng
11519,礦,7,,4,8,12,ㄎㄨㄤˋ,kuàng
11520,狂飆,7,,3,1,4,ㄎㄨㄤˊ ㄅㄧㄠ,kuáng biāo
11521,狂亂,7,,3,0,3,ㄎㄨㄤˊ ㄌㄨㄢˋ,kuáng luàn
11522,狂妄,7,,5,1,6,ㄎㄨㄤˊ ㄨㄤˋ,kuáng wàng
11523,曠野,7,,4,2,6,ㄎㄨㄤˋ ㄧㄝˇ,kuàng yě
11524,潰敗,7,,5,0,5,ㄎㄨㄟˋ ㄅㄞˋ,kuì bài
11525,愧疚,7,,5,4,9,ㄎㄨㄟˋ ㄐㄧㄡˋ,kuì jiù
11526,傀儡,7,,5,1,6,ㄎㄨㄟˇ ㄌㄟˇ,kuǐ lěi
11527,虧欠,7,,2,3,5,ㄎㄨㄟ ㄑㄧㄢˋ,kuī qiàn
11528,窺視,7,,5,1,6,ㄎㄨㄟ ㄕˋ,kuī shì
11529,窺探,7,,4,1,5,ㄎㄨㄟ ㄊㄢˋ,kuī tàn
11530,魁梧,7,,5,1,6,ㄎㄨㄟˊ ㄨˊ,kuí wú
11531,捆綁,7,,2,1,3,ㄎㄨㄣˇ ㄅㄤˇ,kǔn bǎng
11532,綑綁,7,,3,3,6,ㄎㄨㄣˇ ㄅㄤˇ,kǔn bǎng
11533,困頓,7,,5,6,11,ㄎㄨㄣˋ ㄉㄨㄣˋ,kùn dùn
11534,困窘,7,,5,1,6,ㄎㄨㄣˋ ㄐㄩㄥˇ,kùn jiǒng
11535,困難重重,7,,2,3,5,ㄎㄨㄣˋ ㄋㄢˊㄔㄨㄥˊ ㄔㄨㄥˊ,kùn nán chóng chóng
11536,擴建,7,,3,5,8,ㄎㄨㄛˋ ㄐㄧㄢˋ,kuò jiàn
11537,擴音器,7,,3,2,5,ㄎㄨㄛˋ ㄧㄣ ㄑㄧˋ,kuò yīn qì
11538,拉攏,7,,5,5,10,ㄌㄚ ㄌㄨㄥˇ,lā lǒng
11539,邋遢,7,,3,1,4,ㄌㄚ ˙ㄊㄚ,lā ta
11540,來來往往,7,,2,2,4,ㄌㄞˊ ㄌㄞˊ ㄨㄤˇ ㄨㄤˇ,lái lái wǎng wǎng
11541,來龍去脈,7,,6,1,7,ㄌㄞˊ ㄌㄨㄥˊ ㄑㄩˋ ㄇㄛˋ,lái lóng qù mò
11542,來日,7,,3,0,3,ㄌㄞˊ ㄖˋ,lái rì
11543,來勢洶洶,7,,2,3,5,ㄌㄞˊ ㄕˋ ㄒㄩㄥ ㄒㄩㄥ,lái shì xiōng xiōng
11544,賴以,7,,3,2,5,ㄌㄞˋㄧˇ,làiyǐ
11545,濫,7,,4,3,7,ㄌㄢˋ,làn
11546,攬,7,,4,3,7,ㄌㄢˇ,lǎn
11547,蘭花,7,,4,16,20,ㄌㄢˊ ㄏㄨㄚ,lán huā
11548,攔截,7,,4,7,11,ㄌㄢˊ ㄐㄧㄝˊ,lán jié
11549,藍領,7,,2,1,3,ㄌㄢˊ ㄌㄧㄥˇ,lán lǐng
11550,襤褸,7,,3,1,4,ㄌㄢˊ ㄌㄩˇ,lán lǚ
11551,懶洋洋,7,,4,1,5,ㄌㄢˇ ㄧㄤˊ ㄧㄤˊ,lǎn yáng yáng
11552,廊,7,,7,2,9,ㄌㄤˊ,láng
11553,狼狽不堪,7,,2,0,2,ㄌㄤˊ ㄅㄟˋ ㄅㄨˋ ㄎㄢ,láng bèi bù kān
11554,浪花,7,,4,2,6,ㄌㄤˋ ㄏㄨㄚ,làng huā
11555,朗誦,7,,4,2,6,ㄌㄤˇ ㄙㄨㄥˋ,lǎng sòng
11556,狼吞虎嚥,7,,4,4,8,ㄌㄤˊ ㄊㄨㄣ ㄏㄨˇ ㄧㄢˋ,láng tūn hǔ yàn
11557,浪子,7,,4,4,8,ㄌㄤˋ ㄗˇ,làng zǐ
11558,牢不可破,7,,2,0,2,ㄌㄠˊ ㄅㄨˋ ㄎㄜˇ ㄆㄛˋ,láo bù kě pò
11559,牢固,7,,6,4,10,ㄌㄠˊ ㄍㄨˋ,láo gù
11560,老將,7,,3,0,3,ㄌㄠˇ ㄐㄧㄤˋ,lǎo jiàng
11561,牢靠,7,,2,1,3,ㄌㄠˊ ˙ㄎㄠ,láo kao
11562,勞苦,7,,4,2,6,ㄌㄠˊ ㄎㄨˇ,láo kǔ
11563,老練,7,,4,0,4,ㄌㄠˇ ㄌㄧㄢˋ,lǎo liàn
11564,老派,7,,3,1,4,ㄌㄠˇ ㄆㄞˋ,lǎo pài
11565,老去,7,,4,0,4,ㄌㄠˇ ㄑㄩˋ,lǎo qù
11566,老生常談,7,,2,1,3,ㄌㄠˇ ㄕㄥ ㄔㄤˊ ㄊㄢˊ,lǎo shēng cháng tán
11567,老套,7,,4,1,5,ㄌㄠˇ ㄊㄠˋ,lǎo tào
11568,烙印,7,,4,3,7,ㄌㄠˋ ㄧㄣˋ,lào yìn
11569,牢獄,7,,4,3,7,ㄌㄠˊ ㄩˋ,láo yù
11570,樂不可支,7,,2,0,2,ㄌㄜˋ ㄅㄨˋ ㄎㄜˇ ㄓ,lè bù kě zhī
11571,樂此不疲,7,,3,2,5,ㄌㄜˋ ㄘˇ ㄅㄨˋ ㄆㄧˊ,lè cǐ bù pí
11572,勒令,7,,3,0,3,ㄌㄜˋ ㄌㄧㄥˋ,lè lìng
11573,樂子,7,,3,1,4,ㄌㄜˋ ˙ㄗ,lè zi
11574,累2,7,,53,121,174,ㄌㄟˇ,lěi
11575,雷達,7,,4,6,10,ㄌㄟˊ ㄉㄚˊ,léi dá
11576,累累,7,,5,4,9,ㄌㄟˇ ㄌㄟˇ,lěi lěi
11577,淚流滿面,7,,4,1,5,ㄌㄟˋ ㄌㄧㄡˊ ㄇㄢˇ ㄇㄧㄢˋ,lèi liú mǎn miàn
11578,雷鳴,7,,3,0,3,ㄌㄟˊ ㄇㄧㄥˊ,léi míng
11579,雷同,7,,3,3,6,ㄌㄟˊ ㄊㄨㄥˊ,léi tóng
11580,類推,7,,5,1,6,ㄌㄟˋ ㄊㄨㄟ,lèi tuī
11581,淚珠,7,,3,0,3,ㄌㄟˋ ㄓㄨ,lèi zhū
11582,累贅,7,,3,1,4,ㄌㄟˇ ㄓㄨㄟˋ,lěi zhuì
11583,怔,7,,4,1,5,ㄌㄥˋ,lèng
11584,冷不防,7,,3,1,4,ㄌㄥˇ ㄅㄨˋ ㄈㄤˊ,lěng bù fáng
11585,冷嘲熱諷,7,,2,1,3,ㄌㄥˇ ㄔㄠˊ ㄖㄜˋ ㄈㄥˋ,lěng cháo rè fèng
11586,冷清,7,,3,3,6,ㄌㄥˇ ㄑㄧㄥ,lěng qīng
11587,犁,7,,8,7,15,ㄌㄧˊ,lí
11588,利弊,7,,3,2,5,ㄌㄧˋ ㄅㄧˋ,lì bì
11589,力不從心,7,,3,2,5,ㄌㄧˋ ㄅㄨˋ ㄘㄨㄥˊ ㄒㄧㄣ,lì bù cóng xīn
11590,理睬,7,,6,1,7,ㄌㄧˇ ㄘㄞˇ,lǐ cǎi
11591,理當,7,,3,0,3,ㄌㄧˇ ㄉㄤ,lǐ dāng
11592,立竿見影,7,,3,2,5,ㄌㄧˋ ㄍㄢ ㄐㄧㄢˋ ㄧㄥˇ,lì gān jiàn yǐng
11593,立功,7,,5,1,6,ㄌㄧˋ ㄍㄨㄥ,lì gōng
11594,利己,7,,2,2,4,ㄌㄧˋ ㄐㄧˇ,lì jǐ
11595,禮教,7,,5,1,6,ㄌㄧˇ ㄐㄧㄠˋ,lǐ jiào
11596,歷盡,7,,3,2,5,ㄌㄧˋ ㄐㄧㄣˋ,lì jìn
11597,歷久不衰,7,,3,1,4,ㄌㄧˋ ㄐㄧㄡˇ ㄅㄨˋ ㄕㄨㄞ,lì jiǔ bù shuāi
11598,歷來,7,,5,1,6,ㄌㄧˋ ㄌㄞˊ,lì lái
11599,歷歷在目,7,,2,1,3,ㄌㄧˋ ㄌㄧˋ ㄗㄞˋ ㄇㄨˋ,lì lì zài mù
11600,蒞臨,7,,2,2,4,ㄌㄧˋ ㄌㄧㄣˊ,lì lín
11601,立論,7,,4,1,5,ㄌㄧˋ ㄌㄨㄣˋ,lì lùn
11602,釐清,7,,16,6,22,ㄌㄧˊ ㄑㄧㄥ,lí qīng
11603,禮讓,7,,2,1,3,ㄌㄧˇ ㄖㄤˋ,lǐ ràng
11604,利刃,7,,3,1,4,ㄌㄧˋ ㄖㄣˋ,lì rèn
11605,理事,7,,7,3,10,ㄌㄧˇ ㄕˋ,lǐ shì
11606,利他,7,,4,4,8,ㄌㄧˋ ㄊㄚ,lì tā
11607,離題,7,,2,0,2,ㄌㄧˊ ㄊㄧˊ,lí tí
11608,力圖,7,,5,2,7,ㄌㄧˋ ㄊㄨˊ,lì tú
11609,離鄉背井,7,,2,5,7,ㄌㄧˊ ㄒㄧㄤ ㄅㄟˋ ㄐㄧㄥˇ,lí xiāng bèi jǐng
11610,力行,7,,4,8,12,ㄌㄧˋ ㄒㄧㄥˊ,lì xíng
11611,立意,7,,3,3,6,ㄌㄧˋ ㄧˋ,lì yì
11612,利誘,7,,3,1,4,ㄌㄧˋ ㄧㄡˋ,lì yòu
11613,立於,7,,4,0,4,ㄌㄧˋ ㄩˊ,lì yú
11614,鯉魚,7,,13,3,16,ㄌㄧˇ ㄩˊ,lǐ yú
11615,禮遇,7,,5,3,8,ㄌㄧˇ ㄩˋ,lǐ yù
11616,例證,7,,6,1,7,ㄌㄧˋ ㄓㄥˋ,lì zhèng
11617,勵志,7,,3,3,6,ㄌㄧˋ ㄓˋ,lì zhì
11618,理直氣壯,7,,6,1,7,ㄌㄧˇ ㄓˊ ㄑㄧˋ ㄓㄨㄤˋ,lǐ zhí qì zhuàng
11619,立足點,7,,2,2,4,ㄌㄧˋ ㄗㄨˊ ㄉㄧㄢˇ,lì zú diǎn
11620,憐愛,7,,3,0,3,ㄌㄧㄢˊ ㄞˋ,lián ài
11621,臉蛋,7,,5,0,5,ㄌㄧㄢˇ ㄉㄢˋ,liǎn dàn
11622,連根拔起,7,,0,0,0,ㄌㄧㄢˊ ㄍㄣ ㄅㄚˊ ㄑㄧˇ,lián gēn bá qǐ
11623,連環,7,,3,6,9,ㄌㄧㄢˊ ㄏㄨㄢˊ,lián huán
11624,練就,7,,3,3,6,ㄌㄧㄢˋ ㄐㄧㄡˋ,liàn jiù
11625,聯軍,7,,23,5,28,ㄌㄧㄢˊ ㄐㄩㄣ,lián jūn
11626,連累,7,,4,1,5,ㄌㄧㄢˊ ㄌㄟˋ,lián lèi
11627,連綿,7,,4,3,7,ㄌㄧㄢˊ ㄇㄧㄢˊ,lián mián
11628,聯名,7,,3,1,4,ㄌㄧㄢˊ ㄇㄧㄥˊ,lián míng
11629,連年,7,,4,4,8,ㄌㄧㄢˊ ㄋㄧㄢˊ,lián nián
11630,臉盆,7,,3,2,5,ㄌㄧㄢˇ ㄆㄣˊ,liǎn pén
11631,連日,7,,3,10,13,ㄌㄧㄢˊ ㄖˋ,lián rì
11632,憐惜,7,,3,1,4,ㄌㄧㄢˊ ㄒㄧˊ,lián xí
11633,漣漪,7,,4,3,7,ㄌㄧㄢˊ ㄧ,lián yī
11634,聯姻,7,,4,3,7,ㄌㄧㄢˊ ㄧㄣ,lián yīn
11635,煉獄,7,,2,2,4,ㄌㄧㄢˋ ㄩˋ,liàn yù
11636,樑,7,,6,4,10,ㄌㄧㄤˊ,liáng
11637,晾,7,,3,4,7,ㄌㄧㄤˋ,liàng
11638,量表,7,,6,1,7,ㄌㄧㄤˊㄅㄧㄠˇ,liáng biǎo
11639,良方,7,,3,3,6,ㄌㄧㄤˊ ㄈㄤ,liáng fāng
11640,良機,7,,7,1,8,ㄌㄧㄤˊ ㄐㄧ,liáng jī
11641,兩頰,7,,3,1,4,ㄌㄧㄤˇ ㄐㄧㄚˊ,liǎng jiá
11642,良久,7,,7,1,8,ㄌㄧㄤˊ ㄐㄧㄡˇ,liáng jiǔ
11643,踉蹌,7,,5,1,6,ㄌㄧㄤˋ ㄑㄧㄤˋ,liàng qiàng
11644,良善,7,,4,8,12,ㄌㄧㄤˊ ㄕㄢˋ,liáng shàn
11645,亮相,7,,3,3,6,ㄌㄧㄤˋ ㄒㄧㄤˋ,liàng xiàng
11646,涼鞋,7,,4,2,6,ㄌㄧㄤˊ ㄒㄧㄝˊ,liáng xié
11647,良藥,7,,3,2,5,ㄌㄧㄤˊ ㄧㄠˋ,liáng yào
11648,良知,7,,6,2,8,ㄌㄧㄤˊ ㄓ,liáng zhī
11649,了不得,7,,3,1,4,ㄌㄧㄠˇ ㄅㄨˋ ˙ㄉㄜ,liǎo bù de
11650,潦草,7,,3,1,4,ㄌㄧㄠˊ ㄘㄠˇ,liáo cǎo
11651,療程,7,,6,2,8,ㄌㄧㄠˊ ㄔㄥˊ,liáo chéng
11652,潦倒,7,,4,1,5,ㄌㄧㄠˊ ㄉㄠˇ,liáo dǎo
11653,了得,7,,2,0,2,ㄌㄧㄠˇ ˙ㄉㄜ,liǎo de
11654,了結,7,,5,1,6,ㄌㄧㄠˇ ㄐㄧㄝˊ,liǎo jié
11655,寥寥,7,,4,2,6,ㄌㄧㄠˊ ㄌㄧㄠˊ,liáo liáo
11656,寥寥無幾,7,,2,0,2,ㄌㄧㄠˊ ㄌㄧㄠˊ ㄨˊ ㄐㄧˇ,liáo liáo wú jǐ
11657,了然,7,,3,1,4,ㄌㄧㄠˇ ㄖㄢˊ,liǎo rán
11658,繚繞,7,,4,3,7,ㄌㄧㄠˊ ㄖㄠˋ,liáo rào
11659,瞭若指掌,7,,3,3,6,ㄌㄧㄠˇ ㄖㄨㄛˋ ㄓˇ ㄓㄤˇ,liǎo ruò zhǐ zhǎng
11660,療傷,7,,5,1,6,ㄌㄧㄠˊ ㄕㄤ,liáo shāng
11661,聊勝於無,7,,0,0,0,ㄌㄧㄠˊ ㄕㄥˋ ㄩˊ ㄨˊ,liáo shèng yú wú
11662,瞭望,7,,2,1,3,ㄌㄧㄠˋ ㄨㄤˋ,liào wàng
11663,料想,7,,4,2,6,ㄌㄧㄠˋ ㄒㄧㄤˇ,liào xiǎng
11664,療養,7,,3,1,4,ㄌㄧㄠˊ ㄧㄤˇ,liáo yǎng
11665,療養院,7,,5,4,9,ㄌㄧㄠˊ ㄧㄤˇ ㄩㄢˋ,liáo yǎng yuàn
11666,療癒,7,,17,8,25,ㄌㄧㄠˊ ㄩˋ,liáo yù
11667,列隊,7,,3,2,5,ㄌㄧㄝˋ ㄉㄨㄟˋ,liè duì
11668,裂痕,7,,4,3,7,ㄌㄧㄝˋ ㄏㄣˊ,liè hén
11669,烈火,7,,6,2,8,ㄌㄧㄝˋ ㄏㄨㄛˇ,liè huǒ
11670,烈酒,7,,3,0,3,ㄌㄧㄝˋ ㄐㄧㄡˇ,liè jiǔ
11671,烈日,7,,4,7,11,ㄌㄧㄝˋ ㄖˋ,liè rì
11672,烈士,7,,4,2,6,ㄌㄧㄝˋ ㄕˋ,liè shì
11673,咧嘴,7,,8,0,8,ㄌㄧㄝˇ ㄗㄨㄟˇ,liě zuǐ
11674,鄰,7,,6,7,13,ㄌㄧㄣˊ,lín
11675,鱗,7,,4,3,7,ㄌㄧㄣˊ,lín
11676,鄰國,7,,4,18,22,ㄌㄧㄣˊ ㄍㄨㄛˊ,lín guó
11677,臨近,7,,2,2,4,ㄌㄧㄣˊ ㄐㄧㄣˋ,lín jìn
11678,琳瑯滿目,7,,3,2,5,ㄌㄧㄣˊ ㄌㄤˊ ㄇㄢˇ ㄇㄨˋ,lín láng mǎn mù
11679,淋漓,7,,4,1,5,ㄌㄧㄣˊ ㄌㄧˊ,lín lí
11680,林立,7,,5,7,12,ㄌㄧㄣˊ ㄌㄧˋ,lín lì
11681,淋漓盡致,7,,5,2,7,ㄌㄧㄣˊ ㄌㄧˊ ㄐㄧㄣˋ ㄓˋ,lín lí jìn zhì
11682,林林總總,7,,2,1,3,ㄌㄧㄣˊ ㄌㄧㄣˊ ㄗㄨㄥˇ ㄗㄨㄥˇ,lín lín zǒng zǒng
11683,凜然,7,,3,1,4,ㄌㄧㄣˇ ㄖㄢˊ,lǐn rán
11684,臨危,7,,2,2,4,ㄌㄧㄣˊ ㄨㄟˊ,lín wéi
11685,遴選,7,,3,1,4,ㄌㄧㄣˊ ㄒㄩㄢˇ,lín xuǎn
11686,領兵,7,,6,0,6,ㄌㄧㄥˇ ㄅㄧㄥ,lǐng bīng
11687,另當別論,7,,2,0,2,ㄌㄧㄥˋ ㄉㄤ ㄅㄧㄝˊ ㄌㄨㄣˋ,lìng dāng bié lùn
11688,零工,7,,2,4,6,ㄌㄧㄥˊ ㄍㄨㄥ,líng gōng
11689,靈機一動,7,,5,4,9,ㄌㄧㄥˊ ㄐㄧ ㄧ ㄉㄨㄥˋ,líng jī yī dòng
11690,凌駕,7,,5,2,7,ㄌㄧㄥˊ ㄐㄧㄚˋ,líng jià
11691,領教,7,,3,0,3,ㄌㄧㄥˇ ㄐㄧㄠˋ,lǐng jiào
11692,伶俐,7,,7,0,7,ㄌㄧㄥˊ ㄌㄧˋ,líng lì
11693,玲瓏,7,,2,1,3,ㄌㄧㄥˊ ㄌㄨㄥˊ,líng lóng
11694,凌亂,7,,5,3,8,ㄌㄧㄥˊ ㄌㄨㄢˋ,líng luàn
11695,領略,7,,4,2,6,ㄌㄧㄥˇ ㄌㄩㄝˋ,lǐng lüè
11696,凌辱,7,,3,0,3,ㄌㄧㄥˊ ㄖㄨˋ,líng rù
11697,零售,7,,5,2,7,ㄌㄧㄥˊ ㄕㄡˋ,líng shòu
11698,領受,7,,5,1,6,ㄌㄧㄥˇ ㄕㄡˋ,lǐng shòu
11699,零碎,7,,4,2,6,ㄌㄧㄥˊ ㄙㄨㄟˋ,líng suì
11700,領頭,7,,4,3,7,ㄌㄧㄥˇ ㄊㄡˊ,lǐng tóu
11701,另行,7,,3,1,4,ㄌㄧㄥˋ ㄒㄧㄥˊ,lìng xíng
11702,靈驗,7,,4,1,5,ㄌㄧㄥˊ ㄧㄢˋ,líng yàn
11703,領養,7,,5,2,7,ㄌㄧㄥˇ ㄧㄤˇ,lǐng yǎng
11704,瘤,7,,4,4,8,ㄌㄧㄡˊ,liú
11705,流竄,7,,4,1,5,ㄌㄧㄡˊ ㄘㄨㄢˋ,liú cuàn
11706,留存,7,,4,2,6,ㄌㄧㄡˊ ㄘㄨㄣˊ,liú cún
11707,留待,7,,3,1,4,ㄌㄧㄡˊ ㄉㄞˋ,liú dài
11708,流放,7,,7,1,8,ㄌㄧㄡˊ ㄈㄤˋ,liú fàng
11709,流連,7,,3,2,5,ㄌㄧㄡˊ ㄌㄧㄢˊ,liú lián
11710,留戀,7,,3,1,4,ㄌㄧㄡˊ ㄌㄧㄢˋ,liú liàn
11711,流落,7,,4,3,7,ㄌㄧㄡˊ ㄌㄨㄛˋ,liú luò
11712,留名,7,,2,1,3,ㄌㄧㄡˊ ㄇㄧㄥˊ,liú míng
11713,留情,7,,7,2,9,ㄌㄧㄡˊ ㄑㄧㄥˊ,liú qíng
11714,留神,7,,4,0,4,ㄌㄧㄡˊ ㄕㄣˊ,liú shén
11715,留守,7,,6,5,11,ㄌㄧㄡˊ ㄕㄡˇ,liú shǒu
11716,柳樹,7,,4,0,4,ㄌㄧㄡˇ ㄕㄨˋ,liǔ shù
11717,流亡,7,,6,5,11,ㄌㄧㄡˊ ㄨㄤˊ,liú wáng
11718,流星,7,,4,2,6,ㄌㄧㄡˊ ㄒㄧㄥ,liú xīng
11719,流於,7,,6,1,7,ㄌㄧㄡˊ ㄩˊ ,liú yú
11720,流轉,7,,5,3,8,ㄌㄧㄡˊ ㄓㄨㄢˇ,liú zhuǎn
11721,籠絡,7,,4,1,5,ㄌㄨㄥˊ ㄌㄨㄛˋ,lóng luò
11722,籠統,7,,4,2,6,ㄌㄨㄥˊ ㄊㄨㄥˇ,lóng tǒng
11723,簍,7,,5,4,9,ㄌㄡˇ,lǒu
11724,擄,7,,3,1,4,ㄌㄨˇ,lǔ
11725,縷,7,,5,1,6,ㄌㄩˇ,lǚ
11726,路標,7,,2,1,3,ㄌㄨˋ ㄅㄧㄠ,lù biāo
11727,路燈,7,,4,4,8,ㄌㄨˋ ㄉㄥ,lù dēng
11728,律動,7,,4,3,7,ㄌㄩˋ ㄉㄨㄥˋ,lǜ dòng
11729,綠豆,7,,6,5,11,ㄌㄩˋ ㄉㄡˋ,lǜ dòu
11730,露骨,7,,3,1,4,ㄌㄨˋ ㄍㄨˇ,lù gǔ
11731,擄獲,7,,2,2,4,ㄌㄨˇ ㄏㄨㄛˋ,lǔ huò
11732,屢見不鮮,7,,3,1,4,ㄌㄩˇ ㄐㄧㄢˋ ㄅㄨˋ ㄒㄧㄢ,lǚ jiàn bù xiān
11733,旅居,7,,2,3,5,ㄌㄩˇ ㄐㄩ,lǚ jū
11734,履歷,7,,4,10,14,ㄌㄩˇ ㄌㄧˋ,lǚ lì
11735,屢屢,7,,4,1,5,ㄌㄩˇ ㄌㄩˇ,lǚ lǚ
11736,魯莽,7,,5,1,6,ㄌㄨˇ ㄇㄤˇ,lǔ mǎng
11737,露水,7,,4,10,14,ㄌㄨˋ ㄕㄨㄟˇ,lù shuǐ
11738,錄用,7,,4,1,5,ㄌㄨˋ ㄩㄥˋ,lù yòng
11739,綠油油,7,,3,6,9,ㄌㄩˋ ㄧㄡˊ ㄧㄡˊ,lǜ yóu yóu
11740,爐灶,7,,3,1,4,ㄌㄨˊ ㄗㄠˋ,lú zào
11741,驢子,7,,7,4,11,ㄌㄩˊ ˙ㄗ,lǘ zi
11742,亂竄,7,,3,1,4,ㄌㄨㄢˋ ㄘㄨㄢˋ,luàn cuàn
11743,掠奪,7,,7,3,10,ㄌㄩㄝˋ ㄉㄨㄛˊ,lüè duó
11744,論調,7,,5,2,7,ㄌㄨㄣˋ ㄉㄧㄠˋ,lùn diào
11745,論定,7,,3,1,4,ㄌㄨㄣˋ ㄉㄧㄥˋ,lùn dìng
11746,論斷,7,,4,2,6,ㄌㄨㄣˋ ㄉㄨㄢˋ,lùn duàn
11747,輪番,7,,3,1,4,ㄌㄨㄣˊ ㄈㄢ,lún fān
11748,輪迴,7,,5,7,12,ㄌㄨㄣˊ ㄏㄨㄟˊ,lún huí
11749,淪落,7,,4,3,7,ㄌㄨㄣˊ ㄌㄨㄛˋ,lún luò
11750,論壇,7,,7,4,11,ㄌㄨㄣˋ ㄊㄢˊ,lùn tán
11751,淪陷,7,,5,2,7,ㄌㄨㄣˊ ㄒㄧㄢˋ,lún xiàn
11752,論證,7,,6,1,7,ㄌㄨㄣˋ ㄓㄥˋ,lùn zhèng
11753,鑼,7,,4,2,6,ㄌㄨㄛˊ,luó
11754,落敗,7,,3,1,4,ㄌㄨㄛˋ ㄅㄞˋ,luò bài
11755,落成,7,,4,8,12,ㄌㄨㄛˋ ㄔㄥˊ,luò chéng
11756,落得,7,,7,1,8,ㄌㄨㄛˋ ㄉㄜˊ,luò dé
11757,落荒而逃,7,,3,1,4,ㄌㄨㄛˋ ㄏㄨㄤ ㄦˊ ㄊㄠˊ,luò huāng ér táo
11758,落腳,7,,6,10,16,ㄌㄨㄛˋ ㄐㄧㄠˇ,luò jiǎo
11759,裸露,7,,3,4,7,ㄌㄨㄛˇ ㄌㄨˋ,luǒ lù
11760,落寞,7,,4,1,5,ㄌㄨㄛˋ ㄇㄛˋ,luò mò
11761,落幕,7,,4,10,14,ㄌㄨㄛˋ ㄇㄨˋ,luò mù
11762,羅盤,7,,4,1,5,ㄌㄨㄛˊ ㄆㄢˊ,luó pán
11763,囉唆,7,,2,2,4,ㄌㄨㄛ ㄙㄨㄛ,luō suō
11764,落魄,7,,5,1,6,ㄌㄨㄛˋ ㄊㄨㄛˋ,luò tuò
11765,絡繹不絕,7,,3,5,8,ㄌㄨㄛˋ ㄧˋ ㄅㄨˋ ㄐㄩㄝˊ,luò yì bù jué
11766,麻布,7,,4,1,5,ㄇㄚˊ ㄅㄨˋ,má bù
11767,馬不停蹄,7,,2,4,6,ㄇㄚˇ ㄅㄨˋ ㄊㄧㄥˊ ㄊㄧˊ,mǎ bù tíng tí
11768,馬力,7,,5,3,8,ㄇㄚˇ ㄌㄧˋ,mǎ lì
11769,馬尾,7,,3,0,3,ㄇㄚˇ ㄨㄟˇ,mǎ wěi
11770,邁步,7,,2,1,3,ㄇㄞˋ ㄅㄨˋ,mài bù
11771,脈動,7,,4,47,51,ㄇㄞˋ ㄉㄨㄥˋ,mài dòng
11772,邁進,7,,9,9,18,ㄇㄞˋ ㄐㄧㄣˋ,mài jìn
11773,邁開,7,,3,1,4,ㄇㄞˋ ㄎㄞ,mài kāi
11774,埋沒,7,,3,1,4,ㄇㄞˊ ㄇㄛˋ,mái mò
11775,賣弄,7,,3,0,3,ㄇㄞˋ ㄋㄨㄥˋ,mài nòng
11776,埋首,7,,5,2,7,ㄇㄞˊ ㄕㄡˇ,mái shǒu
11777,埋頭,7,,6,1,7,ㄇㄞˊ ㄊㄡˊ,mái tóu
11778,埋頭苦幹,7,,2,1,3,ㄇㄞˊ ㄊㄡˊ ㄎㄨˇ ㄍㄢˋ,mái tóu kǔ gàn
11779,漫不經心,7,,6,1,7,ㄇㄢˋ ㄅㄨˋ ㄐㄧㄥ ㄒㄧㄣ,màn bù jīng xīn
11780,蠻橫,7,,4,2,6,ㄇㄢˊ ㄏㄥˋ,mán hèng
11781,蠻荒,7,,3,1,4,ㄇㄢˊ ㄏㄨㄤ,mán huāng
11782,謾罵,7,,3,1,4,ㄇㄢˋ ㄇㄚˋ,màn mà
11783,漫漫,7,,4,5,9,ㄇㄢˋ ㄇㄢˋ,màn màn
11784,蹣跚,7,,6,2,8,ㄇㄢˊ ㄕㄢ,mán shān
11785,漫天,7,,4,3,7,ㄇㄢˋ ㄊㄧㄢ,màn tiān
11786,滿天飛,7,,2,1,3,ㄇㄢˇ ㄊㄧㄢ ㄈㄟ,mǎn tiān fēi
11787,慢條斯理,7,,4,0,4,ㄇㄢˋ ㄊㄧㄠˊ ㄙ ㄌㄧˇ,màn tiáo sī lǐ
11788,滿溢,7,,3,3,6,ㄇㄢˇ ㄧˋ,mǎn yì
11789,漫遊,7,,7,2,9,ㄇㄢˋ ㄧㄡˊ,màn yóu
11790,滿載,7,,3,2,5,ㄇㄢˇ ㄗㄞˋ,mǎn zài
11791,莽夫,7,,2,0,2,ㄇㄤˇ ㄈㄨ,mǎng fū
11792,莽撞,7,,3,0,3,ㄇㄤˇ ㄓㄨㄤˋ,mǎng zhuàng
11793,毛骨悚然,7,,6,1,7,ㄇㄠˊ ㄍㄨˇ ㄙㄨㄥˇ ㄖㄢˊ,máo gǔ sǒng rán
11794,冒昧,7,,3,1,4,ㄇㄠˋ ㄇㄟˋ,mào mèi
11795,茂密,7,,5,7,12,ㄇㄠˋ ㄇㄧˋ,mào mì
11796,毛皮,7,,3,1,4,ㄇㄠˊ ㄆㄧˊ,máo pí
11797,貿然,7,,5,3,8,ㄇㄠˋ ㄖㄢˊ,mào rán
11798,茂盛,7,,5,10,15,ㄇㄠˋ ㄕㄥˋ,mào shèng
11799,貓頭鷹,7,,6,14,20,ㄇㄠ ㄊㄡˊ ㄧㄥ,māo tóu yīng
11800,卯足,7,,2,2,4,ㄇㄠˇ ㄗㄨˊ,mǎo zú 
11801,眉開眼笑,7,,3,1,4,ㄇㄟˊ ㄎㄞ ㄧㄢˇ ㄒㄧㄠˋ,méi kāi yǎn xiào
11802,每況愈下,7,,3,4,7,ㄇㄟˇ ㄎㄨㄤˋ ㄩˋ ㄒㄧㄚˋ,měi kuàng yù xià
11803,沒命,7,,4,1,5,ㄇㄟˊ ㄇㄧㄥˋ,méi mìng
11804,美名,7,,3,2,5,ㄇㄟˇ ㄇㄧㄥˊ,měi míng
11805,眉目,7,,3,0,3,ㄇㄟˊ ㄇㄨˋ,méi mù
11806,美色,7,,3,1,4,ㄇㄟˇ ㄙㄜˋ,měi sè
11807,煤炭,7,,4,10,14,ㄇㄟˊ ㄊㄢˋ,méi tàn
11808,沒完沒了,7,,6,1,7,ㄇㄟˊ ㄨㄢˊ ㄇㄟˊ ㄌㄧㄠˇ,méi wán méi liǎo
11809,美意,7,,2,2,4,ㄇㄟˇ ㄧˋ,měi yì
11810,美譽,7,,3,3,6,ㄇㄟˇ ㄩˋ,měi yù
11811,門房,7,,4,0,4,ㄇㄣˊ ㄈㄤˊ,mén fáng
11812,門縫,7,,4,1,5,ㄇㄣˊ ㄈㄥˋ,mén fèng
11813,門徑,7,,2,0,2,ㄇㄣˊ ㄐㄧㄥˋ,mén jìng
11814,門路,7,,2,1,3,ㄇㄣˊ ㄌㄨˋ,mén lù
11815,悶氣,7,,3,2,5,ㄇㄣˋ ㄑㄧˋ,mèn qì
11816,捫心自問,7,,2,1,3,ㄇㄣˊ ㄒㄧㄣ ㄗˋ ㄨㄣˋ,mén xīn zì wèn
11817,蒙,7,,29,8,37,ㄇㄥˊ,méng
11818,蒙蔽,7,,4,1,5,ㄇㄥˊ ㄅㄧˋ,méng bì
11819,猛攻,7,,4,1,5,ㄇㄥˇ ㄍㄨㄥ,měng gōng
11820,盟軍,7,,4,2,6,ㄇㄥˊ ㄐㄩㄣ,méng jūn
11821,夢寐以求,7,,5,1,6,ㄇㄥˋ ㄇㄟˋ ㄧˇ ㄑㄧㄡˊ,mèng mèi yǐ qiú
11822,萌生,7,,4,2,6,ㄇㄥˊ ㄕㄥ,méng shēng
11823,蒙受,7,,4,2,6,ㄇㄥˊ ㄕㄡˋ,méng shòu
11824,猛獸,7,,5,2,7,ㄇㄥˇ ㄕㄡˋ,měng shòu
11825,夢鄉,7,,4,1,5,ㄇㄥˋ ㄒㄧㄤ,mèng xiāng
11826,蒙羞,7,,2,0,2,ㄇㄥˊ ㄒㄧㄡ,méng xiū
11827,萌芽,7,,7,9,16,ㄇㄥˊ ㄧㄚˊ,méng yá
11828,夢魘,7,,6,3,9,ㄇㄥˋ ㄧㄢˇ,mèng yǎn
11829,夢遊,7,,4,1,5,ㄇㄥˋ ㄧㄡˊ,mèng yóu
11830,密布,7,,3,2,5,ㄇㄧˋ ㄅㄨˋ,mì bù
11831,謎底,7,,2,1,3,ㄇㄧˊ ㄉㄧˇ,mí dǐ
11832,祕方/秘方,7,,6,7,13,ㄇㄧˋ ㄈㄤ,mì fāng
11833,迷濛,7,,3,0,3,ㄇㄧˊ ㄇㄥˊ,mí méng
11834,密密麻麻,7,,5,7,12,ㄇㄧˋ ㄇㄧˋ ㄇㄚˊ ㄇㄚˊ,mì mì má má
11835,密謀,7,,4,1,5,ㄇㄧˋ ㄇㄡˊ,mì móu
11836,覓食,7,,6,9,15,ㄇㄧˋ ㄕˊ,mì shí
11837,密室,7,,3,1,4,ㄇㄧˋ ㄕˋ,mì shì
11838,謎題,7,,3,2,5,ㄇㄧˊ ㄊㄧˊ,mí tí
11839,迷途,7,,3,3,6,ㄇㄧˊ ㄊㄨˊ,mí tú
11840,謎團,7,,6,0,6,ㄇㄧˊ ㄊㄨㄢˊ,mí tuán
11841,迷惘,7,,7,3,10,ㄇㄧˊ ㄨㄤˇ,mí wǎng
11842,迷霧,7,,4,1,5,ㄇㄧˊ ㄨˋ,mí wù
11843,密友,7,,3,1,4,ㄇㄧˋ ㄧㄡˇ,mì yǒu
11844,謎語,7,,3,0,3,ㄇㄧˊ ㄩˇ,mí yǔ
11845,面板,7,,2,5,7,ㄇㄧㄢˋ ㄅㄢˇ,miàn bǎn
11846,面紅耳赤,7,,3,1,4,ㄇㄧㄢˋ ㄏㄨㄥˊ ㄦˇ ㄔˋ,miàn hóng ěr chì
11847,緬懷,7,,3,5,8,ㄇㄧㄢˇ ㄏㄨㄞˊ,miǎn huái
11848,面頰,7,,5,0,5,ㄇㄧㄢˋ ㄐㄧㄚˊ,miàn jiá
11849,勉力,7,,3,1,4,ㄇㄧㄢˇ ㄌㄧˋ,miǎn lì
11850,勉勵,7,,4,7,11,ㄇㄧㄢˇ ㄌㄧˋ,miǎn lì
11851,綿綿,7,,3,8,11,ㄇㄧㄢˊ ㄇㄧㄢˊ,mián mián
11852,面面相覷,7,,5,0,5,ㄇㄧㄢˋ ㄇㄧㄢˋ ㄒㄧㄤ ㄑㄩˋ,miàn miàn xiāng qù
11853,靦腆,7,,4,4,8,ㄇㄧㄢˇ ㄊㄧㄢˇ,miǎn tiǎn
11854,麵條,7,,6,4,10,ㄇㄧㄢˋ ㄊㄧㄠˊ,miàn tiáo
11855,綿延,7,,7,12,19,ㄇㄧㄢˊ ㄧㄢˊ,mián yán
11856,綿羊,7,,5,2,7,ㄇㄧㄢˊ ㄧㄤˊ,mián yáng
11857,免職,7,,4,1,5,ㄇㄧㄢˇ ㄓˊ,miǎn zhí
11858,描,7,,3,1,4,ㄇㄧㄠˊ,miáo
11859,妙計,7,,4,2,6,ㄇㄧㄠˋ ㄐㄧˋ,miào jì
11860,渺茫,7,,4,2,6,ㄇㄧㄠˇ ㄇㄤˊ,miǎo máng
11861,廟堂,7,,3,0,3,ㄇㄧㄠˋ ㄊㄤˊ,miào táng
11862,苗頭,7,,2,1,3,ㄇㄧㄠˊ ˙ㄊㄡ,miáo tou
11863,妙用,7,,3,2,5,ㄇㄧㄠˋ ㄩㄥˋ,miào yòng
11864,瞄準,7,,6,2,8,ㄇㄧㄠˊ ㄓㄨㄣˇ,miáo zhǔn
11865,滅頂,7,,2,1,3,ㄇㄧㄝˋ ㄉㄧㄥˇ,miè dǐng
11866,蔑視,7,,5,2,7,ㄇㄧㄝˋ ㄕˋ,miè shì
11867,民情,7,,4,4,8,ㄇㄧㄣˊ ㄑㄧㄥˊ,mín qíng
11868,民謠,7,,6,1,7,ㄇㄧㄣˊ ㄧㄠˊ,mín yáo
11869,明朝,7,,37,8,45,ㄇㄧㄥˊ ㄔㄠˊ,míng cháo
11870,名次,7,,3,3,6,ㄇㄧㄥˊ ㄘˋ,míng cì
11871,名額,7,,4,3,7,ㄇㄧㄥˊ ㄜˊ,míng é
11872,名副其實,7,,4,2,6,ㄇㄧㄥˊ ㄈㄨˋ ㄑㄧˊ ㄕˊ,míng fù qí shí
11873,名號,7,,7,4,11,ㄇㄧㄥˊ ㄏㄠˋ,míng hào
11874,名家,7,,7,2,9,ㄇㄧㄥˊ ㄐㄧㄚ,míng jiā
11875,鳴叫,7,,4,2,6,ㄇㄧㄥˊ ㄐㄧㄠˋ,míng jiào
11876,明快,7,,3,1,4,ㄇㄧㄥˊ ㄎㄨㄞˋ,míng kuài
11877,明朗,7,,5,4,9,ㄇㄧㄥˊ ㄌㄤˇ,míng lǎng
11878,明理,7,,3,2,5,ㄇㄧㄥˊ ㄌㄧˇ,míng lǐ
11879,名列前茅,7,,3,3,6,ㄇㄧㄥˊ ㄌㄧㄝˋ ㄑㄧㄢˊ ㄇㄠˊ,míng liè qián máo
11880,明令,7,,3,1,4,ㄇㄧㄥˊ ㄌㄧㄥˋ,míng lìng
11881,名流,7,,7,1,8,ㄇㄧㄥˊ ㄌㄧㄡˊ,míng liú
11882,命脈,7,,3,4,7,ㄇㄧㄥˋ ㄇㄞˋ,mìng mài
11883,明媚,7,,2,1,3,ㄇㄧㄥˊ ㄇㄟˋ,míng mèi
11884,名門,7,,6,0,6,ㄇㄧㄥˊ ㄇㄣˊ,míng mén
11885,名目,7,,3,1,4,ㄇㄧㄥˊ ㄇㄨˋ,míng mù
11886,明目張膽,7,,3,1,4,ㄇㄧㄥˊ ㄇㄨˋ ㄓㄤ ㄉㄢˇ,míng mù zhāng dǎn
11887,名勝,7,,3,2,5,ㄇㄧㄥˊ ㄕㄥˋ,míng shèng
11888,名士,7,,7,1,8,ㄇㄧㄥˊ ㄕˋ,míng shì
11889,明說,7,,3,0,3,ㄇㄧㄥˊ ㄕㄨㄛ,míng shuō
11890,命題,7,,7,1,8,ㄇㄧㄥˋ ㄊㄧˊ,mìng tí
11891,名望,7,,5,1,6,ㄇㄧㄥˊ ㄨㄤˋ,míng wàng
11892,名下,7,,4,1,5,ㄇㄧㄥˊ ㄒㄧㄚˋ,míng xià
11893,明證,7,,2,0,2,ㄇㄧㄥˊ ㄓㄥˋ,míng zhèng
11894,名正言順,7,,3,1,4,ㄇㄧㄥˊ ㄓㄥˋ ㄧㄢˊ ㄕㄨㄣˋ,míng zhèng yán shùn
11895,名作,7,,3,0,3,ㄇㄧㄥˊ ㄗㄨㄛˋ,míng zuò
11896,謎樣,7,,2,1,3,ㄇㄧˊㄧㄤˋ,míyàng
11897,膜拜,7,,4,1,5,ㄇㄛˊ ㄅㄞˋ,mó bài
11898,默不作聲,7,,4,0,4,ㄇㄛˋ ㄅㄨˊ ㄗㄨㄛˋ ㄕㄥ,mò bú zuò shēng
11899,莫測,7,,3,1,4,ㄇㄛˋ ㄘㄜˋ,mò cè
11900,摩登,7,,3,1,4,ㄇㄛˊ ㄉㄥ,mó dēng
11901,摸黑,7,,3,3,6,ㄇㄛ ㄏㄟ,mō hēi
11902,模稜兩可,7,,4,1,5,ㄇㄛˊ ㄌㄥˊ ㄌㄧㄤˇ ㄎㄜˇ,mó léng liǎng kě
11903,磨滅,7,,2,2,4,ㄇㄛˊ ㄇㄧㄝˋ,mó miè
11904,磨難,7,,4,2,6,ㄇㄛˊ ㄋㄢˋ,mó nàn
11905,漠然,7,,3,1,4,ㄇㄛˋ ㄖㄢˊ,mò rán
11906,驀然,7,,3,1,4,ㄇㄛˋ ㄖㄢˊ,mò rán
11907,默然,7,,4,1,5,ㄇㄛˋ ㄖㄢˊ,mò rán
11908,抹殺/抹煞,7,,6,1,7,ㄇㄛˇ ㄕㄚ,mǒ shā
11909,漠視,7,,4,5,9,ㄇㄛˋ ㄕˋ,mò shì
11910,末尾,7,,2,1,3,ㄇㄛˋ ㄨㄟˇ,mò wěi
11911,默許,7,,3,3,6,ㄇㄛˋ ㄒㄩˇ,mò xǔ
11912,模子,7,,3,2,5,ㄇㄛˊ ˙ㄗ,mó zi
11913,謀害,7,,5,1,6,ㄇㄡˊ ㄏㄞˋ,móu hài
11914,謀面,7,,2,1,3,ㄇㄡˊ ㄇㄧㄢˋ,móu miàn
11915,謀求,7,,6,2,8,ㄇㄡˊ ㄑㄧㄡˊ,móu qiú
11916,謀取,7,,2,1,3,ㄇㄡˊ ㄑㄩˇ,móu qǔ
11917,魔咒,7,,3,2,5,ㄇㄛˊㄓㄡˋ,mózhòu
11918,畝,7,,11,24,35,ㄇㄨˇ,mǔ
11919,牧場,7,,7,6,13,ㄇㄨˋ ㄔㄤˊ,mù cháng
11920,牡丹,7,,11,3,14,ㄇㄨˇ ㄉㄢ,mǔ dān
11921,募集,7,,3,8,11,ㄇㄨˋ ㄐㄧˊ,mù jí
11922,木偶,7,,4,5,9,ㄇㄨˋ ㄡˇ,mù ǒu
11923,暮色,7,,3,1,4,ㄇㄨˋ ㄙㄜˋ,mù sè
11924,目送,7,,5,1,6,ㄇㄨˋ ㄙㄨㄥˋ,mù sòng
11925,母體,7,,4,3,7,ㄇㄨˇ ㄊㄧˇ,mǔ tǐ
11926,母校,7,,3,4,7,ㄇㄨˇ ㄒㄧㄠˋ,mǔ xiào
11927,母性,7,,3,1,4,ㄇㄨˇ ㄒㄧㄥˋ,mǔ xìng
11928,目眩,7,,4,0,4,ㄇㄨˋ ㄒㄩㄢˋ,mù xuàn
11929,木樁,7,,3,2,5,ㄇㄨˋ ㄓㄨㄤ,mù zhuāng
11930,納粹,7,,14,5,19,ㄋㄚˋ ㄘㄨㄟˋ,nà cuì
11931,拿捏,7,,6,8,14,ㄋㄚˊ ㄋㄧㄝ,ná niē
11932,納稅,7,,3,1,4,ㄋㄚˋ ㄕㄨㄟˋ,nà shuì
11933,奈何,7,,5,0,5,ㄋㄞˋ ㄏㄜˊ,nài hé
11934,耐人尋味,7,,4,2,6,ㄋㄞˋ ㄖㄣˊ ㄒㄩㄣˊ ㄨㄟˋ,nài rén xún wèi
11935,耐用,7,,3,6,9,ㄋㄞˋ ㄩㄥˋ,nài yòng
11936,難纏,7,,4,1,5,ㄋㄢˊ ㄔㄢˊ,nán chán
11937,難產,7,,3,1,4,ㄋㄢˊ ㄔㄢˇ,nán chǎn
11938,難處,7,,3,1,4,ㄋㄢˊ ㄔㄨˇ/ㄋㄢˊ ㄔㄨˋ,nán chǔ/nán chù
11939,難當,7,,3,0,3,ㄋㄢˊ ㄉㄤ,nán dāng
11940,南瓜,7,,9,25,34,ㄋㄢˊ ㄍㄨㄚ,nán guā
11941,難能可貴,7,,4,5,9,ㄋㄢˊ ㄋㄥˊ ㄎㄜˇ ㄍㄨㄟˋ,nán néng kě guì
11942,男女老幼,7,,2,1,3,ㄋㄢˊ ㄋㄩˇ ㄌㄠˇ ㄧㄡˋ,nán nǚ lǎo yòu
11943,難上加難,7,,2,1,3,ㄋㄢˊ ㄕㄤˋ ㄐㄧㄚ ㄋㄢˊ,nán shàng jiā nán
11944,難為,7,,3,0,3,ㄋㄢˊ ㄨㄟˊ,nán wéi
11945,難言,7,,2,1,3,ㄋㄢˊ ㄧㄢˊ,nán yán
11946,南轅北轍,7,,3,3,6,ㄋㄢˊ ㄩㄢˊ ㄅㄟˇ ㄔㄜˋ,nán yuán běi chè
11947,囊括,7,,3,2,5,ㄋㄤˊ ㄍㄨㄚ,náng guā
11948,惱火,7,,5,0,5,ㄋㄠˇ ㄏㄨㄛˇ,nǎo huǒ
11949,腦殼,7,,3,0,3,ㄋㄠˇ ㄎㄜˊ,nǎo ké
11950,惱人,7,,4,2,6,ㄋㄠˇ ㄖㄣˊ,nǎo rén
11951,惱羞成怒,7,,3,1,4,ㄋㄠˇ ㄒㄧㄡ ㄔㄥˊ ㄋㄨˋ,nǎo xiū chéng nù
11952,內斂,7,,4,3,7,ㄋㄟˋ ㄌㄧㄢˋ,nèi liàn
11953,內陸,7,,5,18,23,ㄋㄟˋ ㄌㄨˋ,nèi lù
11954,內亂,7,,3,2,5,ㄋㄟˋ ㄌㄨㄢˋ,nèi luàn
11955,內人,7,,5,1,6,ㄋㄟˋ ㄖㄣˊ,nèi rén
11956,內省,7,,4,1,5,ㄋㄟˋ ㄒㄧㄥˇ,nèi xǐng
11957,內政,7,,4,5,9,ㄋㄟˋ ㄓㄥˋ,nèi zhèng
11958,能事,7,,3,0,3,ㄋㄥˊ ㄕˋ,néng shì
11959,能手,7,,2,1,3,ㄋㄥˊ ㄕㄡˇ,néng shǒu
11960,暱稱,7,,4,3,7,ㄋㄧˋ ㄔㄥ,nì chēng
11961,逆境,7,,6,13,19,ㄋㄧˋ ㄐㄧㄥˋ,nì jìng
11962,逆來順受,7,,3,1,4,ㄋㄧˋ ㄌㄞˊ ㄕㄨㄣˋ ㄕㄡˋ,nì lái shùn shòu
11963,逆流,7,,3,2,5,ㄋㄧˋ ㄌㄧㄡˊ,nì liú
11964,泥淖,7,,3,1,4,ㄋㄧˊ ㄋㄠˋ,ní nào
11965,泥濘,7,,5,4,9,ㄋㄧˊ ㄋㄧㄥˋ,ní nìng
11966,泥沙,7,,2,11,13,ㄋㄧˊ ㄕㄚ,ní shā
11967,溺死,7,,3,1,4,ㄋㄧˋ ㄙˇ,nì sǐ
11968,逆向,7,,3,2,5,ㄋㄧˋ ㄒㄧㄤˋ,nì xiàng
11969,泥沼,7,,2,1,3,ㄋㄧˊ ㄓㄠˇ,ní zhǎo
11970,拈,7,,3,0,3,ㄋㄧㄢˊ,nián
11971,年復一年,7,,4,1,5,ㄋㄧㄢˊ ㄈㄨˋ ㄧˋ ㄋㄧㄢˊ,nián fù yì nián
11972,年華,7,,4,1,5,ㄋㄧㄢˊ ㄏㄨㄚˊ,nián huá
11973,年事,7,,3,2,5,ㄋㄧㄢˊ ㄕˋ,nián shì
11974,黏土,7,,4,4,8,ㄋㄧㄢˊ ㄊㄨˇ,nián tǔ
11975,娘,7,,36,50,86,ㄋㄧㄤˊ,niáng
11976,裊裊,7,,2,1,3,ㄋㄧㄠˇ ㄋㄧㄠˇ,niǎo niǎo
11977,躡手躡腳,7,,4,1,5,ㄋㄧㄝˋ ㄕㄡˇ ㄋㄧㄝˋ ㄐㄧㄠˇ,niè shǒu niè jiǎo
11978,擰2,7,,4,2,6,ㄋㄧㄥˋ,nìng
11979,擰1,7,,4,2,6,ㄋㄧㄥˇ,nǐng
11980,凝固,7,,3,4,7,ㄋㄧㄥˊ ㄍㄨˋ,níng gù
11981,凝結,7,,4,9,13,ㄋㄧㄥˊ ㄐㄧㄝˊ,níng jié
11982,凝神,7,,4,0,4,ㄋㄧㄥˊ ㄕㄣˊ,níng shén
11983,凝望,7,,6,0,6,ㄋㄧㄥˊ ㄨㄤˋ,níng wàng
11984,凝重,7,,4,3,7,ㄋㄧㄥˊ ㄓㄨㄥˋ,níng zhòng
11985,扭頭,7,,3,0,3,ㄋㄧㄡˇ ㄊㄡˊ,niǔ tóu
11986,濃烈,7,,4,1,5,ㄋㄨㄥˊ ㄌㄧㄝˋ,nóng liè
11987,農舍,7,,4,3,7,ㄋㄨㄥˊ ㄕㄜˋ,nóng shè
11988,濃重,7,,3,1,4,ㄋㄨㄥˊ ㄓㄨㄥˋ,nóng zhòng
11989,農莊,7,,7,6,13,ㄋㄨㄥˊ ㄓㄨㄤ,nóng zhuāng
11990,奴才,7,,12,0,12,ㄋㄨˊ ㄘㄞˊ,nú cái
11991,怒罵,7,,3,0,3,ㄋㄨˋ ㄇㄚˋ,nù mà
11992,怒目,7,,3,1,4,ㄋㄨˋ ㄇㄨˋ,nù mù
11993,怒氣沖沖,7,,5,1,6,ㄋㄨˋ ㄑㄧˋ ㄔㄨㄥ ㄔㄨㄥ,nù qì chōng chōng
11994,奴役,7,,5,0,5,ㄋㄨˊ ㄧˋ,nú yì
11995,瘧疾,7,,5,11,16,ㄋㄩㄝˋ ㄐㄧˊ,nüè jí
11996,懦夫,7,,3,1,4,ㄋㄨㄛˋ ㄈㄨ,nuò fū
11997,偶發,7,,4,1,5,ㄡˇ ㄈㄚ,ǒu fā
11998,偶數,7,,2,0,2,ㄡˇ ㄕㄨˋ,ǒu shù
11999,扒2,7,,4,2,6,ㄆㄚˊ,pá
12000,拍案,7,,3,1,4,ㄆㄞ ㄢˋ,pāi àn
12001,派別,7,,3,4,7,ㄆㄞˋ ㄅㄧㄝˊ,pài bié
12002,排放,7,,3,42,45,ㄆㄞˊ ㄈㄤˋ,pái fàng
12003,排解,7,,3,2,5,ㄆㄞˊ ㄐㄧㄝˇ,pái jiě
12004,排遣,7,,2,1,3,ㄆㄞˊ ㄑㄧㄢˇ,pái qiǎn
12005,排山倒海,7,,3,1,4,ㄆㄞˊ ㄕㄢ ㄉㄠˇ ㄏㄞˇ,pái shān dǎo hǎi
12006,派頭,7,,2,1,3,ㄆㄞˋ ㄊㄡˊ,pài tóu
12007,排序,7,,5,2,7,ㄆㄞˊㄒㄩˋ,pái xù
12008,派駐,7,,3,2,5,ㄆㄞˋ ㄓㄨˋ,pài zhù
12009,畔,7,,19,18,37,ㄆㄢˋ,pàn
12010,判處,7,,4,1,5,ㄆㄢˋ ㄔㄨˇ,pàn chǔ
12011,攀登,7,,5,4,9,ㄆㄢ ㄉㄥ,pān dēng
12012,盤據,7,,4,3,7,ㄆㄢˊ ㄐㄩˋ,pán jù
12013,盤踞,7,,3,1,4,ㄆㄢˊ ㄐㄩˋ,pán jù
12014,攀升,7,,6,13,19,ㄆㄢ ㄕㄥ,pān shēng
12015,磐石,7,,3,3,6,ㄆㄢˊ ㄕˊ,pán shí
12016,攀談,7,,4,1,5,ㄆㄢ ㄊㄢˊ,pān tán
12017,叛徒,7,,5,1,6,ㄆㄢˋ ㄊㄨˊ,pàn tú
12018,盤問,7,,3,0,3,ㄆㄢˊ ㄨㄣˋ,pán wèn
12019,旁白,7,,4,1,5,ㄆㄤˊ ㄅㄞˊ,páng bái
12020,龐然大物,7,,2,1,3,ㄆㄤˊ ㄖㄢˊ ㄉㄚˋ ㄨˋ,páng rán dà wù
12021,螃蟹/蟹,7,,20,10,30,ㄆㄤˊ ㄒㄧㄝˋ/ㄒㄧㄝˋ,páng xiè/xiè
12022,龐雜,7,,2,2,4,ㄆㄤˊ ㄗㄚˊ,páng zá
12023,袍,7,,9,4,13,ㄆㄠˊ,páo
12024,泡泡,7,,4,8,12,ㄆㄠˋ ㄆㄠˋ,pào pào
12025,泡湯,7,,3,3,6,ㄆㄠˋ ㄊㄤ,pào tāng
12026,泡影,7,,2,1,3,ㄆㄠˋ ㄧㄥˇ,pào yǐng
12027,佩帶,7,,1,1,2,ㄆㄟˋ ㄉㄞˋ,pèi dài
12028,培根,7,,5,3,8,ㄆㄟˊ ㄍㄣ,péi gēn
12029,配給,7,,4,2,6,ㄆㄟˋ ㄐㄧˇ,pèi jǐ
12030,配件,7,,4,3,7,ㄆㄟˋ ㄐㄧㄢˋ,pèi jiàn
12031,賠錢,7,,3,4,7,ㄆㄟˊ ㄑㄧㄢˊ,péi qián
12032,配套,7,,3,3,6,ㄆㄟˋ ㄊㄠˋ,pèi tào
12033,培植,7,,4,2,6,ㄆㄟˊ ㄓˊ,péi zhí
12034,配置,7,,10,5,15,ㄆㄟˋ ㄓˋ,pèi zhì
12035,盆地,7,,5,9,14,ㄆㄣˊ ㄉㄧˋ,pén dì
12036,噴泉,7,,3,3,6,ㄆㄣ ㄑㄩㄢˊ,pēn quán
12037,噴射,7,,5,4,9,ㄆㄣ ㄕㄜˋ,pēn shè
12038,棚,7,,5,7,12,ㄆㄥˊ,péng
12039,碰壁,7,,2,1,3,ㄆㄥˋ ㄅㄧˋ,pèng bì
12040,捧場,7,,3,2,5,ㄆㄥˇ ㄔㄤˊ,pěng cháng
12041,澎湃,7,,6,3,9,ㄆㄥ ㄆㄞˋ,pēng pài
12042,蓬鬆,7,,3,2,5,ㄆㄥˊ ㄙㄨㄥ,péng sōng
12043,蓬頭,7,,3,3,6,ㄆㄥˊ ㄊㄡˊ,péng tóu
12044,匹2,7,,42,12,54,ㄆㄧˇ,pǐ
12045,疲憊不堪,7,,4,1,5,ㄆㄧˊ ㄅㄟˋ ㄅㄨˋ ㄎㄢ,pí bèi bù kān
12046,匹敵,7,,3,1,4,ㄆㄧˇ ㄉㄧˊ,pǐ dí
12047,疲乏,7,,4,1,5,ㄆㄧˊ ㄈㄚˊ,pí fá
12048,批發,7,,4,4,8,ㄆㄧ ㄈㄚ,pī fā
12049,皮革,7,,4,3,7,ㄆㄧˊ ㄍㄜˊ,pí gé
12050,癖好,7,,2,0,2,ㄆㄧˇ ㄏㄠˋ,pǐ hào
12051,披肩,7,,4,1,5,ㄆㄧ ㄐㄧㄢ,pī jiān
12052,僻靜,7,,2,1,3,ㄆㄧˋ ㄐㄧㄥˋ,pì jìng
12053,霹靂,7,,5,2,7,ㄆㄧ ㄌㄧˋ,pī lì
12054,披露,7,,4,2,6,ㄆㄧ ㄌㄨˋ,pī lù
12055,皮毛,7,,4,2,6,ㄆㄧˊ ㄇㄠˊ,pí máo
12056,媲美,7,,4,4,8,ㄆㄧˋ ㄇㄟˇ,pì měi
12057,匹配,7,,3,1,4,ㄆㄧˇ ㄆㄟˋ,pǐ pèi
12058,皮球,7,,2,2,4,ㄆㄧˊ ㄑㄧㄡˊ,pí qiú
12059,皮肉,7,,3,1,4,ㄆㄧˊ ㄖㄡˋ,pí ròu
12060,劈頭,7,,4,0,4,ㄆㄧ ㄊㄡˊ,pī tóu
12061,疲於奔命,7,,3,2,5,ㄆㄧˊ ㄩˊ ㄅㄣ ㄇㄧㄥˋ,pí yú bēn mìng
12062,偏激,7,,3,1,4,ㄆㄧㄢ ㄐㄧ,piān jī
12063,騙局,7,,3,1,4,ㄆㄧㄢˋ ㄐㄩˊ,piàn jú
12064,片面,7,,3,3,6,ㄆㄧㄢˋ ㄇㄧㄢˋ,piàn miàn
12065,翩翩,7,,5,1,6,ㄆㄧㄢ ㄆㄧㄢ,piān piān
12066,偏頗,7,,4,1,5,ㄆㄧㄢ ㄆㄛˇ,piān pǒ
12067,偏袒,7,,3,1,4,ㄆㄧㄢ ㄊㄢˇ,piān tǎn
12068,篇章,7,,4,4,8,ㄆㄧㄢ ㄓㄤ,piān zhāng
12069,偏執,7,,5,1,6,ㄆㄧㄢ ㄓˊ,piān zhí
12070,偏重,7,,4,2,6,ㄆㄧㄢ ㄓㄨㄥˋ,piān zhòng
12071,瓢,7,,7,5,12,ㄆㄧㄠˊ,piáo
12072,瞟,7,,3,0,3,ㄆㄧㄠˇ,piǎo
12073,漂泊,7,,4,4,8,ㄆㄧㄠ ㄅㄛˊ,piāo bó
12074,飄蕩,7,,3,1,4,ㄆㄧㄠ ㄉㄤˋ,piāo dàng
12075,飄動,7,,3,1,4,ㄆㄧㄠ ㄉㄨㄥˋ,piāo dòng
12076,飄浮,7,,5,2,7,ㄆㄧㄠ ㄈㄨˊ,piāo fú
12077,飄忽,7,,3,1,4,ㄆㄧㄠ ㄏㄨ,piāo hū
12078,漂流,7,,6,12,18,ㄆㄧㄠ ㄌㄧㄡˊ,piāo liú
12079,飄落,7,,3,1,4,ㄆㄧㄠ ㄌㄨㄛˋ,piāo luò
12080,飄飄然,7,,3,2,5,ㄆㄧㄠ ㄆㄧㄠ ㄖㄢˊ,piāo piāo rán
12081,飄然,7,,3,0,3,ㄆㄧㄠ ㄖㄢˊ,piāo rán
12082,飄散,7,,3,4,7,ㄆㄧㄠ ㄙㄢˋ,piāo sàn
12083,飄揚,7,,4,3,7,ㄆㄧㄠ ㄧㄤˊ,piāo yáng
12084,飄逸,7,,2,2,4,ㄆㄧㄠ ㄧˋ,piāo yì
12085,撇2,7,,5,7,12,ㄆㄧㄝˇ,piě
12086,撇1,7,,5,7,12,ㄆㄧㄝ,piē
12087,撇開,7,,4,1,5,ㄆㄧㄝ ㄎㄞ,piē kāi
12088,拼湊,7,,4,3,7,ㄆㄧㄣ ㄘㄡˋ,pīn còu
12089,貧瘠,7,,4,10,14,ㄆㄧㄣˊ ㄐㄧˊ,pín jí
12090,貧賤,7,,3,1,4,ㄆㄧㄣˊ ㄐㄧㄢˋ,pín jiàn
12091,貧民,7,,3,5,8,ㄆㄧㄣˊ ㄇㄧㄣˊ,pín mín
12092,貧民窟,7,,3,9,12,ㄆㄧㄣˊ ㄇㄧㄣˊ ㄎㄨ,pín mín kū
12093,平白,7,,2,1,3,ㄆㄧㄥˊ ㄅㄞˊ,píng bái
12094,評比,7,,3,4,7,ㄆㄧㄥˊ ㄅㄧˇ,píng bǐ
12095,平淡無奇,7,,2,1,3,ㄆㄧㄥˊ ㄉㄢˋ ㄨˊ ㄑㄧˊ,píng dàn wú qí
12096,平定,7,,14,1,15,ㄆㄧㄥˊ ㄉㄧㄥˋ,píng dìng
12097,評定,7,,3,0,3,ㄆㄧㄥˊ ㄉㄧㄥˋ,píng dìng
12098,平反,7,,6,1,7,ㄆㄧㄥˊ ㄈㄢ,píng fān
12099,平房,7,,3,1,4,ㄆㄧㄥˊ ㄈㄤˊ,píng fáng
12100,平分,7,,2,1,3,ㄆㄧㄥˊ ㄈㄣ,píng fēn
12101,評分,7,,5,3,8,ㄆㄧㄥˊ ㄈㄣ,píng fēn
12102,平復,7,,3,2,5,ㄆㄧㄥˊ ㄈㄨˋ,píng fù
12103,平衡點,7,,3,7,10,ㄆㄧㄥˊ ㄏㄥˊ ㄉㄧㄢˇ,píng héng diǎn
12104,平緩,7,,3,6,9,ㄆㄧㄥˊ ㄏㄨㄢˇ,píng huǎn
12105,評鑑,7,,12,9,21,ㄆㄧㄥˊ ㄐㄧㄢˋ,píng jiàn
12106,憑空,7,,5,2,7,ㄆㄧㄥˊ ㄎㄨㄥ,píng kōng
12107,評判,7,,4,1,5,ㄆㄧㄥˊ ㄆㄢˋ,píng pàn
12108,平平,7,,4,5,9,ㄆㄧㄥˊ ㄆㄧㄥˊ,píng píng
12109,平生,7,,7,1,8,ㄆㄧㄥˊ ㄕㄥ,píng shēng
12110,平實,7,,2,2,4,ㄆㄧㄥˊ ㄕˊ,píng shí
12111,平順,7,,4,1,5,ㄆㄧㄥˊ ㄕㄨㄣˋ,píng shùn
12112,平素,7,,3,0,3,ㄆㄧㄥˊ ㄙㄨˋ,píng sù
12113,平心靜氣,7,,3,1,4,ㄆㄧㄥˊ ㄒㄧㄣ ㄐㄧㄥˋ ㄑㄧˋ,píng xīn jìng qì
12114,平易近人,7,,2,1,3,ㄆㄧㄥˊ ㄧˋ ㄐㄧㄣˋ ㄖㄣˊ,píng yì jìn rén
12115,平庸,7,,7,2,9,ㄆㄧㄥˊ ㄩㄥ,píng yōng
12116,屏障,7,,5,6,11,ㄆㄧㄥˊ ㄓㄤˋ,píng zhàng
12117,破案,7,,4,4,8,ㄆㄛˋ ㄢˋ,pò àn
12118,破敗,7,,3,2,5,ㄆㄛˋ ㄅㄞˋ,pò bài
12119,迫不得已,7,,3,1,4,ㄆㄛˋ ㄅㄨˋ ㄉㄜˊ ㄧˇ,pò bù dé yǐ
12120,頗負盛名,7,,0,0,0,ㄆㄛˇㄈㄨˋㄕㄥˋ ㄇㄧㄥˊ,pǒ fù shèng míng
12121,破獲,7,,1,1,2,ㄆㄛˋ ㄏㄨㄛˋ,pò huò
12122,破口大罵,7,,4,1,5,ㄆㄛˋ ㄎㄡˇ ㄉㄚˋ ㄇㄚˋ,pò kǒu dà mà
12123,破例,7,,3,1,4,ㄆㄛˋ ㄌㄧˋ,pò lì
12124,破滅,7,,6,2,8,ㄆㄛˋ ㄇㄧㄝˋ,pò miè
12125,破曉,7,,3,1,4,ㄆㄛˋ ㄒㄧㄠˇ,pò xiǎo
12126,迫在眉睫,7,,3,2,5,ㄆㄛˋ ㄗㄞˋ ㄇㄟˊ ㄐㄧㄝˊ,pò zài méi jié
12127,破綻,7,,5,0,5,ㄆㄛˋ ㄓㄢˋ,pò zhàn
12128,剖,7,,2,1,3,ㄆㄡˇ,pǒu
12129,剖開,7,,3,2,5,ㄆㄡˇ ㄎㄞ,pǒu kāi
12130,剖析,7,,6,9,15,ㄆㄡˇ ㄒㄧ,pǒu xī
12131,迫於,7,,3,1,4,ㄆㄛˋㄩˊ,pòyú
12132,噗,7,,4,3,7,ㄆㄨ,pū
12133,撲鼻,7,,4,2,6,ㄆㄨ ㄅㄧˊ,pū bí
12134,鋪陳/舖陳,7,,6,1,7,ㄆㄨ ㄔㄣˊ,pū chén
12135,撲克牌,7,,4,2,6,ㄆㄨ ㄎㄜˋ ㄆㄞˊ,pū kè pái
12136,鋪路/舖路,7,,4,2,6,ㄆㄨ ㄌㄨˋ,pū lù
12137,撲滅,7,,4,5,9,ㄆㄨ ㄇㄧㄝˋ,pū miè
12138,鋪設/舖設,7,,5,8,13,ㄆㄨ ㄕㄜˋ,pū shè
12139,撲通,7,,4,0,4,ㄆㄨ ㄊㄨㄥ,pū tōng
12140,柒,7,,1,0,1,ㄑㄧ,qī
12141,齊備,7,,2,1,3,ㄑㄧˊ ㄅㄟˋ,qí bèi
12142,悽慘,7,,3,2,5,ㄑㄧ ㄘㄢˇ,qī cǎn
12143,淒慘,7,,4,1,5,ㄑㄧ ㄘㄢˇ,qī cǎn
12144,起草,7,,4,1,5,ㄑㄧˇ ㄘㄠˇ,qǐ cǎo
12145,啟齒,7,,3,1,4,ㄑㄧˇ ㄔˇ,qǐ chǐ
12146,啟迪,7,,3,1,4,ㄑㄧˇ ㄉㄧˊ,qǐ dí
12147,氣度,7,,5,1,6,ㄑㄧˋ ㄉㄨˋ,qì dù
12148,祈福,7,,4,13,17,ㄑㄧˊ ㄈㄨˊ,qí fú
12149,奇觀,7,,4,2,6,ㄑㄧˊ ㄍㄨㄢ,qí guān
12150,契合,7,,5,4,9,ㄑㄧˋ ㄏㄜˊ,qì hé
12151,奇幻,7,,4,3,7,ㄑㄧˊ ㄏㄨㄢˋ,qí huàn
12152,期貨,7,,3,1,4,ㄑㄧˊ ㄏㄨㄛˋ,qí huò
12153,氣急敗壞,7,,4,0,4,ㄑㄧˋ ㄐㄧˊ ㄅㄞˋ ㄏㄨㄞˋ,qì jí bài huài
12154,歧見,7,,3,2,5,ㄑㄧˊ ㄐㄧㄢˋ,qí jiàn
12155,奇景,7,,3,4,7,ㄑㄧˊ ㄐㄧㄥˇ,qí jǐng
12156,起居室,7,,4,0,4,ㄑㄧˇ ㄐㄩ ㄕˋ,qǐ jū shì
12157,起立,7,,5,4,9,ㄑㄧˇ ㄌㄧˋ,qǐ lì
12158,淒厲,7,,2,1,3,ㄑㄧ ㄌㄧˋ,qī lì
12159,欺凌,7,,3,0,3,ㄑㄧ ㄌㄧㄥˊ,qī líng
12160,起落,7,,3,2,5,ㄑㄧˇ ㄌㄨㄛˋ,qǐ luò
12161,期滿,7,,3,1,4,ㄑㄧˊ ㄇㄢˇ,qí mǎn
12162,欺瞞,7,,3,0,3,ㄑㄧ ㄇㄢˊ,qī mán
12163,器皿,7,,4,3,7,ㄑㄧˋ ㄇㄧㄣˇ,qì mǐn
12164,氣惱,7,,3,1,4,ㄑㄧˋ ㄋㄠˇ,qì nǎo
12165,企盼,7,,2,1,3,ㄑㄧˋ ㄆㄢˋ,qì pàn
12166,氣魄,7,,4,1,5,ㄑㄧˋ ㄆㄛˋ,qì pò
12167,氣球,7,,11,6,17,ㄑㄧˋ ㄑㄧㄡˊ,qì qiú
12168,乞求,7,,4,1,5,ㄑㄧˇ ㄑㄧㄡˊ,qǐ qiú
12169,崎嶇,7,,6,8,14,ㄑㄧˊ ㄑㄩ,qí qū
12170,起色,7,,4,1,5,ㄑㄧˇ ㄙㄜˋ,qǐ sè
12171,棲身,7,,3,5,8,ㄑㄧ ㄕㄣ,qī shēn
12172,奇事,7,,3,0,3,ㄑㄧˊ ㄕˋ,qí shì
12173,啟事,7,,4,1,5,ㄑㄧˇ ㄕˋ,qǐ shì
12174,起司,7,,5,4,9,ㄑㄧˇ ㄙ,qǐ sī
12175,起死回生,7,,4,3,7,ㄑㄧˇ ㄙˇ ㄏㄨㄟˊ ㄕㄥ,qǐ sǐ huí shēng
12176,乞討,7,,3,3,6,ㄑㄧˇ ㄊㄠˇ,qǐ tǎo
12177,起頭,7,,4,5,9,ㄑㄧˇ ㄊㄡˊ,qǐ tóu
12178,起舞,7,,7,0,7,ㄑㄧˇ ㄨˇ,qǐ wǔ
12179,棲息,7,,7,19,26,ㄑㄧ ㄒㄧˊ,qī xí
12180,器械,7,,4,2,6,ㄑㄧˋ ㄒㄧㄝˋ,qì xiè
12181,齊心,7,,2,5,7,ㄑㄧˊ ㄒㄧㄣ,qí xīn
12182,氣壓,7,,3,3,6,ㄑㄧˋ ㄧㄚ,qì yā
12183,欺壓,7,,4,1,5,ㄑㄧ ㄧㄚ,qī yā
12184,起疑,7,,4,0,4,ㄑㄧˇ ㄧˊ,qǐ yí
12185,起義,7,,14,2,16,ㄑㄧˇ ㄧˋ,qǐ yì
12186,起因,7,,6,1,7,ㄑㄧˇ ㄧㄣ,qǐ yīn
12187,啟用,7,,3,13,16,ㄑㄧˇ ㄩㄥˋ,qǐ yòng
12188,起用,7,,3,1,4,ㄑㄧˇ ㄩㄥˋ,qǐ yòng
12189,奇遇,7,,4,1,5,ㄑㄧˊ ㄩˋ,qí yù
12190,豈止,7,,3,1,4,ㄑㄧˇ ㄓˇ,qǐ zhǐ
12191,器重,7,,3,0,3,ㄑㄧˋ ㄓㄨㄥˋ,qì zhòng
12192,恰如其分,7,,2,0,2,ㄑㄧㄚˋ ㄖㄨˊ ㄑㄧˊ ㄈㄣˋ,qià rú qí fèn
12193,乾2,7,,50,99,149,ㄑㄧㄢˊ,qián
12194,嵌,7,,5,1,6,ㄑㄧㄢ,qiān
12195,牽絆,7,,2,2,4,ㄑㄧㄢ ㄅㄢˋ,qiān bàn
12196,謙卑,7,,6,15,21,ㄑㄧㄢ ㄅㄟ,qiān bēi
12197,錢幣,7,,3,2,5,ㄑㄧㄢˊ ㄅㄧˋ,qián bì
12198,淺薄,7,,4,1,5,ㄑㄧㄢˇ ㄅㄛˊ,qiǎn bó
12199,牽扯,7,,4,1,5,ㄑㄧㄢ ㄔㄜˇ,qiān chě
12200,千方百計,7,,5,1,6,ㄑㄧㄢ ㄈㄤ ㄅㄞˇ ㄐㄧˋ,qiān fāng bǎi jì
12201,潛伏,7,,6,2,8,ㄑㄧㄢˊ ㄈㄨˊ,qián fú
12202,前功盡棄,7,,2,1,3,ㄑㄧㄢˊ ㄍㄨㄥ ㄐㄧㄣˋ ㄑㄧˋ,qián gōng jìn qì
12203,牽掛,7,,4,4,8,ㄑㄧㄢ ㄍㄨㄚˋ,qiān guà
12204,謙和,7,,2,1,3,ㄑㄧㄢ ㄏㄜˊ,qiān hé
12205,欠佳,7,,3,2,5,ㄑㄧㄢˋ ㄐㄧㄚ,qiàn jiā
12206,歉疚,7,,3,1,4,ㄑㄧㄢˋ ㄐㄧㄡˋ,qiàn jiù
12207,遷就,7,,3,1,4,ㄑㄧㄢ ㄐㄧㄡˋ,qiān jiù
12208,遷居,7,,4,2,6,ㄑㄧㄢ ㄐㄩ,qiān jū
12209,千鈞一髮,7,,2,1,3,ㄑㄧㄢ ㄐㄩㄣ ㄧˋ ㄈㄚˇ,qiān jūn yì fǎ
12210,乾坤,7,,5,8,13,ㄑㄧㄢˊ ㄎㄨㄣ,qián kūn
12211,千里迢迢,7,,3,4,7,ㄑㄧㄢ ㄌㄧˇ ㄊㄧㄠˊ ㄊㄧㄠˊ,qiān lǐ tiáo tiáo
12212,遷怒,7,,2,0,2,ㄑㄧㄢ ㄋㄨˋ,qiān nù
12213,千篇一律,7,,3,1,4,ㄑㄧㄢ ㄆㄧㄢ ㄧˊ ㄌㄩˋ,qiān piān yí lǜ
12214,前仆後繼,7,,2,1,3,ㄑㄧㄢˊ ㄆㄨ ㄏㄡˋ ㄐㄧˋ,qián pū hòu jì
12215,千奇百怪,7,,2,1,3,ㄑㄧㄢ ㄑㄧˊ ㄅㄞˇ ㄍㄨㄞˋ,qiān qí bǎi guài
12216,牽強,7,,3,1,4,ㄑㄧㄢ ㄑㄧㄤˇ,qiān qiǎng
12217,千秋,7,,4,1,5,ㄑㄧㄢ ㄑㄧㄡ,qiān qiū
12218,前世,7,,5,2,7,ㄑㄧㄢˊ ㄕˋ,qián shì
12219,前所未見,7,,3,2,5,ㄑㄧㄢˊ ㄙㄨㄛˇ ㄨㄟˋ ㄐㄧㄢˋ,qián suǒ wèi jiàn
12220,前所未有,7,,12,6,18,ㄑㄧㄢˊ ㄙㄨㄛˇ ㄨㄟˋ ㄧㄡˇ,qián suǒ wèi yǒu
12221,前衛,7,,7,2,9,ㄑㄧㄢˊ ㄨㄟˋ,qián wèi
12222,遷徙,7,,7,20,27,ㄑㄧㄢ ㄒㄧˇ,qiān xǐ
12223,淺顯,7,,4,2,6,ㄑㄧㄢˇ ㄒㄧㄢˇ,qiǎn xiǎn
12224,潛心,7,,3,1,4,ㄑㄧㄢˊ ㄒㄧㄣ,qián xīn
12225,謙遜,7,,5,1,6,ㄑㄧㄢ ㄒㄩㄣˋ,qiān xùn
12226,千言萬語,7,,2,1,3,ㄑㄧㄢ ㄧㄢˊ ㄨㄢˋ ㄩˇ,qiān yán wàn yǔ
12227,潛移默化,7,,4,5,9,ㄑㄧㄢˊ ㄧˊ ㄇㄛˋ ㄏㄨㄚˋ,qián yí mò huà
12228,牽引,7,,5,7,12,ㄑㄧㄢ ㄧㄣˇ,qiān yǐn
12229,前因後果,7,,2,2,4,ㄑㄧㄢˊ ㄧㄣ ㄏㄡˋ ㄍㄨㄛˇ,qián yīn hòu guǒ
12230,千載難逢,7,,2,0,2,ㄑㄧㄢ ㄗㄞˇ ㄋㄢˊ ㄈㄥˊ,qiān zǎi nán féng
12231,前瞻,7,,4,1,5,ㄑㄧㄢˊ ㄓㄢ,qián zhān
12232,千真萬確,7,,4,0,4,ㄑㄧㄢ ㄓㄣ ㄨㄢˋ ㄑㄩㄝˋ,qiān zhēn wàn què
12233,前座,7,,3,1,4,ㄑㄧㄢˊ ㄗㄨㄛˋ,qián zuò
12234,嗆,7,,4,4,8,ㄑㄧㄤˋ,qiàng
12235,槍斃,7,,4,0,4,ㄑㄧㄤ ㄅㄧˋ,qiāng bì
12236,強固,7,,3,0,3,ㄑㄧㄤˊ ㄍㄨˋ,qiáng gù
12237,強加,7,,3,1,4,ㄑㄧㄤˊ ㄐㄧㄚ,qiáng jiā
12238,強姦,7,,5,1,6,ㄑㄧㄤˊ ㄐㄧㄢ,qiáng jiān
12239,強勁,7,,6,7,13,ㄑㄧㄤˊ ㄐㄧㄥˋ,qiáng jìng
12240,強求,7,,4,2,6,ㄑㄧㄤˇ ㄑㄧㄡˊ,qiǎng qiú
12241,槍殺,7,,3,2,5,ㄑㄧㄤ ㄕㄚ,qiāng shā
12242,強項,7,,7,1,8,ㄑㄧㄤˊ ㄒㄧㄤˋ,qiáng xiàng
12243,搶眼,7,,3,1,4,ㄑㄧㄤˇ ㄧㄢˇ,qiǎng yǎn
12244,槍枝,7,,4,5,9,ㄑㄧㄤ ㄓ,qiāng zhī
12245,峭壁,7,,6,2,8,ㄑㄧㄠˋ ㄅㄧˋ,qiào bì
12246,敲定,7,,2,2,4,ㄑㄧㄠ ㄉㄧㄥˋ,qiāo dìng
12247,敲擊,7,,4,1,5,ㄑㄧㄠ ㄐㄧˊ,qiāo jí
12248,竅門,7,,3,1,4,ㄑㄧㄠˋ ㄇㄣˊ,qiào mén
12249,橋牌,7,,4,0,4,ㄑㄧㄠˊ ㄆㄞˊ,qiáo pái
12250,俏皮,7,,3,1,4,ㄑㄧㄠˋ ㄆㄧˊ,qiào pí
12251,悄悄話,7,,3,0,3,ㄑㄧㄠˇ ㄑㄧㄠˇ ㄏㄨㄚˋ,qiǎo qiǎo huà
12252,悄然,7,,5,1,6,ㄑㄧㄠˇ ㄖㄢˊ,qiǎo rán
12253,巧思,7,,4,6,10,ㄑㄧㄠˇ ㄙ,qiǎo sī
12254,巧遇,7,,3,3,6,ㄑㄧㄠˇ ㄩˋ,qiǎo yù
12255,敲詐,7,,4,0,4,ㄑㄧㄠ ㄓㄚˋ,qiāo zhà
12256,妾,7,,12,1,13,ㄑㄧㄝˋ,qiè
12257,切磋,7,,3,2,5,ㄑㄧㄝ ㄘㄨㄛ,qiē cuō
12258,鍥而不捨,7,,5,4,9,ㄑㄧㄝˋ ㄦˊ ㄅㄨˋ ㄕㄜˇ,qiè ér bù shě
12259,切割,7,,6,9,15,ㄑㄧㄝ ㄍㄜ,qiē gē
12260,切合,7,,3,1,4,ㄑㄧㄝˋ ㄏㄜˊ,qiè hé
12261,切忌,7,,3,0,3,ㄑㄧㄝˋ ㄐㄧˋ,qiè jì
12262,竊竊私語,7,,4,1,5,ㄑㄧㄝˋ ㄑㄧㄝˋ ㄙ ㄩˇ,qiè qiè sī yǔ
12263,切身,7,,4,2,6,ㄑㄧㄝˋ ㄕㄣ,qiè shēn
12264,切實,7,,5,1,6,ㄑㄧㄝˋ ㄕˊ,qiè shí
12265,切勿,7,,3,0,3,ㄑㄧㄝˋ ㄨˋ,qiè wù
12266,竊喜,7,,1,0,1,ㄑㄧㄝˋ ㄒㄧˇ,qiè xǐ
12267,竊笑,7,,2,0,2,ㄑㄧㄝˋ ㄒㄧㄠˋ,qiè xiào
12268,愜意,7,,5,2,7,ㄑㄧㄝˋ ㄧˋ,qiè yì
12269,竊賊,7,,4,2,6,ㄑㄧㄝˋ ㄗㄟˊ,qiè zéi
12270,擒,7,,7,0,7,ㄑㄧㄣˊ,qín
12271,秦朝,7,,5,1,6,ㄑㄧㄣˊ ㄔㄠˊ,qín cháo
12272,勤儉,7,,3,8,11,ㄑㄧㄣˊ ㄐㄧㄢˇ,qín jiǎn
12273,親臨,7,,4,2,6,ㄑㄧㄣ ㄌㄧㄣˊ,qīn lín
12274,勤勉,7,,3,1,4,ㄑㄧㄣˊ ㄇㄧㄢˇ,qín miǎn
12275,侵擾,7,,4,4,8,ㄑㄧㄣ ㄖㄠˇ,qīn rǎo
12276,侵蝕,7,,6,19,25,ㄑㄧㄣ ㄕˊ,qīn shí
12277,親事,7,,4,0,4,ㄑㄧㄣ ㄕˋ,qīn shì
12278,禽獸,7,,7,1,8,ㄑㄧㄣˊ ㄕㄡˋ,qín shòu
12279,親王,7,,26,2,28,ㄑㄧㄣ ㄨㄤˊ,qīn wáng
12280,勤於,7,,3,2,5,ㄑㄧㄣˊ ㄩˊ,qín yú
12281,親耳,7,,2,0,2,ㄑㄧㄣㄦˇ,qīněr
12282,情不自禁,7,,6,1,7,ㄑㄧㄥˊ ㄅㄨˊ ㄗˋ ㄐㄧㄣ,qíng bú zì jīn
12283,情場,7,,3,1,4,ㄑㄧㄥˊ ㄔㄤˇ,qíng chǎng
12284,清朝,7,,53,14,67,ㄑㄧㄥ ㄔㄠˊ,qīng cháo
12285,青翠,7,,2,3,5,ㄑㄧㄥ ㄘㄨㄟˋ,qīng cuì
12286,傾倒2,7,,4,5,9,ㄑㄧㄥ ㄉㄠˋ,qīng dào
12287,傾倒1,7,,4,5,9,ㄑㄧㄥ ㄉㄠˇ,qīng dǎo
12288,情調,7,,4,1,5,ㄑㄧㄥˊ ㄉㄧㄠˋ,qíng diào
12289,清風,7,,5,2,7,ㄑㄧㄥ ㄈㄥ,qīng fēng
12290,清高,7,,2,1,3,ㄑㄧㄥ ㄍㄠ,qīng gāo
12291,青紅皂白,7,,2,2,4,ㄑㄧㄥ ㄏㄨㄥˊ ㄗㄠˋ ㄅㄞˊ,qīng hóng zào bái
12292,輕忽,7,,5,4,9,ㄑㄧㄥ ㄏㄨ,qīng hū
12293,情懷,7,,9,9,18,ㄑㄧㄥˊ ㄏㄨㄞˊ,qíng huái
12294,情急,7,,3,1,4,ㄑㄧㄥˊ ㄐㄧˊ,qíng jí
12295,輕舉妄動,7,,3,2,5,ㄑㄧㄥ ㄐㄩˇ ㄨㄤˋ ㄉㄨㄥˋ,qīng jǔ wàng dòng
12296,頃刻,7,,4,1,5,ㄑㄧㄥˇ ㄎㄜˋ,qǐng kè
12297,情理,7,,6,1,7,ㄑㄧㄥˊ ㄌㄧˇ,qíng lǐ
12298,清廉,7,,3,1,4,ㄑㄧㄥ ㄌㄧㄢˊ,qīng lián
12299,輕描淡寫,7,,4,3,7,ㄑㄧㄥ ㄇㄧㄠˊ ㄉㄢˋ ㄒㄧㄝˇ,qīng miáo dàn xiě
12300,輕蔑,7,,10,0,10,ㄑㄧㄥ ㄇㄧㄝˋ,qīng miè
12301,傾盆大雨,7,,3,2,5,ㄑㄧㄥ ㄆㄣˊ ㄉㄚˋ ㄩˇ,qīng pén dà yǔ
12302,輕飄飄,7,,2,1,3,ㄑㄧㄥ ㄆㄧㄠ ㄆㄧㄠ,qīng piāo piāo
12303,輕巧,7,,4,4,8,ㄑㄧㄥ ㄑㄧㄠˇ,qīng qiǎo
12304,青澀,7,,2,2,4,ㄑㄧㄥ ㄙㄜˋ,qīng sè
12305,傾身,7,,3,0,3,ㄑㄧㄥ ㄕㄣ,qīng shēn
12306,情事,7,,4,0,4,ㄑㄧㄥˊ ㄕˋ,qíng shì
12307,請示,7,,6,1,7,ㄑㄧㄥˇ ㄕˋ,qǐng shì
12308,青史,7,,2,0,2,ㄑㄧㄥ ㄕˇ,qīng shǐ
12309,清算,7,,3,1,4,ㄑㄧㄥ ㄙㄨㄢˋ,qīng suàn
12310,青苔,7,,3,5,8,ㄑㄧㄥ ㄊㄞˊ,qīng tái
12311,青天,7,,4,0,4,ㄑㄧㄥ ㄊㄧㄢ,qīng tiān
12312,晴天霹靂,7,,2,1,3,ㄑㄧㄥˊ ㄊㄧㄢ ㄆㄧ ㄌㄧˋ,qíng tiān pī lì
12313,傾吐,7,,4,1,5,ㄑㄧㄥ ㄊㄨˇ,qīng tǔ
12314,輕信,7,,2,0,2,ㄑㄧㄥ ㄒㄧㄣˋ,qīng xìn
12315,傾心,7,,3,0,3,ㄑㄧㄥ ㄒㄧㄣ,qīng xīn
12316,清秀,7,,4,1,5,ㄑㄧㄥ ㄒㄧㄡˋ,qīng xiù
12317,傾軋,7,,3,0,3,ㄑㄧㄥ ㄧㄚˋ,qīng yà
12318,輕言,7,,3,1,4,ㄑㄧㄥ ㄧㄢˊ,qīng yán
12319,情意,7,,7,3,10,ㄑㄧㄥˊ ㄧˋ,qíng yì
12320,請益,7,,2,1,3,ㄑㄧㄥˇ ㄧˋ,qǐng yì
12321,清一色,7,,3,1,4,ㄑㄧㄥ ㄧˊ ㄙㄜˋ,qīng yí sè
12322,輕盈,7,,7,2,9,ㄑㄧㄥ ㄧㄥˊ,qīng yíng
12323,情慾/情欲,7,,8,1,9,ㄑㄧㄥˊ ㄩˋ,qíng yù
12324,請願,7,,5,1,6,ㄑㄧㄥˇ ㄩㄢˋ,qǐng yuàn
12325,傾注,7,,3,1,4,ㄑㄧㄥ ㄓㄨˋ,qīng zhù
12326,輕撫,7,,3,1,4,ㄑㄧㄥㄈㄨˇ,qīngfǔ
12327,窮鄉僻壤,7,,2,3,5,ㄑㄩㄥˊ ㄒㄧㄤ ㄆㄧˋ ㄖㄤˇ,qióng xiāng pì rǎng
12328,求教,7,,3,1,4,ㄑㄧㄡˊ ㄐㄧㄠˋ,qiú jiào
12329,丘陵,7,,4,6,10,ㄑㄧㄡ ㄌㄧㄥˊ,qiū líng
12330,求取,7,,4,2,6,ㄑㄧㄡˊ ㄑㄩˇ,qiú qǔ
12331,求饒,7,,4,1,5,ㄑㄧㄡˊ ㄖㄠˊ,qiú ráo
12332,求醫,7,,3,2,5,ㄑㄧㄡˊ ㄧ,qiú yī
12333,蚯蚓,7,,4,12,16,ㄑㄧㄡ ㄧㄣˇ,qiū yǐn
12334,求診,7,,3,4,7,ㄑㄧㄡˊ ㄓㄣˇ,qiú zhěn
12335,求證,7,,4,1,5,ㄑㄧㄡˊ ㄓㄥˋ,qiú zhèng
12336,求之不得,7,,2,1,3,ㄑㄧㄡˊ ㄓ ㄅㄨˋ ㄉㄜˊ,qiú zhī bù dé
12337,驅車,7,,4,1,5,ㄑㄩ ㄔㄜ,qū chē
12338,屈從,7,,3,0,3,ㄑㄩ ㄘㄨㄥˊ,qū cóng
12339,驅趕,7,,4,6,10,ㄑㄩ ㄍㄢˇ,qū gǎn
12340,取暖,7,,4,4,8,ㄑㄩˇ ㄋㄨㄢˇ,qǔ nuǎn
12341,屈辱,7,,7,1,8,ㄑㄩ ㄖㄨˋ,qū rù
12342,驅散,7,,3,1,4,ㄑㄩ ㄙㄢˋ,qū sàn
12343,趣事,7,,3,1,4,ㄑㄩˋ ㄕˋ,qù shì
12344,屈膝,7,,3,0,3,ㄑㄩ ㄒㄧ,qū xī
12345,去向,7,,3,0,3,ㄑㄩˋ ㄒㄧㄤˋ,qù xiàng
12346,取樣,7,,3,2,5,ㄑㄩˇ ㄧㄤˋ,qǔ yàng
12347,曲2,7,,21,10,31,ㄑㄩ,qū/
12348,拳打腳踢,7,,3,0,3,ㄑㄩㄢˊ ㄉㄚˇ ㄐㄧㄠˇ ㄊㄧ,quán dǎ jiǎo tī
12349,勸導,7,,3,3,6,ㄑㄩㄢˋ ㄉㄠˇ,quàn dǎo
12350,權貴,7,,6,0,6,ㄑㄩㄢˊ ㄍㄨㄟˋ,quán guì
12351,權衡,7,,3,1,4,ㄑㄩㄢˊ ㄏㄥˊ,quán héng
12352,拳擊,7,,4,3,7,ㄑㄩㄢˊ ㄐㄧˊ,quán jí
12353,全軍覆沒,7,,4,1,5,ㄑㄩㄢˊ ㄐㄩㄣ ㄈㄨˋ ㄇㄛˋ,quán jūn fù mò
12354,全力以赴,7,,6,7,13,ㄑㄩㄢˊ ㄌㄧˋ ㄧˇ ㄈㄨˋ,quán lì yǐ fù
12355,全貌,7,,4,1,5,ㄑㄩㄢˊ ㄇㄠˋ,quán mào
12356,蜷曲,7,,2,1,3,ㄑㄩㄢˊ ㄑㄩ,quán qū
12357,全盛,7,,3,3,6,ㄑㄩㄢˊ ㄕㄥˋ,quán shèng
12358,蜷縮,7,,3,1,4,ㄑㄩㄢˊ ㄙㄨㄛ,quán suō
12359,圈套,7,,5,1,6,ㄑㄩㄢ ㄊㄠˋ,quān tào
12360,權位,7,,3,1,4,ㄑㄩㄢˊ ㄨㄟˋ,quán wèi
12361,泉湧,7,,3,1,4,ㄑㄩㄢˊ ㄩㄥˇ,quán yǒng
12362,泉源,7,,5,3,8,ㄑㄩㄢˊ ㄩㄢˊ,quán yuán
12363,卻步,7,,2,1,3,ㄑㄩㄝˋ ㄅㄨˋ,què bù
12364,缺憾,7,,4,3,7,ㄑㄩㄝ ㄏㄢˋ,quē hàn
12365,怯懦,7,,3,0,3,ㄑㄩㄝˋ ㄋㄨㄛˋ,què nuò
12366,雀躍,7,,6,1,7,ㄑㄩㄝˋ ㄩㄝˋ,què yuè
12367,確鑿,7,,4,1,5,ㄑㄩㄝˋ ㄗㄠˊ,què záo
12368,群聚,7,,3,4,7,ㄑㄩㄣˊ ㄐㄩˋ,qún jù
12369,趨前,7,,3,0,3,ㄑㄩㄑㄧㄢˊ,qūqián
12370,繞道,7,,4,2,6,ㄖㄠˋ ㄉㄠˋ,rào dào
12371,饒富,7,,2,1,3,ㄖㄠˊ ㄈㄨˋ,ráo fù
12372,饒恕,7,,3,1,4,ㄖㄠˊ ㄕㄨˋ,ráo shù
12373,繞行,7,,3,2,5,ㄖㄠˋ ㄒㄧㄥˊ,rào xíng
12374,熱誠,7,,6,3,9,ㄖㄜˋ ㄔㄥˊ,rè chéng
12375,惹禍,7,,3,1,4,ㄖㄜˇ ㄏㄨㄛˋ,rě huò
12376,熱淚,7,,3,1,4,ㄖㄜˋ ㄌㄟˋ,rè lèi
12377,熱淚盈眶,7,,3,2,5,ㄖㄜˋ ㄌㄟˋ ㄧㄥˊ ㄎㄨㄤ,rè lèi yíng kuāng
12378,熱戀,7,,3,1,4,ㄖㄜˋ ㄌㄧㄢˋ,rè liàn
12379,熱絡,7,,4,4,8,ㄖㄜˋ ㄌㄨㄛˋ,rè luò
12380,惹惱,7,,3,1,4,ㄖㄜˇ ㄋㄠˇ,rě nǎo
12381,熱騰騰,7,,5,7,12,ㄖㄜˋ ㄊㄥˊ ㄊㄥˊ,rè téng téng
12382,人本,7,,5,2,7,ㄖㄣˊ ㄅㄣˇ,rén běn
12383,人稱,7,,3,1,4,ㄖㄣˊ ㄔㄥ,rén chēng
12384,人和,7,,4,2,6,ㄖㄣˊ ㄏㄜˊ,rén hé
12385,人跡,7,,3,1,4,ㄖㄣˊ ㄐㄧ,rén jī
12386,人來人往,7,,2,1,3,ㄖㄣˊ ㄌㄞˊ ㄖㄣˊ ㄨㄤˇ,rén lái rén wǎng
12387,人面,7,,3,6,9,ㄖㄣˊ ㄇㄧㄢˋ,rén miàn
12388,認命,7,,4,6,10,ㄖㄣˋ ㄇㄧㄥˋ,rèn mìng
12389,人品,7,,5,2,7,ㄖㄣˊ ㄆㄧㄣˇ,rén pǐn
12390,忍氣吞聲,7,,3,0,3,ㄖㄣˇ ㄑㄧˋ ㄊㄨㄣ ㄕㄥ,rěn qì tūn shēng
12391,人像,7,,3,1,4,ㄖㄣˊ ㄒㄧㄤˋ,rén xiàng
12392,人心惶惶,7,,2,3,5,ㄖㄣˊ ㄒㄧㄣ ㄏㄨㄤˊ ㄏㄨㄤˊ,rén xīn huáng huáng
12393,人煙,7,,5,3,8,ㄖㄣˊ ㄧㄢ,rén yān
12394,人云亦云,7,,3,1,4,ㄖㄣˊ ㄩㄣˊ ㄧˋ ㄩㄣˊ,rén yún yì yún
12395,認證,7,,4,38,42,ㄖㄣˋ ㄓㄥˋ,rèn zhèng
12396,人種,7,,7,4,11,ㄖㄣˊ ㄓㄨㄥˇ,rén zhǒng
12397,日復一日,7,,6,3,9,ㄖˋ ㄈㄨˋ ㄧˊ ㄖˋ,rì fù yí rì
12398,日積月累,7,,3,3,6,ㄖˋ ㄐㄧ ㄩㄝˋ ㄌㄟˇ,rì jī yuè lěi
12399,日曆,7,,4,1,5,ㄖˋ ㄌㄧˋ,rì lì
12400,日前,7,,4,4,8,ㄖˋ ㄑㄧㄢˊ,rì qián
12401,日曬,7,,3,9,12,ㄖˋ ㄕㄞˋ,rì shài
12402,日新月異,7,,3,3,6,ㄖˋ ㄒㄧㄣ ㄩㄝˋ ㄧˋ,rì xīn yuè yì
12403,日誌,7,,6,3,9,ㄖˋ ㄓˋ,rì zhì
12404,容光煥發,7,,3,2,5,ㄖㄨㄥˊ ㄍㄨㄤ ㄏㄨㄢˋ ㄈㄚ,róng guāng huàn fā
12405,溶化,7,,2,3,5,ㄖㄨㄥˊ ㄏㄨㄚˋ,róng huà
12406,榮華富貴,7,,4,1,5,ㄖㄨㄥˊ ㄏㄨㄚˊ ㄈㄨˋ ㄍㄨㄟˋ,róng huá fù guì
12407,融會貫通,7,,3,1,4,ㄖㄨㄥˊ ㄏㄨㄟˋ ㄍㄨㄢˋ ㄊㄨㄥ,róng huì guàn tōng
12408,榮獲,7,,5,5,10,ㄖㄨㄥˊ ㄏㄨㄛˋ,róng huò
12409,溶解,7,,3,15,18,ㄖㄨㄥˊ ㄐㄧㄝˇ,róng jiě
12410,絨毛,7,,3,3,6,ㄖㄨㄥˊ ㄇㄠˊ,róng máo
12411,容顏,7,,3,2,5,ㄖㄨㄥˊ ㄧㄢˊ,róng yán
12412,蹂躪,7,,4,1,5,ㄖㄡˊ ㄌㄧㄣˋ,róu lìn
12413,柔情,7,,5,2,7,ㄖㄡˊ ㄑㄧㄥˊ,róu qíng
12414,柔弱,7,,4,2,6,ㄖㄡˊ ㄖㄨㄛˋ,róu ruò
12415,柔順,7,,4,1,5,ㄖㄡˊ ㄕㄨㄣˋ,róu shùn
12416,肉眼,7,,6,9,15,ㄖㄡˋ ㄧㄢˇ,ròu yǎn
12417,汝,7,,13,6,19,ㄖㄨˇ,rǔ
12418,如常,7,,3,1,4,ㄖㄨˊ ㄔㄤˊ,rú cháng
12419,如出一轍,7,,4,1,5,ㄖㄨˊ ㄔㄨ ㄧ ㄔㄜˋ,rú chū yī chè
12420,蠕動,7,,7,4,11,ㄖㄨˊ ㄉㄨㄥˋ,rú dòng
12421,如法炮製,7,,3,1,4,ㄖㄨˊ ㄈㄚˇ ㄆㄠˊ ㄓˋ,rú fǎ páo zhì
12422,如火如荼,7,,3,1,4,ㄖㄨˊ ㄏㄨㄛˇ ㄖㄨˊ ㄊㄨˊ,rú huǒ rú tú
12423,辱罵,7,,5,1,6,ㄖㄨˋ ㄇㄚˋ,rù mà
12424,入迷,7,,3,2,5,ㄖㄨˋ ㄇㄧˊ,rù mí
12425,如日中天,7,,2,0,2,ㄖㄨˊ ㄖˋ ㄓㄨㄥ ㄊㄧㄢ,rú rì zhōng tiān
12426,如實,7,,4,3,7,ㄖㄨˊ ㄕˊ,rú shí
12427,如釋重負,7,,4,1,5,ㄖㄨˊ ㄕˋ ㄓㄨㄥˋ ㄈㄨˋ,rú shì zhòng fù
12428,入手,7,,3,1,4,ㄖㄨˋ ㄕㄡˇ,rù shǒu
12429,如數家珍,7,,2,2,4,ㄖㄨˊ ㄕㄨˇ ㄐㄧㄚ ㄓㄣ,rú shǔ jiā zhēn
12430,入微,7,,3,0,3,ㄖㄨˋ ㄨㄟˊ,rù wéi
12431,入伍,7,,4,0,4,ㄖㄨˋ ㄨˇ,rù wǔ
12432,如影隨形,7,,2,1,3,ㄖㄨˊ ㄧㄥˇ ㄙㄨㄟˊ ㄒㄧㄥˊ,rú yǐng suí xíng
12433,如願以償,7,,3,1,4,ㄖㄨˊ ㄩㄢˋ ㄧˇ ㄔㄤˊ,rú yuàn yǐ cháng
12434,軟禁,7,,4,2,6,ㄖㄨㄢˇ ㄐㄧㄣˋ,ruǎn jìn
12435,銳減,7,,2,6,8,ㄖㄨㄟˋ ㄐㄧㄢˇ,ruì jiǎn
12436,睿智,7,,6,1,7,ㄖㄨㄟˋ ㄓˋ,ruì zhì
12437,偌大,7,,4,2,6,ㄖㄨㄛˋ ㄉㄚˋ,ruò dà
12438,撒嬌,7,,4,8,12,ㄙㄚ ㄐㄧㄠ,sā jiāo
12439,撒手,7,,3,1,4,ㄙㄚ ㄕㄡˇ,sā shǒu
12440,腮,7,,4,1,5,ㄙㄞ,sāi
12441,賽車,7,,5,3,8,ㄙㄞˋ ㄔㄜ,sài chē
12442,賽馬,7,,4,1,5,ㄙㄞˋ ㄇㄚˇ,sài mǎ
12443,三部曲,7,,3,1,4,ㄙㄢ ㄅㄨˋ ㄑㄩˇ,sān bù qǔ
12444,三國演義,7,,24,1,25,ㄙㄢ ㄍㄨㄛˊ ㄧㄢˇ ㄧˋ,sān guó yǎn yì
12445,散漫,7,,3,1,4,ㄙㄢˇ ㄇㄢˋ,sǎn màn
12446,三思,7,,4,1,5,ㄙㄢ ㄙ,sān sī
12447,喪命,7,,6,14,20,ㄙㄤˋ ㄇㄧㄥˋ,sàng mìng
12448,喪氣,7,,4,2,6,ㄙㄤˋ ㄑㄧˋ,sàng qì
12449,搔,7,,7,1,8,ㄙㄠ,sāo
12450,掃蕩,7,,3,3,6,ㄙㄠˇ ㄉㄤˋ,sǎo dàng
12451,騷亂,7,,3,1,4,ㄙㄠ ㄌㄨㄢˋ,sāo luàn
12452,掃視,7,,4,0,4,ㄙㄠˇ ㄕˋ,sǎo shì
12453,掃興,7,,3,2,5,ㄙㄠˇ ㄒㄧㄥˋ,sǎo xìng
12454,色調,7,,4,1,5,ㄙㄜˋ ㄉㄧㄠˋ,sè diào
12455,色澤,7,,7,8,15,ㄙㄜˋ ㄗㄜˊ,sè zé
12456,森嚴,7,,4,2,6,ㄙㄣ ㄧㄢˊ,sēn yán
12457,僧侶,7,,5,15,20,ㄙㄥ ㄌㄩˇ,sēng lǚ
12458,煞2,7,,4,4,8,ㄕㄚˋ,shà
12459,煞1,7,,4,4,8,ㄕㄚ,shā
12460,紗,7,,3,9,12,ㄕㄚ,shā
12461,沙場,7,,3,1,4,ㄕㄚ ㄔㄤˇ,shā chǎng
12462,沙地,7,,4,3,7,ㄕㄚ ㄉㄧˋ,shā dì
12463,殺機,7,,2,0,2,ㄕㄚ ㄐㄧ,shā jī
12464,沙龍,7,,4,4,8,ㄕㄚ ㄌㄨㄥˊ,shā lóng
12465,殺戮,7,,7,4,11,ㄕㄚ ㄌㄨˋ,shā lù
12466,殺人犯,7,,5,0,5,ㄕㄚ ㄖㄣˊ ㄈㄢˋ,shā rén fàn
12467,殺身,7,,4,1,5,ㄕㄚ ㄕㄣ,shā shēn
12468,霎時,7,,5,1,6,ㄕㄚˋ ㄕˊ,shà shí
12469,殺頭,7,,4,1,5,ㄕㄚ ㄊㄡˊ,shā tóu
12470,煞有介事,7,,2,0,2,ㄕㄚˋ ㄧㄡˇ ㄐㄧㄝˋ ㄕˋ,shà yǒu jiè shì
12471,閃動,7,,3,0,3,ㄕㄢˇ ㄉㄨㄥˋ,shǎn dòng
12472,山河,7,,5,1,6,ㄕㄢ ㄏㄜˊ,shān hé
12473,善後,7,,5,2,7,ㄕㄢˋ ㄏㄡˋ,shàn hòu
12474,珊瑚,7,,4,61,65,ㄕㄢ ㄏㄨˊ,shān hú
12475,善解人意,7,,2,1,3,ㄕㄢˋ ㄐㄧㄝˇ ㄖㄣˊ ㄧˋ,shàn jiě rén yì
12476,山嶺,7,,4,1,5,ㄕㄢ ㄌㄧㄥˇ,shān lǐng
12477,山麓,7,,3,3,6,ㄕㄢ ㄌㄨˋ,shān lù
12478,山巒,7,,4,1,5,ㄕㄢ ㄌㄨㄢˊ,shān luán
12479,善事,7,,3,3,6,ㄕㄢˋ ㄕˋ,shàn shì
12480,閃現,7,,3,0,3,ㄕㄢˇ ㄒㄧㄢˋ,shǎn xiàn
12481,山腰,7,,4,1,5,ㄕㄢ ㄧㄠ,shān yāo
12482,山野,7,,5,1,6,ㄕㄢ ㄧㄝˇ,shān yě
12483,擅於,7,,4,1,5,ㄕㄢˋ ㄩˊ,shàn yú
12484,山岳,7,,2,0,2,ㄕㄢ ㄩㄝˋ,shān yuè
12485,山珍海味,7,,3,3,6,ㄕㄢ ㄓㄣ ㄏㄞˇ ㄨㄟˋ,shān zhēn hǎi wèi
12486,傷疤,7,,3,1,4,ㄕㄤ ㄅㄚ,shāng bā
12487,上蒼,7,,4,4,8,ㄕㄤˋ ㄘㄤ,shàng cāng
12488,上策,7,,3,1,4,ㄕㄤˋ ㄘㄜˋ,shàng cè
12489,商朝,7,,2,1,3,ㄕㄤ ㄔㄠˊ,shāng cháo
12490,上吊,7,,6,1,7,ㄕㄤˋ ㄉㄧㄠˋ,shàng diào
12491,傷痕,7,,6,7,13,ㄕㄤ ㄏㄣˊ,shāng hén
12492,尚可,7,,3,0,3,ㄕㄤˋ ㄎㄜˇ,shàng kě
12493,尚且,7,,5,1,6,ㄕㄤˋ ㄑㄧㄝˇ,shàng qiě
12494,商榷,7,,2,1,3,ㄕㄤ ㄑㄩㄝˋ,shāng què
12495,上乘,7,,3,1,4,ㄕㄤˋ ㄕㄥˋ,shàng shèng
12496,上昇,7,,4,1,5,ㄕㄤˋ ㄕㄥ,shàng shēng
12497,上書,7,,15,1,16,ㄕㄤˋ ㄕㄨ,shàng shū
12498,賞賜,7,,11,1,12,ㄕㄤˇ ㄙˋ,shǎng sì
12499,商談,7,,3,1,4,ㄕㄤ ㄊㄢˊ,shāng tán
12500,傷透,7,,3,3,6,ㄕㄤ ㄊㄡˋ,shāng tòu
12501,上尉,7,,10,1,11,ㄕㄤˋ ㄨㄟˋ,shàng wèi
12502,上校,7,,32,1,33,ㄕㄤˋ ㄒㄧㄠˋ,shàng xiào
12503,賞心悅目,7,,3,3,6,ㄕㄤˇ ㄒㄧㄣ ㄩㄝˋ ㄇㄨˋ,shǎng xīn yuè mù
12504,上漲,7,,12,12,24,ㄕㄤˋ ㄓㄤˇ,shàng zhǎng
12505,上陣,7,,4,1,5,ㄕㄤˋ ㄓㄣˋ,shàng zhèn
12506,勺,7,,4,1,5,ㄕㄠˊ,sháo
12507,少婦,7,,5,1,6,ㄕㄠˋ ㄈㄨˋ,shào fù
12508,燒毀,7,,7,6,13,ㄕㄠ ㄏㄨㄟˇ,shāo huǐ
12509,少校,7,,11,0,11,ㄕㄠˋ ㄒㄧㄠˋ,shào xiào
12510,少之又少,7,,4,2,6,ㄕㄠˇ ㄓ  ㄧㄡˋ ㄕㄠˇ,shǎo zhī yòu shǎo
12511,稍作,7,,2,1,3,ㄕㄠ ㄗㄨㄛˋ,shāo zuò
12512,設防,7,,3,1,4,ㄕㄜˋ ㄈㄤˊ,shè fáng
12513,社稷,7,,5,1,6,ㄕㄜˋ ㄐㄧˋ,shè jì
12514,涉獵,7,,3,2,5,ㄕㄜˋ ㄌㄧㄝˋ,shè liè
12515,社論,7,,8,1,9,ㄕㄜˋ ㄌㄨㄣˋ,shè lùn
12516,赦免/赦,7,,10,1,11,ㄕㄜˋ ㄇㄧㄢˇ/ㄕㄜˋ,shè miǎn/shè
12517,射殺,7,,5,3,8,ㄕㄜˋ ㄕㄚ,shè shā
12518,設身處地,7,,4,2,6,ㄕㄜˋ ㄕㄣ ㄔㄨˇ ㄉㄧˋ,shè shēn chǔ dì
12519,涉水,7,,4,6,10,ㄕㄜˋ ㄕㄨㄟˇ,shè shuǐ
12520,奢望,7,,3,1,4,ㄕㄜ ㄨㄤˋ,shē wàng
12521,涉嫌,7,,4,2,6,ㄕㄜˋ ㄒㄧㄢˊ,shè xián
12522,設限,7,,3,3,6,ㄕㄜˋ ㄒㄧㄢˋ,shè xiàn
12523,設宴,7,,4,0,4,ㄕㄜˋ ㄧㄢˋ,shè yàn
12524,深奧,7,,6,4,10,ㄕㄣ ㄠˋ,shēn ào
12525,身敗名裂,7,,2,0,2,ㄕㄣ ㄅㄞˋ ㄇㄧㄥˊ ㄌㄧㄝˋ,shēn bài míng liè
12526,身不由己,7,,3,1,4,ㄕㄣ ㄅㄨˋ ㄧㄡˊ ㄐㄧˇ,shēn bù yóu jǐ
12527,神采,7,,3,1,4,ㄕㄣˊ ㄘㄞˇ,shén cǎi
12528,神采奕奕,7,,3,1,4,ㄕㄣˊ ㄘㄞˇ ㄧˋ ㄧˋ,shén cǎi yì yì
12529,身段,7,,5,12,17,ㄕㄣ ㄉㄨㄢˋ,shēn duàn
12530,深廣,7,,2,0,2,ㄕㄣ ㄍㄨㄤˇ,shēn guǎng
12531,甚或,7,,9,1,10,ㄕㄣˋ ㄏㄨㄛˋ,shèn huò
12532,身家,7,,3,1,4,ㄕㄣ ㄐㄧㄚ,shēn jiā
12533,身教,7,,6,4,10,ㄕㄣ ㄐㄧㄠˋ,shēn jiào
12534,深究,7,,4,1,5,ㄕㄣ ㄐㄧㄡˋ,shēn jiù
12535,深覺,7,,2,1,3,ㄕㄣ ㄐㄩㄝˊ,shēn jué
12536,審理,7,,6,2,8,ㄕㄣˇ ㄌㄧˇ,shěn lǐ
12537,神迷,7,,3,0,3,ㄕㄣˊ ㄇㄧˊ,shén mí
12538,神祇,7,,7,2,9,ㄕㄣˊ ㄑㄧˊ,shén qí
12539,神氣,7,,6,2,8,ㄕㄣˊ ㄑㄧˋ,shén qì
12540,滲入,7,,4,5,9,ㄕㄣˋ ㄖㄨˋ,shèn rù
12541,深入淺出,7,,4,1,5,ㄕㄣ ㄖㄨˋ ㄑㄧㄢˇ ㄔㄨ,shēn rù qiǎn chū
12542,審慎,7,,7,3,10,ㄕㄣˇ ㄕㄣˋ,shěn shèn
12543,身受,7,,3,2,5,ㄕㄣ ㄕㄡˋ,shēn shòu
12544,身手,7,,6,4,10,ㄕㄣ ㄕㄡˇ,shēn shǒu
12545,深思熟慮,7,,6,1,7,ㄕㄣ ㄙ ㄕㄡˊ ㄌㄩˋ,shēn sī shóu lǜ
12546,深邃,7,,5,2,7,ㄕㄣ ㄙㄨㄟˋ,shēn suì
12547,深鎖,7,,3,2,5,ㄕㄣ ㄙㄨㄛˇ,shēn suǒ
12548,身體力行,7,,4,10,14,ㄕㄣ ㄊㄧˇ ㄌㄧˋ ㄒㄧㄥˊ,shēn tǐ lì xíng
12549,神通,7,,3,1,4,ㄕㄣˊ ㄊㄨㄥ,shén tōng
12550,滲透,7,,7,10,17,ㄕㄣˋ ㄊㄡˋ,shèn tòu
12551,神往,7,,3,1,4,ㄕㄣˊ ㄨㄤˇ,shén wǎng
12552,審問,7,,6,0,6,ㄕㄣˇ ㄨㄣˋ,shěn wèn
12553,深惡痛絕,7,,3,0,3,ㄕㄣ ㄨˋ ㄊㄨㄥˋ ㄐㄩㄝˊ,shēn wù tòng jué
12554,深陷,7,,4,5,9,ㄕㄣ ㄒㄧㄢˋ,shēn xiàn
12555,神像,7,,5,4,9,ㄕㄣˊ ㄒㄧㄤˋ,shén xiàng
12556,深信不疑,7,,4,1,5,ㄕㄣ ㄒㄧㄣˋ ㄅㄨˋ ㄧˊ,shēn xìn bù yí
12557,審訊,7,,7,1,8,ㄕㄣˇ ㄒㄩㄣˋ,shěn xùn
12558,審議,7,,6,1,7,ㄕㄣˇ ㄧˋ,shěn yì
12559,神遊,7,,2,0,2,ㄕㄣˊ ㄧㄡˊ,shén yóu
12560,身孕,7,,3,1,4,ㄕㄣ ㄩㄣˋ,shēn yùn
12561,深造,7,,3,2,5,ㄕㄣ ㄗㄠˋ,shēn zào
12562,伸張,7,,4,2,6,ㄕㄣ ㄓㄤ,shēn zhāng
12563,神職,7,,4,5,9,ㄕㄣˊ ㄓˊ,shén zhí
12564,神志,7,,3,0,3,ㄕㄣˊ ㄓˋ,shén zhì
12565,神智,7,,4,1,5,ㄕㄣˊ ㄓˋ,shén zhì
12566,伸直,7,,8,3,11,ㄕㄣ ㄓˊ,shēn zhí
12567,深植,7,,4,3,7,ㄕㄣ ㄓˊ,shēn zhí
12568,深重,7,,3,2,5,ㄕㄣ ㄓㄨㄥˋ,shēn zhòng
12569,盛產,7,,4,14,18,ㄕㄥˋ ㄔㄢˇ,shèng chǎn
12570,省吃儉用,7,,2,2,4,ㄕㄥˇ ㄔ ㄐㄧㄢˇ ㄩㄥˋ,shěng chī jiǎn yòng
12571,勝出,7,,3,1,4,ㄕㄥˋ ㄔㄨ,shèng chū
12572,省得,7,,2,1,3,ㄕㄥˇ ˙ㄉㄜ,shěng de
12573,勝地,7,,4,7,11,ㄕㄥˋ ㄉㄧˋ,shèng dì
12574,聖地,7,,4,8,12,ㄕㄥˋ ㄉㄧˋ,shèng dì
12575,生兒育女,7,,3,0,3,ㄕㄥ ㄦˊ ㄩˋ ㄋㄩˇ,shēng ér yù nǚ
12576,生根,7,,5,5,10,ㄕㄥ ㄍㄣ,shēng gēn
12577,昇華,7,,6,3,9,ㄕㄥ ㄏㄨㄚˊ,shēng huá
12578,升降,7,,2,3,5,ㄕㄥ ㄐㄧㄤˋ,shēng jiàng
12579,聖潔,7,,3,2,5,ㄕㄥˋ ㄐㄧㄝˊ,shèng jié
12580,牲口,7,,4,5,9,ㄕㄥ ㄎㄡˇ,shēng kǒu
12581,盛況,7,,4,4,8,ㄕㄥˋ ㄎㄨㄤˋ,shèng kuàng
12582,聲浪,7,,4,10,14,ㄕㄥ ㄌㄤˋ,shēng làng
12583,勝利在望,7,,0,0,0,ㄕㄥˋ ㄌㄧˋ ㄗㄞˋ ㄨㄤˋ,shèng lì zài wàng
12584,生靈,7,,3,3,6,ㄕㄥ ㄌㄧㄥˊ,shēng líng
12585,生龍活虎,7,,2,1,3,ㄕㄥ ㄌㄨㄥˊ ㄏㄨㄛˊ ㄏㄨˇ,shēng lóng huó hǔ
12586,生路,7,,4,2,6,ㄕㄥ ㄌㄨˋ,shēng lù
12587,省略,7,,4,0,4,ㄕㄥˇ ㄌㄩㄝˋ,shěng lüè
12588,盛名,7,,5,3,8,ㄕㄥˋ ㄇㄧㄥˊ,shèng míng
12589,盛怒,7,,4,0,4,ㄕㄥˋ ㄋㄨˋ,shèng nù
12590,生氣勃勃,7,,2,2,4,ㄕㄥ ㄑㄧˋ ㄅㄛˊ ㄅㄛˊ,shēng qì bó bó
12591,生人,7,,3,3,6,ㄕㄥ ㄖㄣˊ,shēng rén
12592,聲色,7,,5,4,9,ㄕㄥ ㄙㄜˋ,shēng sè
12593,生生不息,7,,3,4,7,ㄕㄥ ㄕㄥ ㄅㄨˋ ㄒㄧˊ,shēng shēng bù xí
12594,盛世,7,,7,2,9,ㄕㄥˋ ㄕˋ,shèng shì
12595,盛事,7,,2,4,6,ㄕㄥˋ ㄕˋ,shèng shì
12596,省事,7,,2,1,3,ㄕㄥˇ ㄕˋ,shěng shì
12597,生疏,7,,3,1,4,ㄕㄥ ㄕㄨ,shēng shū
12598,聲嘶力竭,7,,3,0,3,ㄕㄥ ㄙ ㄌㄧˋ ㄐㄧㄝˊ,shēng sī lì jié
12599,勝算,7,,4,1,5,ㄕㄥˋ ㄙㄨㄢˋ,shèng suàn
12600,升天,7,,3,0,3,ㄕㄥ ㄊㄧㄢ,shēng tiān
12601,生息,7,,3,6,9,ㄕㄥ ㄒㄧˊ,shēng xí
12602,聖賢,7,,5,3,8,ㄕㄥˋ ㄒㄧㄢˊ,shèng xián
12603,生性,7,,7,2,9,ㄕㄥ ㄒㄧㄥˋ,shēng xìng
12604,盛宴,7,,3,1,4,ㄕㄥˋ ㄧㄢˋ,shèng yàn
12605,生硬,7,,3,1,4,ㄕㄥ ㄧㄥˋ,shēng yìng
12606,聲援,7,,2,3,5,ㄕㄥ ㄩㄢˊ,shēng yuán
12607,勝仗,7,,3,0,3,ㄕㄥˋ ㄓㄤˋ,shèng zhàng
12608,聖旨,7,,9,0,9,ㄕㄥˋ ㄓˇ,shèng zhǐ
12609,盛裝,7,,4,3,7,ㄕㄥˋ ㄓㄨㄤ,shèng zhuāng
12610,身居,7,,3,0,3,ㄕㄣㄐㄩ,shēnjū
12611,嗜,7,,9,1,10,ㄕˋ,shì
12612,石板,7,,7,1,8,ㄕˊ ㄅㄢˇ,shí bǎn
12613,事半功倍,7,,3,1,4,ㄕˋ ㄅㄢˋ ㄍㄨㄥ ㄅㄟˋ,shì bàn gōng bèi
12614,視察,7,,7,4,11,ㄕˋ ㄔㄚˊ,shì chá
12615,使臣,7,,7,0,7,ㄕˇ ㄔㄣˊ,shǐ chén
12616,時程,7,,3,1,4,ㄕˊ ㄔㄥˊ,shí chéng
12617,釋出,7,,5,9,14,ㄕˋ ㄔㄨ,shì chū
12618,失傳,7,,3,3,6,ㄕ ㄔㄨㄢˊ,shī chuán
12619,失措,7,,3,1,4,ㄕ ㄘㄨㄛˋ,shī cuò
12620,世道,7,,2,0,2,ㄕˋ ㄉㄠˋ,shì dào
12621,適得其反,7,,3,0,3,ㄕˋ ㄉㄜˊ ㄑㄧˊ ㄈㄢˇ,shì dé qí fǎn
12622,事端,7,,3,1,4,ㄕˋ ㄉㄨㄢ,shì duān
12623,施肥,7,,3,31,34,ㄕ ㄈㄟˊ,shī féi
12624,侍奉,7,,6,1,7,ㄕˋ ㄈㄥˋ,shì fèng
12625,世故,7,,6,2,8,ㄕˋ ㄍㄨˋ,shì gù
12626,屍骨,7,,4,1,5,ㄕ ㄍㄨˇ,shī gǔ
12627,侍候,7,,6,0,6,ㄕˋ ㄏㄡˋ,shì hòu
12628,釋懷,7,,4,4,8,ㄕˋ ㄏㄨㄞˊ,shì huái
12629,使喚,7,,5,0,5,ㄕˇ ㄏㄨㄢˋ,shǐ huàn
12630,實惠,7,,3,3,6,ㄕˊ ㄏㄨㄟˋ,shí huì
12631,詩集,7,,6,1,7,ㄕ ㄐㄧˊ,shī jí
12632,視角,7,,4,2,6,ㄕˋ ㄐㄧㄠˇ,shì jiǎo
12633,市郊,7,,3,4,7,ㄕˋ ㄐㄧㄠ,shì jiāo
12634,石階,7,,4,1,5,ㄕˊ ㄐㄧㄝ,shí jiē
12635,市井,7,,4,1,5,ㄕˋ ㄐㄧㄥˇ,shì jǐng
12636,時局,7,,4,1,5,ㄕˊ ㄐㄩˊ,shí jú
12637,適可而止,7,,2,1,3,ㄕˋ ㄎㄜˇ ㄦˊ ㄓˇ,shì kě ér zhǐ
12638,事例,7,,7,0,7,ㄕˋ ㄌㄧˋ,shì lì
12639,勢利,7,,3,0,3,ㄕˋ ㄌㄧˋ,shì lì
12640,使力,7,,4,1,5,ㄕˇ ㄌㄧˋ,shǐ lì
12641,食糧,7,,4,0,4,ㄕˊ ㄌㄧㄤˊ,shí liáng
12642,始料未及,7,,2,1,3,ㄕˇ ㄌㄧㄠˋ ㄨㄟˋ ㄐㄧˊ,shǐ liào wèi jí
12643,世面,7,,3,1,4,ㄕˋ ㄇㄧㄢˋ,shì miàn
12644,石磨,7,,2,1,3,ㄕˊ ㄇㄛˋ,shí mò
12645,始末,7,,4,1,5,ㄕˇ ㄇㄛˋ,shǐ mò
12646,識破,7,,4,1,5,ㄕˋ ㄆㄛˋ,shì pò
12647,士氣大振,7,,0,0,0,ㄕˋ ㄑㄧˋㄉㄚˋ ㄓㄣˋ,shì qì dà zhèn
12648,市容,7,,1,3,4,ㄕˋ ㄖㄨㄥˊ,shì róng
12649,勢如破竹,7,,2,0,2,ㄕˋ ㄖㄨˊ ㄆㄛˋ ㄓㄨˊ,shì rú pò zhú
12650,溼潤/濕潤,7,,6,8,14,ㄕ ㄖㄨㄣˋ,shī rùn
12651,示弱,7,,3,0,3,ㄕˋ ㄖㄨㄛˋ,shì ruò
12652,視若無睹,7,,3,1,4,ㄕˋ ㄖㄨㄛˋ ㄨˊ ㄉㄨˇ,shì ruò wú dǔ
12653,失色,7,,3,0,3,ㄕ ㄙㄜˋ,shī sè
12654,施捨,7,,4,2,6,ㄕ ㄕㄜˇ,shī shě
12655,失聲,7,,3,0,3,ㄕ ㄕㄥ,shī shēng
12656,時事,7,,4,2,6,ㄕˊ ㄕˋ,shí shì
12657,失事,7,,5,3,8,ㄕ ㄕˋ,shī shì
12658,實事求是,7,,4,1,5,ㄕˊ ㄕˋ ㄑㄧㄡˊ ㄕˋ,shí shì qiú shì
12659,失守,7,,4,1,5,ㄕ ㄕㄡˇ,shī shǒu
12660,屍首,7,,4,0,4,ㄕ ㄕㄡˇ,shī shǒu
12661,失手,7,,3,1,4,ㄕ ㄕㄡˇ,shī shǒu
12662,詩書,7,,3,1,4,ㄕ ㄕㄨ,shī shū
12663,誓死,7,,4,3,7,ㄕˋ ㄙˇ,shì sǐ
12664,事態,7,,7,2,9,ㄕˋ ㄊㄞˋ,shì tài
12665,失態,7,,2,0,2,ㄕ ㄊㄞˋ,shī tài
12666,仕途,7,,5,2,7,ㄕˋ ㄊㄨˊ,shì tú
12667,視網膜,7,,5,3,8,ㄕˋ ㄨㄤˇ ㄇㄛˋ,shì wǎng mò
12668,式微,7,,3,6,9,ㄕˋ ㄨㄟˊ,shì wéi
12669,侍衛,7,,12,1,13,ㄕˋ ㄨㄟˋ,shì wèi
12670,史無前例,7,,4,3,7,ㄕˇ ㄨˊ ㄑㄧㄢˊ ㄌㄧˋ,shǐ wú qián lì
12671,世襲,7,,7,2,9,ㄕˋ ㄒㄧˊ,shì xí
12672,失序,7,,2,2,4,ㄕ ㄒㄩˋ,shī xù
12673,施以,7,,6,0,6,ㄕ ㄧˇ,shī yǐ
12674,時有所聞,7,,2,0,2,ㄕˊㄧㄡˇㄙㄨㄛˇㄨㄣˊ,shí yǒu suǒ wén
12675,施予,7,,4,1,5,ㄕ ㄩˇ,shī yǔ
12676,事與願違,7,,2,0,2,ㄕˋ ㄩˇ ㄩㄢˋ ㄨㄟˊ,shì yǔ yuàn wéi
12677,施政,7,,4,4,8,ㄕ ㄓㄥˋ,shī zhèng
12678,失職,7,,2,1,3,ㄕ ㄓˊ,shī zhí
12679,食指大動,7,,0,0,0,ㄕˊ ㄓˇ ㄉㄚˋ ㄉㄨㄥˋ,shí zhǐ dà dòng
12680,示眾,7,,3,0,3,ㄕˋ ㄓㄨㄥˋ,shì zhòng
12681,始終如一,7,,2,1,3,ㄕˇ ㄓㄨㄥ ㄖㄨˊ ㄧ,shǐ zhōng rú yī
12682,時裝,7,,3,0,3,ㄕˊ ㄓㄨㄤ,shí zhuāng
12683,師資,7,,5,6,11,ㄕ ㄗ,shī zī
12684,侍從,7,,7,0,7,ㄕˋ ㄗㄨㄥˋ,shì zòng
12685,始祖,7,,5,2,7,ㄕˇ ㄗㄨˇ,shǐ zǔ
12686,失足,7,,4,2,6,ㄕ ㄗㄨˊ,shī zú
12687,始作俑者,7,,2,0,2,ㄕˇ ㄗㄨㄛˋ ㄩㄥˇ ㄓㄜˇ,shǐ zuò yǒng zhě
12688,試煉,7,,3,1,4,ㄕˋㄌㄧㄢˋ,shìliàn
12689,飾品,7,,3,2,5,ㄕˋㄆㄧㄣˇ,shìpǐn
12690,適於,7,,3,1,4,ㄕˋㄩˊ,shìyú
12691,手筆,7,,2,0,2,ㄕㄡˇ ㄅㄧˇ,shǒu bǐ
12692,收場,7,,7,4,11,ㄕㄡ ㄔㄤˇ,shōu chǎng
12693,受寵若驚,7,,3,1,4,ㄕㄡˋ ㄔㄨㄥˇ ㄖㄨㄛˋ ㄐㄧㄥ,shòu chǒng ruò jīng
12694,受創,7,,4,2,6,ㄕㄡˋ ㄔㄨㄤ,shòu chuāng
12695,首創,7,,3,1,4,ㄕㄡˇ ㄔㄨㄤˋ,shǒu chuàng
12696,首當其衝,7,,2,4,6,ㄕㄡˇ ㄉㄤ ㄑㄧˊ ㄔㄨㄥ,shǒu dāng qí chōng
12697,熟讀,7,,3,2,5,ㄕㄡˊ ㄉㄨˊ,shóu dú
12698,受罰,7,,3,0,3,ㄕㄡˋ ㄈㄚˊ,shòu fá
12699,收割,7,,5,30,35,ㄕㄡ ㄍㄜ,shōu gē
12700,受雇,7,,3,0,3,ㄕㄡˋ ㄍㄨˋ,shòu gù
12701,守候,7,,4,4,8,ㄕㄡˇ ㄏㄡˋ,shǒu hòu
12702,守護神,7,,3,4,7,ㄕㄡˇ ㄏㄨˋ ㄕㄣˊ,shǒu hù shén
12703,受惠,7,,4,10,14,ㄕㄡˋ ㄏㄨㄟˋ,shòu huì
12704,受教,7,,3,7,10,ㄕㄡˋ ㄐㄧㄠˋ,shòu jiào
12705,受驚,7,,3,0,3,ㄕㄡˋ ㄐㄧㄥ,shòu jīng
12706,收據,7,,3,4,7,ㄕㄡ ㄐㄩˋ,shōu jù
12707,手銬,7,,3,1,4,ㄕㄡˇ ㄎㄠˋ,shǒu kào
12708,首肯,7,,2,1,3,ㄕㄡˇ ㄎㄣˇ,shǒu kěn
12709,守口如瓶,7,,2,1,3,ㄕㄡˇ ㄎㄡˇ ㄖㄨˊ ㄆㄧㄥˊ,shǒu kǒu rú píng
12710,收斂,7,,6,2,8,ㄕㄡ ㄌㄧㄢˋ,shōu liàn
12711,狩獵,7,,11,3,14,ㄕㄡˋ ㄌㄧㄝˋ,shòu liè
12712,守門,7,,3,1,4,ㄕㄡˇ ㄇㄣˊ,shǒu mén
12713,受難,7,,6,6,12,ㄕㄡˋ ㄋㄢˋ,shòu nàn
12714,首腦,7,,4,2,6,ㄕㄡˇ ㄋㄠˇ,shǒu nǎo
12715,首屈一指,7,,3,2,5,ㄕㄡˇ ㄑㄩ ㄧˋ ㄓˇ,shǒu qū yì zhǐ
12716,受辱,7,,3,1,4,ㄕㄡˋ ㄖㄨˋ,shòu rù
12717,收尾,7,,2,2,4,ㄕㄡ ㄨㄟˇ,shōu wěi
12718,首尾呼應,7,,0,0,0,ㄕㄡˇ ㄨㄟˇㄏㄨ ㄧㄥˋ,shǒu wěi hū yìng
12719,手舞足蹈,7,,3,2,5,ㄕㄡˇ ㄨˇ ㄗㄨˊ ㄉㄠˋ,shǒu wǔ zú dào
12720,首選,7,,3,1,4,ㄕㄡˇ ㄒㄩㄢˇ,shǒu xuǎn
12721,瘦削,7,,4,0,4,ㄕㄡˋ ㄒㄩㄝˋ,shòu xuè
12722,受用,7,,7,4,11,ㄕㄡˋ ㄩㄥˋ,shòu yòng
12723,授予,7,,6,1,7,ㄕㄡˋ ㄩˇ,shòu yǔ
12724,手杖,7,,4,0,4,ㄕㄡˇ ㄓㄤˋ,shǒu zhàng
12725,收支,7,,3,2,5,ㄕㄡ ㄓ,shōu zhī
12726,壽終正寢,7,,2,1,3,ㄕㄡˋ ㄓㄨㄥ ㄓㄥˋ ㄑㄧㄣˇ,shòu zhōng zhèng qǐn
12727,受阻,7,,3,2,5,ㄕㄡˋ ㄗㄨˇ,shòu zǔ
12728,手足無措,7,,4,1,5,ㄕㄡˇ ㄗㄨˊ ㄨˊ ㄘㄨㄛˋ,shǒu zú wú cuò
12729,受罪,7,,4,1,5,ㄕㄡˋ ㄗㄨㄟˋ,shòu zuì
12730,孰,7,,9,2,11,ㄕㄨˊ,shú
12731,贖,7,,3,1,4,ㄕㄨˊ,shú
12732,殊不知,7,,5,1,6,ㄕㄨ ㄅㄨˋ ㄓ,shū bù zhī
12733,書呆子,7,,4,2,6,ㄕㄨ ㄉㄞ ˙ㄗ,shū dāi zi
12734,疏導,7,,2,1,3,ㄕㄨ ㄉㄠˇ,shū dǎo
12735,抒發,7,,5,4,9,ㄕㄨ ㄈㄚ,shū fā
12736,曙光,7,,6,8,14,ㄕㄨˋ ㄍㄨㄤ,shù guāng
12737,輸家,7,,3,0,3,ㄕㄨ ㄐㄧㄚ,shū jiā
12738,豎立,7,,5,3,8,ㄕㄨˋ ㄌㄧˋ,shù lì
12739,梳理,7,,6,1,7,ㄕㄨ ㄌㄧˇ,shū lǐ
12740,數落,7,,4,1,5,ㄕㄨˇ ㄌㄨㄛˋ,shǔ luò
12741,庶民,7,,6,4,10,ㄕㄨˋ ㄇㄧㄣˊ,shù mín
12742,書目,7,,4,1,5,ㄕㄨ ㄇㄨˋ,shū mù
12743,樞紐,7,,3,3,6,ㄕㄨ ㄋㄧㄡˇ,shū niǔ
12744,書評,7,,3,0,3,ㄕㄨ ㄆㄧㄥˊ,shū píng
12745,暑氣,7,,2,2,4,ㄕㄨˇ ㄑㄧˋ,shǔ qì
12746,抒情,7,,5,2,7,ㄕㄨ ㄑㄧㄥˊ,shū qíng
12747,樹梢,7,,7,2,9,ㄕㄨˋ ㄕㄠ,shù shāo
12748,屬實,7,,4,0,4,ㄕㄨˇ ㄕˊ,shǔ shí
12749,舒坦,7,,3,2,5,ㄕㄨ ㄊㄢˇ,shū tǎn
12750,數以千計,7,,3,1,4,ㄕㄨˋ ㄧˇ ㄑㄧㄢ ㄐㄧˋ,shù yǐ qiān jì
12751,數一數二,7,,3,3,6,ㄕㄨˇ ㄧ ㄕㄨˇ ㄦˋ,shǔ yī shǔ èr
12752,疏於,7,,6,2,8,ㄕㄨ ㄩˊ,shū yú
12753,舒展,7,,3,1,4,ㄕㄨ ㄓㄢˇ,shū zhǎn
12754,贖罪,7,,4,3,7,ㄕㄨˊ ㄗㄨㄟˋ,shú zuì
12755,衰敗,7,,4,3,7,ㄕㄨㄞ ㄅㄞˋ,shuāi bài
12756,率兵,7,,7,1,8,ㄕㄨㄞˋ ㄅㄧㄥ,shuài bīng
12757,衰落,7,,4,2,6,ㄕㄨㄞ ㄌㄨㄛˋ,shuāi luò
12758,衰微,7,,3,1,4,ㄕㄨㄞ ㄨㄟˊ,shuāi wéi
12759,拴,7,,10,0,10,ㄕㄨㄢ,shuān
12760,爽朗,7,,3,2,5,ㄕㄨㄤˇ ㄌㄤˇ,shuǎng lǎng
12761,水壩,7,,3,7,10,ㄕㄨㄟˇ ㄅㄚˋ,shuǐ bà
12762,水草,7,,3,8,11,ㄕㄨㄟˇ ㄘㄠˇ,shuǐ cǎo
12763,水到渠成,7,,3,1,4,ㄕㄨㄟˇ ㄉㄠˋ ㄑㄩˊ ㄔㄥˊ,shuǐ dào qú chéng
12764,水晶,7,,7,2,9,ㄕㄨㄟˇ ㄐㄧㄥ,shuǐ jīng
12765,水利,7,,5,11,16,ㄕㄨㄟˇ ㄌㄧˋ,shuǐ lì
12766,水落石出,7,,4,1,5,ㄕㄨㄟˇ ㄌㄨㄛˋ ㄕˊ ㄔㄨ,shuǐ luò shí chū
12767,順服,7,,3,1,4,ㄕㄨㄣˋ ㄈㄨˊ,shùn fú
12768,順口,7,,3,3,6,ㄕㄨㄣˋ ㄎㄡˇ,shùn kǒu
12769,順理成章,7,,5,1,6,ㄕㄨㄣˋ ㄌㄧˇ ㄔㄥˊ ㄓㄤ,shùn lǐ chéng zhāng
12770,順其自然,7,,3,2,5,ㄕㄨㄣˋ ㄑㄧˊ ㄗˋ ㄖㄢˊ,shùn qí zì rán
12771,順遂,7,,4,6,10,ㄕㄨㄣˋ ㄙㄨㄟˋ,shùn suì
12772,瞬息萬變,7,,3,2,5,ㄕㄨㄣˋ ㄒㄧˊ ㄨㄢˋ ㄅㄧㄢˋ,shùn xí wàn biàn
12773,順心,7,,3,1,4,ㄕㄨㄣˋ ㄒㄧㄣ,shùn xīn
12774,順應,7,,7,10,17,ㄕㄨㄣˋ ㄧㄥˋ,shùn yìng
12775,說詞,7,,4,1,5,ㄕㄨㄛ ㄘˊ,shuō cí
12776,說辭,7,,3,0,3,ㄕㄨㄛ ㄘˊ,shuō cí
12777,碩大,7,,4,2,6,ㄕㄨㄛˋ ㄉㄚˋ,shuò dà
12778,說理,7,,3,1,4,ㄕㄨㄛ ㄌㄧˇ,shuō lǐ
12779,說明書,7,,4,1,5,ㄕㄨㄛ ㄇㄧㄥˊ ㄕㄨ,shuō míng shū
12780,肆,7,,3,1,4,ㄙˋ,sì
12781,私奔,7,,4,1,5,ㄙ ㄅㄣ,sī bēn
12782,似曾相識,7,,3,2,5,ㄙˋ ㄘㄥˊ ㄒㄧㄤ ㄕˋ,sì céng xiāng shì
12783,絲綢,7,,6,11,17,ㄙ ㄔㄡˊ,sī chóu
12784,思忖,7,,3,0,3,ㄙ ㄘㄨㄣˇ,sī cǔn
12785,死黨,7,,4,1,5,ㄙˇ ㄉㄤˇ,sǐ dǎng
12786,四分五裂,7,,2,1,3,ㄙˋ ㄈㄣ ㄨˇ ㄌㄧㄝˋ,sì fēn wǔ liè
12787,死胡同,7,,2,0,2,ㄙˇ ㄏㄨˊ ˙ㄊㄨㄥ,sǐ hú tong
12788,伺機,7,,5,2,7,ㄙˋ ㄐㄧ,sì jī
12789,死寂,7,,4,2,6,ㄙˇ ㄐㄧˊ,sǐ jí
12790,私家,7,,4,2,6,ㄙ ㄐㄧㄚ,sī jiā
12791,司空見慣,7,,3,1,4,ㄙ ㄎㄨㄥ ㄐㄧㄢˋ ㄍㄨㄢˋ,sī kōng jiàn guàn
12792,私利,7,,3,0,3,ㄙ ㄌㄧˋ,sī lì
12793,死裡逃生,7,,2,1,3,ㄙˇ ㄌㄧˇ ㄊㄠˊ ㄕㄥ,sǐ lǐ táo shēng
12794,思量,7,,6,1,7,ㄙ ㄌㄧㄤˊ,sī liáng
12795,撕裂,7,,5,3,8,ㄙ ㄌㄧㄝˋ,sī liè
12796,司令,7,,15,2,17,ㄙ ㄌㄧㄥˋ,sī lìng
12797,思慮,7,,5,1,6,ㄙ ㄌㄩˋ,sī lǜ
12798,私密,7,,5,2,7,ㄙ ㄇㄧˋ,sī mì
12799,死命,7,,4,0,4,ㄙˇ ㄇㄧㄥˋ,sǐ mìng
12800,肆虐,7,,4,11,15,ㄙˋ ㄋㄩㄝˋ,sì nüè
12801,死氣沉沉,7,,2,1,3,ㄙˇ ㄑㄧˋ ㄔㄣˊ ㄔㄣˊ,sǐ qì chén chén
12802,死去活來,7,,3,1,4,ㄙˇ ㄑㄩˋ ㄏㄨㄛˊ ㄌㄞˊ,sǐ qù huó lái
12803,四散,7,,4,2,6,ㄙˋ ㄙㄢˋ,sì sàn
12804,廝殺,7,,5,2,7,ㄙ ㄕㄚ,sī shā
12805,私生活,7,,4,1,5,ㄙ ㄕㄥ ㄏㄨㄛˊ,sī shēng huó
12806,似是而非,7,,3,1,4,ㄙˋ ㄕˋ ㄦˊ ㄈㄟ,sì shì ér fēi
12807,四書,7,,4,1,5,ㄙˋ ㄕㄨ,sì shū
12808,私塾,7,,3,1,4,ㄙ ㄕㄨˊ,sī shú
12809,斯文,7,,3,2,5,ㄙ ㄨㄣˊ,sī wén
12810,肆無忌憚,7,,3,2,5,ㄙˋ ㄨˊ ㄐㄧˋ ㄉㄢˋ,sì wú jì dàn
12811,絲線,7,,4,1,5,ㄙ ㄒㄧㄢˋ,sī xiàn
12812,死訊,7,,4,0,4,ㄙˇ ㄒㄩㄣˋ,sǐ xùn
12813,嘶啞,7,,3,1,4,ㄙ ㄧㄚˇ,sī yǎ
12814,四溢,7,,3,1,4,ㄙˋ ㄧˋ,sì yì
12815,私有,7,,3,1,4,ㄙ ㄧㄡˇ,sī yǒu
12816,私自,7,,4,1,5,ㄙ ㄗˋ,sī zì
12817,鬆綁,7,,3,1,4,ㄙㄨㄥ ㄅㄤˇ,sōng bǎng
12818,宋朝,7,,10,4,14,ㄙㄨㄥˋ ㄔㄠˊ,sòng cháo
12819,聳動,7,,3,2,5,ㄙㄨㄥˇ ㄉㄨㄥˋ,sǒng dòng
12820,誦讀,7,,3,1,4,ㄙㄨㄥˋ ㄉㄨˊ,sòng dú
12821,聳肩,7,,4,1,5,ㄙㄨㄥˇ ㄐㄧㄢ,sǒng jiān
12822,聳立,7,,4,2,6,ㄙㄨㄥˇ ㄌㄧˋ,sǒng lì
12823,松林,7,,4,0,4,ㄙㄨㄥ ㄌㄧㄣˊ,sōng lín
12824,送命,7,,2,0,2,ㄙㄨㄥˋ ㄇㄧㄥˋ,sòng mìng
12825,鬆手,7,,3,1,4,ㄙㄨㄥ ㄕㄡˇ,sōng shǒu
12826,松鼠,7,,7,5,12,ㄙㄨㄥ ㄕㄨˇ,sōng shǔ
12827,搜刮,7,,3,3,6,ㄙㄡ ㄍㄨㄚ,sōu guā
12828,粟,7,,4,3,7,ㄙㄨˋ,sù
12829,酥,7,,9,9,18,ㄙㄨ,sū
12830,宿命,7,,6,7,13,ㄙㄨˋ ㄇㄧㄥˋ,sù mìng
12831,肅穆,7,,4,4,8,ㄙㄨˋ ㄇㄨˋ,sù mù
12832,肅然起敬,7,,4,0,4,ㄙㄨˋ ㄖㄢˊ ㄑㄧˇ ㄐㄧㄥˋ,sù rán qǐ jìng
12833,素色,7,,1,1,2,ㄙㄨˋ ㄙㄜˋ,sù sè
12834,塑像,7,,4,1,5,ㄙㄨˋ ㄒㄧㄤˋ,sù xiàng
12835,素有,7,,3,5,8,ㄙㄨˋ ㄧㄡˇ,sù yǒu
12836,訴諸,7,,6,3,9,ㄙㄨˋ ㄓㄨ,sù zhū
12837,算計,7,,4,1,5,ㄙㄨㄢˋ ㄐㄧˋ,suàn jì
12838,算盤,7,,5,2,7,ㄙㄨㄢˋ ㄆㄢˊ,suàn pán
12839,隨筆,7,,3,0,3,ㄙㄨㄟˊ ㄅㄧˇ,suí bǐ
12840,隨波逐流,7,,4,1,5,ㄙㄨㄟˊ ㄅㄛ ㄓㄨˊ ㄌㄧㄡˊ,suí bō zhú liú
12841,隋朝,7,,13,2,15,ㄙㄨㄟˊ ㄔㄠˊ,suí cháo
12842,隨機應變,7,,3,1,4,ㄙㄨㄟˊ ㄐㄧ ㄧㄥˋ ㄅㄧㄢˋ,suí jī yìng biàn
12843,碎裂,7,,3,2,5,ㄙㄨㄟˋ ㄌㄧㄝˋ,suì liè
12844,隨俗,7,,2,3,5,ㄙㄨㄟˊ ㄙㄨˊ,suí sú
12845,隨同,7,,3,0,3,ㄙㄨㄟˊ ㄊㄨㄥˊ,suí tóng
12846,隨行,7,,6,2,8,ㄙㄨㄟˊ ㄒㄧㄥˊ,suí xíng
12847,隨興,7,,4,2,6,ㄙㄨㄟˊ ㄒㄧㄥˋ,suí xìng
12848,縮減,7,,4,4,8,ㄙㄨㄛ ㄐㄧㄢˇ,suō jiǎn
12849,所見所聞,7,,3,1,4,ㄙㄨㄛˇ ㄐㄧㄢˋ ㄙㄨㄛˇ ㄨㄣˊ,suǒ jiàn suǒ wén
12850,索賠,7,,2,0,2,ㄙㄨㄛˇ ㄆㄟˊ,suǒ péi
12851,索求,7,,2,1,3,ㄙㄨㄛˇ ㄑㄧㄡˊ,suǒ qiú
12852,所向無敵,7,,2,1,3,ㄙㄨㄛˇ ㄒㄧㄤˋ ㄨˊ ㄉㄧˊ,suǒ xiàng wú dí
12853,所以然,7,,4,2,6,ㄙㄨㄛˇ ㄧˇ ㄖㄢˊ,suǒ yǐ rán
12854,縮影,7,,3,7,10,ㄙㄨㄛ ㄧㄥˇ,suō yǐng
12855,所有人,7,,5,2,7,ㄙㄨㄛˇ ㄧㄡˇ ㄖㄣˊ,suǒ yǒu rén
12856,祂,7,,27,22,49,ㄊㄚ,tā
12857,踏板,7,,4,1,5,ㄊㄚˋ ㄅㄢˇ,tà bǎn
12858,撻伐,7,,2,3,5,ㄊㄚˋ ㄈㄚ,tà fā
12859,榻榻米,7,,4,0,4,ㄊㄚˋ ㄊㄚˋ ㄇㄧˇ,tà tà mǐ
12860,他鄉,7,,3,2,5,ㄊㄚ ㄒㄧㄤ,tā xiāng
12861,太后,7,,64,1,65,ㄊㄞˋ ㄏㄡˋ,tài hòu
12862,太監,7,,38,0,38,ㄊㄞˋ ㄐㄧㄢˋ,tài jiàn
12863,檯面,7,,5,10,15,ㄊㄞˊ ㄇㄧㄢˋ,tái miàn
12864,泰然自若,7,,2,1,3,ㄊㄞˋ ㄖㄢˊ ㄗˋ ㄖㄨㄛˋ,tài rán zì ruò
12865,態勢,7,,6,5,11,ㄊㄞˋ ㄕˋ,tài shì
12866,抬頭挺胸,7,,2,3,5,ㄊㄞˊ ㄊㄡˊ ㄊㄧㄥˇ ㄒㄩㄥ,tái tóu tǐng xiōng
12867,太陽穴,7,,4,2,6,ㄊㄞˋ ㄧㄤˊ ㄒㄩㄝˋ,tài yáng xuè
12868,太子,7,,71,4,75,ㄊㄞˋ ㄗˇ,tài zǐ
12869,太祖,7,,14,1,15,ㄊㄞˋ ㄗㄨˇ,tài zǔ
12870,碳,7,,8,144,152,ㄊㄢˋ,tàn
12871,癱,7,,4,1,5,ㄊㄢ,tān
12872,探測,7,,5,11,16,ㄊㄢˋ ㄘㄜˋ,tàn cè
12873,探查,7,,3,1,4,ㄊㄢˋ ㄔㄚˊ,tàn chá
12874,探訪,7,,7,8,15,ㄊㄢˋ ㄈㄤˇ,tàn fǎng
12875,談何容易,7,,3,2,5,ㄊㄢˊ ㄏㄜˊ ㄖㄨㄥˊ ㄧˋ,tán hé róng yì
12876,袒護,7,,2,0,2,ㄊㄢˇ ㄏㄨˋ,tǎn hù
12877,曇花一現,7,,2,1,3,ㄊㄢˊ ㄏㄨㄚ ㄧˊ ㄒㄧㄢˋ,tán huā yí xiàn
12878,彈簧,7,,4,2,6,ㄊㄢˊ ㄏㄨㄤˊ,tán huáng
12879,探親,7,,3,4,7,ㄊㄢˋ ㄑㄧㄣ,tàn qīn
12880,談情說愛,7,,2,1,3,ㄊㄢˊ ㄑㄧㄥˊ ㄕㄨㄛ ㄞˋ,tán qíng shuō ài
12881,探求,7,,3,1,4,ㄊㄢˋ ㄑㄧㄡˊ,tàn qiú
12882,探視,7,,6,6,12,ㄊㄢˋ ㄕˋ,tàn shì
12883,忐忑不安,7,,4,1,5,ㄊㄢˇ ㄊㄜˋ ㄅㄨˋ ㄢ,tǎn tè bù ān
12884,彈跳,7,,3,1,4,ㄊㄢˊ ㄊㄧㄠˋ,tán tiào
12885,探聽,7,,4,1,5,ㄊㄢˋ ㄊㄧㄥ,tàn tīng
12886,探頭,7,,6,1,7,ㄊㄢ ㄊㄡˊ,tān tóu
12887,談吐,7,,4,1,5,ㄊㄢˊ ㄊㄨˇ,tán tǔ
12888,貪圖,7,,4,2,6,ㄊㄢ ㄊㄨˊ,tān tú
12889,嘆為觀止,7,,4,3,7,ㄊㄢˋ ㄨㄟˊ ㄍㄨㄢ ㄓˇ,tàn wéi guān zhǐ
12890,探問,7,,4,0,4,ㄊㄢˋ ㄨㄣˋ,tàn wèn
12891,談心,7,,5,1,6,ㄊㄢˊ ㄒㄧㄣ,tán xīn
12892,探尋,7,,4,1,5,ㄊㄢˋ ㄒㄩㄣˊ,tàn xún
12893,探詢,7,,5,1,6,ㄊㄢˋ ㄒㄩㄣˊ,tàn xún
12894,唐朝,7,,23,17,40,ㄊㄤˊ ㄔㄠˊ,táng cháo
12895,堂而皇之,7,,2,0,2,ㄊㄤˊ ㄦˊ ㄏㄨㄤˊ ㄓ,táng ér huáng zhī
12896,搪塞,7,,3,0,3,ㄊㄤˊ ㄙㄜˋ,táng sè
12897,堂堂,7,,6,2,8,ㄊㄤˊ ㄊㄤˊ,táng táng
12898,堂兄,7,,3,0,3,ㄊㄤˊ ㄒㄩㄥ,táng xiōng
12899,逃竄,7,,3,1,4,ㄊㄠˊ ㄘㄨㄢˋ,táo cuàn
12900,討伐,7,,12,2,14,ㄊㄠˇ ㄈㄚ,tǎo fā
12901,淘氣,7,,4,1,5,ㄊㄠˊ ㄑㄧˋ,táo qì
12902,滔滔,7,,4,2,6,ㄊㄠ ㄊㄠ,tāo tāo
12903,滔天,7,,3,1,4,ㄊㄠ ㄊㄧㄢ,tāo tiān
12904,陶冶,7,,4,1,5,ㄊㄠˊ ㄧㄝˇ,táo yě
12905,逃逸,7,,2,1,3,ㄊㄠˊ ㄧˋ,táo yì
12906,逃之夭夭,7,,3,1,4,ㄊㄠˊ ㄓ ㄧㄠ ㄧㄠ,táo zhī yāo yāo
12907,特長,7,,4,1,5,ㄊㄜˋ ㄔㄤˊ,tè cháng
12908,特技,7,,3,1,4,ㄊㄜˋ ㄐㄧˋ,tè jì
12909,特例,7,,4,3,7,ㄊㄜˋ ㄌㄧˋ,tè lì
12910,特立獨行,7,,3,1,4,ㄊㄜˋ ㄌㄧˋ ㄉㄨˊ ㄒㄧㄥˊ,tè lì dú xíng
12911,特務,7,,7,1,8,ㄊㄜˋ ㄨˋ,tè wù
12912,特寫,7,,4,1,5,ㄊㄜˋ ㄒㄧㄝˇ,tè xiě
12913,特約,7,,2,1,3,ㄊㄜˋ ㄩㄝ,tè yuē
12914,騰空,7,,5,1,6,ㄊㄥˊ ㄎㄨㄥ,téng kōng
12915,藤蔓,7,,3,5,8,ㄊㄥˊ ㄇㄢˋ,téng màn
12916,疼惜,7,,3,13,16,ㄊㄥˊ ㄒㄧˊ,téng xí
12917,啼,7,,7,2,9,ㄊㄧˊ,tí
12918,剃,7,,4,2,6,ㄊㄧˋ,tì
12919,提筆,7,,4,1,5,ㄊㄧˊ ㄅㄧˇ,tí bǐ
12920,體察,7,,2,2,4,ㄊㄧˇ ㄔㄚˊ,tǐ chá
12921,剔除,7,,3,1,4,ㄊㄧ ㄔㄨˊ,tī chú
12922,提煉,7,,4,10,14,ㄊㄧˊ ㄌㄧㄢˋ,tí liàn
12923,體面,7,,7,1,8,ㄊㄧˇ ㄇㄧㄢˋ,tǐ miàn
12924,提取,7,,7,3,10,ㄊㄧˊ ㄑㄩˇ,tí qǔ
12925,體態,7,,5,4,9,ㄊㄧˇ ㄊㄞˋ,tǐ tài
12926,體統,7,,2,1,3,ㄊㄧˇ ㄊㄨㄥˇ,tǐ tǒng
12927,體悟,7,,6,13,19,ㄊㄧˇ ㄨˋ,tǐ wù
12928,提攜,7,,3,2,5,ㄊㄧˊ ㄒㄧ,tí xī
12929,啼笑皆非,7,,2,0,2,ㄊㄧˊ ㄒㄧㄠˋ ㄐㄧㄝ ㄈㄟ,tí xiào jiē fēi
12930,提心吊膽,7,,4,3,7,ㄊㄧˊ ㄒㄧㄣ ㄉㄧㄠˋ ㄉㄢˇ,tí xīn diào dǎn
12931,體恤,7,,3,2,5,ㄊㄧˇ ㄒㄩˋ,tǐ xù
12932,提振,7,,3,3,6,ㄊㄧˊ ㄓㄣˋ,tí zhèn
12933,天鵝,7,,8,2,10,ㄊㄧㄢ ㄜˊ,tiān é
12934,天翻地覆,7,,3,1,4,ㄊㄧㄢ ㄈㄢ ㄉㄧˋ ㄈㄨˋ,tiān fān dì fù
12935,天方夜譚,7,,3,2,5,ㄊㄧㄢ ㄈㄤ ㄧㄝˋ ㄊㄢˊ,tiān fāng yè tán
12936,添購,7,,2,3,5,ㄊㄧㄢ ㄍㄡˋ,tiān gòu
12937,天國,7,,5,1,6,ㄊㄧㄢ ㄍㄨㄛˊ,tiān guó
12938,天花亂墜,7,,2,1,3,ㄊㄧㄢ ㄏㄨㄚ ㄌㄨㄢˋ ㄓㄨㄟˋ,tiān huā luàn zhuì
12939,天皇,7,,24,3,27,ㄊㄧㄢ ㄏㄨㄤˊ,tiān huáng
12940,天昏地暗,7,,3,0,3,ㄊㄧㄢ ㄏㄨㄣ ㄉㄧˋ ㄢˋ,tiān hūn dì àn
12941,天際,7,,6,3,9,ㄊㄧㄢ ㄐㄧˋ,tiān jì
12942,天經地義,7,,4,7,11,ㄊㄧㄢ ㄐㄧㄥ ㄉㄧˋ ㄧˋ,tiān jīng dì yì
12943,天理,7,,5,1,6,ㄊㄧㄢ ㄌㄧˇ,tiān lǐ
12944,天馬行空,7,,3,4,7,ㄊㄧㄢ ㄇㄚˇ ㄒㄧㄥˊ ㄎㄨㄥ,tiān mǎ xíng kōng
12945,天命,7,,10,3,13,ㄊㄧㄢ ㄇㄧㄥˋ,tiān mìng
12946,天南地北,7,,2,1,3,ㄊㄧㄢ ㄋㄢˊ ㄉㄧˋ ㄅㄟˇ,tiān nán dì běi
12947,天壤之別,7,,3,1,4,ㄊㄧㄢ ㄖㄤˇ ㄓ ㄅㄧㄝˊ,tiān rǎng zhī bié
12948,甜食,7,,3,2,5,ㄊㄧㄢˊ ㄕˊ,tián shí
12949,甜頭,7,,2,2,4,ㄊㄧㄢˊ ˙ㄊㄡ,tián tou
12950,天線,7,,4,2,6,ㄊㄧㄢ ㄒㄧㄢˋ,tiān xiàn
12951,天仙,7,,3,0,3,ㄊㄧㄢ ㄒㄧㄢ,tiān xiān
12952,天旋地轉,7,,2,1,3,ㄊㄧㄢ ㄒㄩㄢˊ ㄉㄧˋ ㄓㄨㄢˇ,tiān xuán dì zhuǎn
12953,天涯,7,,4,4,8,ㄊㄧㄢ ㄧㄚˊ,tiān yá
12954,天涯海角,7,,2,1,3,ㄊㄧㄢ ㄧㄚˊ ㄏㄞˇ ㄐㄧㄠˇ,tiān yá hǎi jiǎo
12955,天意,7,,7,2,9,ㄊㄧㄢ ㄧˋ,tiān yì
12956,天衣無縫,7,,3,1,4,ㄊㄧㄢ ㄧ ㄨˊ ㄈㄥˋ,tiān yī wú fèng
12957,天災人禍,7,,2,6,8,ㄊㄧㄢ ㄗㄞ ㄖㄣˊ ㄏㄨㄛˋ,tiān zāi rén huò
12958,天職,7,,3,3,6,ㄊㄧㄢ ㄓˊ,tiān zhí
12959,天子,7,,23,3,26,ㄊㄧㄢ ㄗˇ,tiān zǐ
12960,天資,7,,3,1,4,ㄊㄧㄢ ㄗ,tiān zī
12961,挑2,7,,45,64,109,ㄊㄧㄠˇ,tiǎo
12962,挑撥,7,,5,2,7,ㄊㄧㄠˇ ㄅㄛ,tiǎo bō
12963,挑逗,7,,3,0,3,ㄊㄧㄠˇ ㄉㄡˋ,tiǎo dòu
12964,調解,7,,4,2,6,ㄊㄧㄠˊ ㄐㄧㄝˇ,tiáo jiě
12965,調侃,7,,5,2,7,ㄊㄧㄠˊ ㄎㄢˇ,tiáo kǎn
12966,調理,7,,5,7,12,ㄊㄧㄠˊ ㄌㄧˇ,tiáo lǐ
12967,調配1,7,,4,7,11,ㄊㄧㄠˊ ㄆㄟˋ,tiáo pèi
12968,條文,7,,7,2,9,ㄊㄧㄠˊ ㄨㄣˊ,tiáo wén
12969,調養,7,,3,1,4,ㄊㄧㄠˊ ㄧㄤˇ,tiáo yǎng
12970,跳蚤,7,,5,8,13,ㄊㄧㄠˋ ㄗㄠˇ,tiào zǎo
12971,條子,7,,3,1,4,ㄊㄧㄠˊ ˙ㄗ,tiáo zi
12972,帖,7,,6,4,10,ㄊㄧㄝˇ,tiě
12973,鐵板,7,,3,4,7,ㄊㄧㄝˇ ㄅㄢˇ,tiě bǎn
12974,鐵定,7,,4,1,5,ㄊㄧㄝˇ ㄉㄧㄥˋ,tiě dìng
12975,鐵絲,7,,3,6,9,ㄊㄧㄝˇ ㄙ,tiě sī
12976,挺拔,7,,3,1,4,ㄊㄧㄥˇ ㄅㄚˊ,tǐng bá
12977,停擺,7,,3,7,10,ㄊㄧㄥˊ ㄅㄞˇ,tíng bǎi
12978,停泊,7,,4,2,6,ㄊㄧㄥˊ ㄅㄛˊ,tíng bó
12979,鋌而走險,7,,2,1,3,ㄊㄧㄥˇ ㄦˊ ㄗㄡˇ ㄒㄧㄢˇ,tǐng ér zǒu xiǎn
12980,停放,7,,3,1,4,ㄊㄧㄥˊ ㄈㄤˋ,tíng fàng
12981,聽講,7,,4,1,5,ㄊㄧㄥ ㄐㄧㄤˇ,tīng jiǎng
12982,挺立,7,,3,2,5,ㄊㄧㄥˇ ㄌㄧˋ,tǐng lì
12983,聽命,7,,6,1,7,ㄊㄧㄥˋ ㄇㄧㄥˋ,tìng mìng
12984,聽取,7,,6,3,9,ㄊㄧㄥ ㄑㄩˇ,tīng qǔ
12985,挺身而出,7,,5,3,8,ㄊㄧㄥˇ ㄕㄣ ㄦˊ ㄔㄨ,tǐng shēn ér chū
12986,廳堂,7,,3,1,4,ㄊㄧㄥ ㄊㄤˊ,tīng táng
12987,聽天由命,7,,2,0,2,ㄊㄧㄥˋ ㄊㄧㄢ ㄧㄡˊ ㄇㄧㄥˋ,tìng tiān yóu mìng
12988,聽筒,7,,4,0,4,ㄊㄧㄥ ㄊㄨㄥˇ,tīng tǒng
12989,停歇,7,,3,4,7,ㄊㄧㄥˊ ㄒㄧㄝ,tíng xiē
12990,捅,7,,3,1,4,ㄊㄨㄥˇ,tǒng
12991,通病,7,,2,1,3,ㄊㄨㄥ ㄅㄧㄥˋ,tōng bìng
12992,痛不欲生,7,,3,1,4,ㄊㄨㄥˋ ㄅㄨˊ ㄩˋ ㄕㄥ,tòng bú yù shēng
12993,通稱,7,,4,1,5,ㄊㄨㄥ ㄔㄥ,tōng chēng
12994,痛斥,7,,3,1,4,ㄊㄨㄥˋ ㄔˋ,tòng chì
12995,統籌,7,,3,2,5,ㄊㄨㄥˇ ㄔㄡˊ,tǒng chóu
12996,痛楚,7,,7,1,8,ㄊㄨㄥˋ ㄔㄨˇ,tòng chǔ
12997,通達,7,,3,1,4,ㄊㄨㄥ ㄉㄚˊ,tōng dá
12998,同好,7,,3,2,5,ㄊㄨㄥˊ ㄏㄠˋ,tóng hào
12999,同化,7,,4,2,6,ㄊㄨㄥˊ ㄏㄨㄚˋ,tóng huà
13000,通婚,7,,5,2,7,ㄊㄨㄥ ㄏㄨㄣ,tōng hūn
13001,同夥,7,,4,1,5,ㄊㄨㄥˊ ㄏㄨㄛˇ,tóng huǒ
13002,瞳孔,7,,4,3,7,ㄊㄨㄥˊ ㄎㄨㄥˇ,tóng kǒng
13003,痛哭流涕,7,,3,1,4,ㄊㄨㄥˋ ㄎㄨ ㄌㄧㄡˊ ㄊㄧˋ,tòng kū liú tì
13004,同僚,7,,7,1,8,ㄊㄨㄥˊ ㄌㄧㄠˊ,tóng liáo
13005,統領,7,,8,2,10,ㄊㄨㄥˇ ㄌㄧㄥˇ,tǒng lǐng
13006,通明,7,,3,2,5,ㄊㄨㄥ ㄇㄧㄥˊ,tōng míng
13007,通緝,7,,3,2,5,ㄊㄨㄥ ㄑㄧˋ,tōng qì
13008,通商,7,,6,2,8,ㄊㄨㄥ ㄕㄤ,tōng shāng
13009,統帥,7,,10,1,11,ㄊㄨㄥˇ ㄕㄨㄞˋ,tǒng shuài
13010,統率,7,,3,0,3,ㄊㄨㄥˇ ㄕㄨㄞˋ,tǒng shuài
13011,通曉,7,,3,1,4,ㄊㄨㄥ ㄒㄧㄠˇ,tōng xiǎo
13012,通宵,7,,2,1,3,ㄊㄨㄥ ㄒㄧㄠ,tōng xiāo
13013,同心,7,,4,6,10,ㄊㄨㄥˊ ㄒㄧㄣ,tóng xīn
13014,同心協力,7,,4,5,9,ㄊㄨㄥˊ ㄒㄧㄣ ㄒㄧㄝˊ ㄌㄧˋ,tóng xīn xié lì
13015,同義詞,7,,2,0,2,ㄊㄨㄥˊ ㄧˋ ㄘˊ,tóng yì cí
13016,統御,7,,4,1,5,ㄊㄨㄥˇ ㄩˋ,tǒng yù
13017,通則,7,,4,0,4,ㄊㄨㄥ ㄗㄜˊ,tōng zé
13018,桶子,7,,4,10,14,ㄊㄨㄥˇ ˙ㄗ,tǒng zi
13019,透徹,7,,6,4,10,ㄊㄡˋ ㄔㄜˋ,tòu chè
13020,透頂,7,,5,1,6,ㄊㄡˋ ㄉㄧㄥˇ,tòu dǐng
13021,投稿,7,,2,8,10,ㄊㄡˊ ㄍㄠˇ,tóu gǎo
13022,頭昏眼花,7,,2,2,4,ㄊㄡˊ ㄏㄨㄣ ㄧㄢˇ ㄏㄨㄚ,tóu hūn yǎn huā
13023,頭盔,7,,4,1,5,ㄊㄡˊ ㄎㄨㄟ,tóu kuī
13024,偷窺,7,,4,1,5,ㄊㄡ ㄎㄨㄟ,tōu kuī
13025,頭顱,7,,9,1,10,ㄊㄡˊ ㄌㄨˊ,tóu lú
13026,頭目,7,,12,7,19,ㄊㄡˊ ㄇㄨˋ,tóu mù
13027,頭破血流,7,,2,1,3,ㄊㄡˊ ㄆㄛˋ ㄒㄧㄝˇ ㄌㄧㄡˊ,tóu pò xiě liú
13028,透視,7,,5,3,8,ㄊㄡˋ ㄕˋ,tòu shì
13029,投宿,7,,3,0,3,ㄊㄡˊ ㄙㄨˋ,tóu sù
13030,偷偷摸摸,7,,4,2,6,ㄊㄡ ㄊㄡ ㄇㄛ ㄇㄛ,tōu tōu mō mō
13031,頭頭是道,7,,3,1,4,ㄊㄡˊ ㄊㄡˊ ㄕˋ ㄉㄠˋ,tóu tóu shì dào
13032,頭暈目眩,7,,2,0,2,ㄊㄡˊ ㄩㄣ ㄇㄨˋ ㄒㄩㄢˋ,tóu yūn mù xuàn
13033,投擲,7,,2,3,5,ㄊㄡˊ ㄓˊ,tóu zhí
13034,透支,7,,2,2,4,ㄊㄡˋ ㄓ,tòu zhī
13035,突變,7,,11,4,15,ㄊㄨˊ ㄅㄧㄢˋ,tú biàn
13036,徒步,7,,5,7,12,ㄊㄨˊ ㄅㄨˋ,tú bù
13037,土匪,7,,5,1,6,ㄊㄨˇ ㄈㄟˇ,tǔ fěi
13038,突飛猛進,7,,3,2,5,ㄊㄨˊ ㄈㄟ ㄇㄥˇ ㄐㄧㄣˋ,tú fēi měng jìn
13039,突擊,7,,5,3,8,ㄊㄨˊ ㄐㄧˊ,tú jí
13040,途經,7,,2,3,5,ㄊㄨˊ ㄐㄧㄥ,tú jīng
13041,徒勞無功,7,,6,1,7,ㄊㄨˊ ㄌㄠˊ ㄨˊ ㄍㄨㄥ,tú láo wú gōng
13042,吐露,7,,6,0,6,ㄊㄨˇ ㄌㄨˋ,tǔ lù
13043,圖謀,7,,5,1,6,ㄊㄨˊ ㄇㄡˊ,tú móu
13044,土木,7,,3,3,6,ㄊㄨˇ ㄇㄨˋ,tǔ mù
13045,徒然,7,,4,0,4,ㄊㄨˊ ㄖㄢˊ,tú rán
13046,土生土長,7,,3,7,10,ㄊㄨˇ ㄕㄥ ㄊㄨˇ ㄓㄤˇ,tǔ shēng tǔ zhǎng
13047,圖騰,7,,5,8,13,ㄊㄨˊ ㄊㄥˊ,tú téng
13048,禿頭,7,,4,1,5,ㄊㄨ ㄊㄡˊ,tū tóu
13049,突兀,7,,5,2,7,ㄊㄨˊ ㄨˋ,tú wù
13050,突襲,7,,5,2,7,ㄊㄨˊ ㄒㄧˊ,tú xí
13051,塗鴉,7,,4,13,17,ㄊㄨˊ ㄧㄚ,tú yā
13052,圖樣,7,,5,2,7,ㄊㄨˊ ㄧㄤˋ,tú yàng
13053,徒增,7,,2,1,3,ㄊㄨˊ ㄗㄥ,tú zēng
13054,土著,7,,5,1,6,ㄊㄨˇ ㄓㄨˋ,tǔ zhù
13055,湍急,7,,3,5,8,ㄊㄨㄢ ㄐㄧˊ,tuān jí
13056,蛻變,7,,4,5,9,ㄊㄨㄟˋ ㄅㄧㄢˋ,tuì biàn
13057,推波助瀾,7,,3,3,6,ㄊㄨㄟ ㄅㄛ ㄓㄨˋ ㄌㄢˊ,tuī bō zhù lán
13058,推陳出新,7,,3,0,3,ㄊㄨㄟ ㄔㄣˊ ㄔㄨ ㄒㄧㄣ,tuī chén chū xīn
13059,推辭,7,,5,1,6,ㄊㄨㄟ ㄘˊ,tuī cí
13060,頹廢,7,,5,0,5,ㄊㄨㄟˊ ㄈㄟˋ,tuí fèi
13061,退還,7,,3,0,3,ㄊㄨㄟˋ ㄏㄨㄢˊ,tuì huán
13062,退居,7,,3,1,4,ㄊㄨㄟˋ ㄐㄩ,tuì jū
13063,推敲,7,,5,2,7,ㄊㄨㄟ ㄑㄧㄠ,tuī qiāo
13064,退卻,7,,5,1,6,ㄊㄨㄟˋ ㄑㄩㄝˋ,tuì què
13065,頹喪,7,,2,1,3,ㄊㄨㄟˊ ㄙㄤˋ,tuí sàng
13066,推手,7,,4,7,11,ㄊㄨㄟ ㄕㄡˇ,tuī shǒu
13067,推算,7,,5,3,8,ㄊㄨㄟ ㄙㄨㄢˋ,tuī suàn
13068,退位,7,,5,4,9,ㄊㄨㄟˋ ㄨㄟˋ,tuì wèi
13069,推諉,7,,3,0,3,ㄊㄨㄟ ㄨㄟˇ,tuī wěi
13070,退伍,7,,12,17,29,ㄊㄨㄟˋ ㄨˇ,tuì wǔ
13071,推想,7,,3,1,4,ㄊㄨㄟ ㄒㄧㄤˇ,tuī xiǎng
13072,推卸,7,,3,1,4,ㄊㄨㄟ ㄒㄧㄝˋ,tuī xiè
13073,推演,7,,3,2,5,ㄊㄨㄟ ㄧㄢˇ,tuī yǎn
13074,退役,7,,4,3,7,ㄊㄨㄟˋ ㄧˋ,tuì yì
13075,推移,7,,3,3,6,ㄊㄨㄟ ㄧˊ,tuī yí
13076,退隱,7,,3,1,4,ㄊㄨㄟˋ ㄧㄣˇ,tuì yǐn
13077,退下,7,,3,1,4,ㄊㄨㄟˋㄒㄧㄚˋ,tuìxià
13078,臀,7,,4,2,6,ㄊㄨㄣˊ,tún
13079,囤積,7,,5,4,9,ㄊㄨㄣˊ ㄐㄧ,tún jī
13080,吞沒,7,,4,0,4,ㄊㄨㄣ ㄇㄛˋ,tūn mò
13081,吞噬,7,,6,7,13,ㄊㄨㄣ ㄕˋ,tūn shì
13082,吞吞吐吐,7,,3,1,4,ㄊㄨㄣ ㄊㄨㄣ ㄊㄨˇ ㄊㄨˇ,tūn tūn tǔ tǔ
13083,吞嚥,7,,3,2,5,ㄊㄨㄣ ㄧㄢˋ,tūn yàn
13084,託付,7,,3,1,4,ㄊㄨㄛ ㄈㄨˋ,tuō fù
13085,脫節,7,,4,2,6,ㄊㄨㄛ ㄐㄧㄝˊ,tuō jié
13086,脫口,7,,4,1,5,ㄊㄨㄛ ㄎㄡˇ,tuō kǒu
13087,拖累,7,,3,3,6,ㄊㄨㄛ ㄌㄟˋ,tuō lèi
13088,脫落,7,,6,5,11,ㄊㄨㄛ ㄌㄨㄛˋ,tuō luò
13089,唾沫,7,,3,0,3,ㄊㄨㄛˋ ㄇㄛˋ,tuò mò
13090,唾棄,7,,3,1,4,ㄊㄨㄛˋ ㄑㄧˋ,tuò qì
13091,脫水,7,,5,6,11,ㄊㄨㄛ ㄕㄨㄟˇ,tuō shuǐ
13092,脫俗,7,,2,1,3,ㄊㄨㄛ ㄙㄨˊ,tuō sú
13093,脫胎換骨,7,,4,2,6,ㄊㄨㄛ ㄊㄞ ㄏㄨㄢˋ ㄍㄨˇ,tuō tāi huàn gǔ
13094,脫逃,7,,4,2,6,ㄊㄨㄛ ㄊㄠˊ,tuō táo
13095,拖拖拉拉,7,,3,1,4,ㄊㄨㄛ ㄊㄨㄛ ㄌㄚ ㄌㄚ,tuō tuō lā lā
13096,脫穎而出,7,,5,2,7,ㄊㄨㄛ ㄧㄥˇ ㄦˊ ㄔㄨ,tuō yǐng ér chū
13097,橢圓形,7,,3,1,4,ㄊㄨㄛˇ ㄩㄢˊ ㄒㄧㄥˊ,tuǒ yuán xíng
13098,瓦,7,,12,26,38,ㄨㄚˇ,wǎ
13099,挖苦,7,,4,1,5,ㄨㄚ ㄎㄨˇ,wā kǔ
13100,挽,7,,6,4,10,ㄨㄢˇ,wǎn
13101,豌豆,7,,4,12,16,ㄨㄢ ㄉㄡˋ,wān dòu
13102,莞爾,7,,3,1,4,ㄨㄢˇ ㄦˇ,wǎn ěr
13103,完結,7,,2,0,2,ㄨㄢˊ ㄐㄧㄝˊ,wán jié
13104,婉拒,7,,6,2,8,ㄨㄢˇ ㄐㄩˋ,wǎn jù
13105,挽留,7,,3,1,4,ㄨㄢˇ ㄌㄧㄡˊ,wǎn liú
13106,玩偶,7,,4,3,7,ㄨㄢˊ ㄡˇ,wán ǒu
13107,萬全,7,,2,2,4,ㄨㄢˋ ㄑㄩㄢˊ,wàn quán
13108,萬世,7,,3,0,3,ㄨㄢˋ ㄕˋ,wàn shì
13109,頑童,7,,4,1,5,ㄨㄢˊ ㄊㄨㄥˊ,wán tóng
13110,玩味,7,,3,1,4,ㄨㄢˋ ㄨㄟˋ,wàn wèi
13111,玩意,7,,4,1,5,ㄨㄢˊ ㄧˋ,wán yì
13112,婉轉,7,,5,1,6,ㄨㄢˇ ㄓㄨㄢˇ,wǎn zhuǎn
13113,王朝,7,,64,21,85,ㄨㄤˊ ㄔㄠˊ,wáng cháo
13114,望塵莫及,7,,2,0,2,ㄨㄤˋ ㄔㄣˊ ㄇㄛˋ ㄐㄧˊ,wàng chén mò jí
13115,忘恩負義,7,,3,1,4,ㄨㄤˋ ㄣ ㄈㄨˋ ㄧˋ,wàng ēn fù yì
13116,王府,7,,8,1,9,ㄨㄤˊ ㄈㄨˇ,wáng fǔ
13117,王宮,7,,7,2,9,ㄨㄤˊ ㄍㄨㄥ,wáng gōng
13118,亡故,7,,3,1,4,ㄨㄤˊ ㄍㄨˋ,wáng gù
13119,忘懷,7,,7,3,10,ㄨㄤˋ ㄏㄨㄞˊ,wàng huái
13120,網羅,7,,3,1,4,ㄨㄤˇ ㄌㄨㄛˊ,wǎng luó
13121,亡命,7,,3,1,4,ㄨㄤˊ ㄇㄧㄥˋ,wáng mìng
13122,往年,7,,3,13,16,ㄨㄤˇ ㄋㄧㄢˊ,wǎng nián
13123,王牌,7,,3,1,4,ㄨㄤˊ ㄆㄞˊ,wáng pái
13124,忘情,7,,2,1,3,ㄨㄤˋ ㄑㄧㄥˊ,wàng qíng
13125,忘卻,7,,6,1,7,ㄨㄤˋ ㄑㄩㄝˋ,wàng què
13126,枉然,7,,3,1,4,ㄨㄤˇ ㄖㄢˊ,wǎng rán
13127,王位,7,,7,4,11,ㄨㄤˊ ㄨㄟˋ,wáng wèi
13128,汪洋,7,,3,5,8,ㄨㄤ ㄧㄤˊ,wāng yáng
13129,王爺,7,,14,1,15,ㄨㄤˊ ㄧㄝˊ,wáng yé
13130,衛兵,7,,6,1,7,ㄨㄟˋ ㄅㄧㄥ,wèi bīng
13131,微薄,7,,5,7,12,ㄨㄟˊ ㄅㄛˊ,wéi bó
13132,未嘗,7,,5,1,6,ㄨㄟˋ ㄔㄤˊ,wèi cháng
13133,圍城,7,,4,3,7,ㄨㄟˊ ㄔㄥˊ,wéi chéng
13134,尾端,7,,3,2,5,ㄨㄟˇ ㄉㄨㄢ,wěi duān
13135,巍峨,7,,3,2,5,ㄨㄟˊ ㄜˊ,wéi é
13136,為非作歹,7,,3,0,3,ㄨㄟˊ ㄈㄟ ㄗㄨㄛˋ ㄉㄞˇ,wéi fēi zuò dǎi
13137,威風,7,,6,2,8,ㄨㄟ ㄈㄥ,wēi fēng
13138,威風凜凜,7,,3,1,4,ㄨㄟ ㄈㄥ ㄌㄧㄣˇ ㄌㄧㄣˇ,wēi fēng lǐn lǐn
13139,違規,7,,4,2,6,ㄨㄟˊ ㄍㄨㄟ,wéi guī
13140,為害,7,,2,1,3,ㄨㄟˊ ㄏㄞˋ,wéi hài
13141,威嚇,7,,4,2,6,ㄨㄟ ㄏㄜˋ,wēi hè
13142,微乎其微,7,,4,1,5,ㄨㄟˊ ㄏㄨ ㄑㄧˊ ㄨㄟˊ,wéi hū qí wéi
13143,未婚夫,7,,4,1,5,ㄨㄟˋ ㄏㄨㄣ ㄈㄨ,wèi hūn fū
13144,未婚妻,7,,4,2,6,ㄨㄟˋ ㄏㄨㄣ ㄑㄧ,wèi hūn qī
13145,圍剿,7,,3,3,6,ㄨㄟˊ ㄐㄧㄠˇ,wéi jiǎo
13146,慰藉,7,,7,3,10,ㄨㄟˋ ㄐㄧㄝˋ,wèi jiè
13147,位居,7,,6,6,12,ㄨㄟˋ ㄐㄩ,wèi jū
13148,違抗,7,,5,0,5,ㄨㄟˊ ㄎㄤˋ,wéi kàng
13149,唯恐/惟恐,7,,8,2,10,ㄨㄟˊ ㄎㄨㄥˇ,wéi kǒng
13150,圍困,7,,5,1,6,ㄨㄟˊ ㄎㄨㄣˋ,wéi kùn
13151,蔚藍,7,,3,1,4,ㄨㄟˋ ㄌㄢˊ,wèi lán
13152,危難,7,,4,1,5,ㄨㄟˊ ㄋㄢˋ,wéi nàn
13153,委任,7,,3,1,4,ㄨㄟˇ ㄖㄣˋ,wěi rèn
13154,偽善,7,,3,1,4,ㄨㄟˋ ㄕㄢˋ,wèi shàn
13155,威勢,7,,3,0,3,ㄨㄟ ㄕˋ,wēi shì
13156,為時已晚,7,,3,1,4,ㄨㄟˊ ㄕˊ ㄧˇ ㄨㄢˇ,wéi shí yǐ wǎn
13157,尾隨,7,,5,1,6,ㄨㄟˇ ㄙㄨㄟˊ,wěi suí
13158,畏縮,7,,6,1,7,ㄨㄟˋ ㄙㄨㄛ,wèi suō
13159,為所欲為,7,,4,2,6,ㄨㄟˊ ㄙㄨㄛˇ ㄩˋ ㄨㄟˊ,wéi suǒ yù wéi
13160,委婉,7,,6,2,8,ㄨㄟˇ ㄨㄢˇ,wěi wǎn
13161,威望,7,,5,2,7,ㄨㄟ ㄨㄤˋ,wēi wàng
13162,蔚為,7,,3,3,6,ㄨㄟˋ ㄨㄟˊ,wèi wéi
13163,娓娓道來,7,,3,1,4,ㄨㄟˇ ㄨㄟˇ ㄉㄠˋ ㄌㄞˊ,wěi wěi dào lái
13164,為伍,7,,3,2,5,ㄨㄟˊ ㄨˇ,wéi wǔ
13165,威武,7,,3,2,5,ㄨㄟ ㄨˇ,wēi wǔ
13166,威信,7,,6,2,8,ㄨㄟ ㄒㄧㄣˋ,wēi xìn
13167,為宜,7,,3,0,3,ㄨㄟˊ ㄧˊ,wéi yí
13168,未雨綢繆,7,,3,2,5,ㄨㄟˋ ㄩˇ ㄔㄡˊ ㄇㄡˊ,wèi yǔ chóu móu
13169,溫飽,7,,4,13,17,ㄨㄣ ㄅㄠˇ,wēn bǎo
13170,文采,7,,3,0,3,ㄨㄣˊ ㄘㄞˇ,wén cǎi
13171,溫床,7,,3,3,6,ㄨㄣ ㄔㄨㄤˊ,wēn chuáng
13172,穩當,7,,2,1,3,ㄨㄣˇ ㄉㄤˋ,wěn dàng
13173,文風,7,,2,0,2,ㄨㄣˊ ㄈㄥ,wén fēng
13174,文稿,7,,5,2,7,ㄨㄣˊ ㄍㄠˇ,wén gǎo
13175,文豪,7,,3,1,4,ㄨㄣˊ ㄏㄠˊ,wén háo
13176,文集,7,,4,1,5,ㄨㄣˊ ㄐㄧˊ,wén jí
13177,穩健,7,,4,2,6,ㄨㄣˇ ㄐㄧㄢˋ,wěn jiàn
13178,文教,7,,7,4,11,ㄨㄣˊ ㄐㄧㄠˋ,wén jiào
13179,紋路,7,,4,4,8,ㄨㄣˊ ㄌㄨˋ,wén lù
13180,溫情,7,,5,5,10,ㄨㄣ ㄑㄧㄥˊ,wēn qíng
13181,紋身,7,,1,2,3,ㄨㄣˊ ㄕㄣ,wén shēn
13182,溫順,7,,4,1,5,ㄨㄣ ㄕㄨㄣˋ,wēn shùn
13183,文壇,7,,5,2,7,ㄨㄣˊ ㄊㄢˊ,wén tán
13184,文武百官,7,,6,1,7,ㄨㄣˊ ㄨˇ ㄅㄞˇ ㄍㄨㄢ,wén wǔ bǎi guān
13185,溫習,7,,2,3,5,ㄨㄣ ㄒㄧˊ,wēn xí
13186,文雅,7,,3,2,5,ㄨㄣˊ ㄧㄚˇ,wén yǎ
13187,問罪,7,,3,0,3,ㄨㄣˋ ㄗㄨㄟˋ,wèn zuì
13188,窩囊,7,,4,0,4,ㄨㄛ ˙ㄋㄤ,wō nang
13189,窩心,7,,2,4,6,ㄨㄛ ㄒㄧㄣ,wō xīn
13190,我行我素,7,,3,1,4,ㄨㄛˇ ㄒㄧㄥˊ ㄨㄛˇ ㄙㄨˋ,wǒ xíng wǒ sù
13191,伍,7,,4,6,10,ㄨˇ,wǔ
13192,無邊無際,7,,3,1,4,ㄨˊ ㄅㄧㄢ ㄨˊ ㄐㄧˋ,wú biān wú jì
13193,舞步,7,,3,6,9,ㄨˇ ㄅㄨˋ,wǔ bù
13194,五彩,7,,3,1,4,ㄨˇ ㄘㄞˇ,wǔ cǎi
13195,五彩繽紛,7,,2,2,4,ㄨˇ ㄘㄞˇ ㄅㄧㄣ ㄈㄣ,wǔ cǎi bīn fēn
13196,誤差,7,,5,3,8,ㄨˋ ㄔㄚ,wù chā
13197,無地自容,7,,2,1,3,ㄨˊ ㄉㄧˋ ㄗˋ ㄖㄨㄥˊ,wú dì zì róng
13198,無動於衷,7,,6,1,7,ㄨˊ ㄉㄨㄥˋ ㄩˊ ㄓㄨㄥ,wú dòng yú zhōng
13199,無端,7,,3,1,4,ㄨˊ ㄉㄨㄢ,wú duān
13200,武斷,7,,4,0,4,ㄨˇ ㄉㄨㄢˋ,wǔ duàn
13201,無法無天,7,,3,1,4,ㄨˊ ㄈㄚˇ ㄨˊ ㄊㄧㄢ,wú fǎ wú tiān
13202,無故,7,,3,0,3,ㄨˊ ㄍㄨˋ,wú gù
13203,無怪乎,7,,3,0,3,ㄨˊ ㄍㄨㄞˋ ㄏㄨ,wú guài hū
13204,五光十色,7,,2,2,4,ㄨˇ ㄍㄨㄤ ㄕˊ ㄙㄜˋ,wǔ guāng shí sè
13205,嗚呼,7,,24,0,24,ㄨ ㄏㄨ,wū hū
13206,污穢/汙穢,7,,4,1,5,ㄨ ㄏㄨㄟˋ,wū huì
13207,無計可施,7,,4,0,4,ㄨˊ ㄐㄧˋ ㄎㄜˇ ㄕ,wú jì kě shī
13208,無濟於事,7,,4,0,4,ㄨˊ ㄐㄧˋ ㄩˊ ㄕˋ,wú jì yú shì
13209,無稽之談,7,,3,1,4,ㄨˊ ㄐㄧ ㄓ ㄊㄢˊ,wú jī zhī tán
13210,無價,7,,3,4,7,ㄨˊ ㄐㄧㄚˋ,wú jià
13211,武將,7,,11,1,12,ㄨˇ ㄐㄧㄤˋ,wǔ jiàng
13212,五金,7,,1,4,5,ㄨˇ ㄐㄧㄣ,wǔ jīn
13213,無精打采,7,,5,1,6,ㄨˊ ㄐㄧㄥ ㄉㄚˇ ㄘㄞˇ,wú jīng dǎ cǎi
13214,無懼,7,,3,1,4,ㄨˊ ㄐㄩˋ,wú jù
13215,無拘無束,7,,3,1,4,ㄨˊ ㄐㄩ ㄨˊ ㄕㄨˋ,wú jū wú shù
13216,無可厚非,7,,2,1,3,ㄨˊ ㄎㄜˇ ㄏㄡˋ ㄈㄟ,wú kě hòu fēi
13217,無可救藥,7,,3,1,4,ㄨˊ ㄎㄜˇ ㄐㄧㄡˋ ㄧㄠˋ,wú kě jiù yào
13218,無賴,7,,7,0,7,ㄨˊ ㄌㄞˋ,wú lài
13219,無量,7,,4,7,11,ㄨˊ ㄌㄧㄤˋ,wú liàng
13220,武林,7,,14,2,16,ㄨˇ ㄌㄧㄣˊ,wǔ lín
13221,無門,7,,3,1,4,ㄨˊㄇㄣˊ,wú mén
13222,污泥,7,,2,3,5,ㄨ ㄋㄧˊ,wū ní
13223,毋寧,7,,5,1,6,ㄨˊ ㄋㄧㄥˊ,wú níng
13224,巫婆,7,,4,1,5,ㄨ ㄆㄛˊ,wū pó
13225,無奇,7,,2,1,3,ㄨˊ ㄑㄧˊ,wú qí
13226,霧氣,7,,4,3,7,ㄨˋ ㄑㄧˋ,wù qì
13227,無窮無盡,7,,3,1,4,ㄨˊ ㄑㄩㄥˊ ㄨˊ ㄐㄧㄣˋ,wú qióng wú jìn
13228,誤入歧途,7,,2,2,4,ㄨˋ ㄖㄨˋ ㄑㄧˊ ㄊㄨˊ,wù rù qí tú
13229,物色,7,,4,0,4,ㄨˋ ㄙㄜˋ,wù sè
13230,無上,7,,3,2,5,ㄨˊ ㄕㄤˋ,wú shàng
13231,無聲無息,7,,3,1,4,ㄨˊ ㄕㄥ ㄨˊ ㄒㄧˊ,wú shēng wú xí
13232,武士,7,,28,0,28,ㄨˇ ㄕˋ,wǔ shì
13233,巫師,7,,8,1,9,ㄨ ㄕ,wū shī
13234,武術,7,,4,4,8,ㄨˇ ㄕㄨˋ,wǔ shù
13235,五體投地,7,,2,1,3,ㄨˇ ㄊㄧˇ ㄊㄡˊ ㄉㄧˋ,wǔ tǐ tóu dì
13236,無往不利,7,,2,1,3,ㄨˊ ㄨㄤˇ ㄅㄨˊ ㄌㄧˋ,wú wǎng bú lì
13237,無畏,7,,3,1,4,ㄨˊ ㄨㄟˋ,wú wèi
13238,無謂,7,,6,2,8,ㄨˊ ㄨㄟˋ,wú wèi
13239,無微不至,7,,3,1,4,ㄨˊ ㄨㄟˊ ㄅㄨˊ ㄓˋ,wú wéi bú zhì
13240,無暇,7,,6,3,9,ㄨˊ ㄒㄧㄚˊ,wú xiá
13241,誣陷,7,,4,1,5,ㄨ ㄒㄧㄢˋ,wū xiàn
13242,無邪,7,,4,2,6,ㄨˊ ㄒㄧㄝˊ,wú xié
13243,無懈可擊,7,,3,1,4,ㄨˊ ㄒㄧㄝˋ ㄎㄜˇ ㄐㄧˊ,wú xiè kě jí
13244,屋簷,7,,6,5,11,ㄨ ㄧㄢˊ,wū yán
13245,無恙,7,,2,0,2,ㄨˊ ㄧㄤˋ,wú yàng
13246,無依,7,,2,2,4,ㄨˊ ㄧ,wú yī
13247,無影無蹤,7,,5,1,6,ㄨˊ ㄧㄥˇ ㄨˊ ㄗㄨㄥ,wú yǐng wú zōng
13248,無憂,7,,3,1,4,ㄨˊ ㄧㄡ,wú yōu 
13249,無虞,7,,4,3,7,ㄨˊ ㄩˊ,wú yú
13250,無與倫比,7,,4,1,5,ㄨˊ ㄩˇ ㄌㄨㄣˊ ㄅㄧˇ,wú yǔ lún bǐ
13251,無緣,7,,4,4,8,ㄨˊ ㄩㄢˊ,wú yuán
13252,無遠弗屆,7,,3,2,5,ㄨˊ ㄩㄢˇ ㄈㄨˊ ㄐㄧㄝˋ,wú yuǎn fú jiè
13253,無緣無故,7,,4,2,6,ㄨˊ ㄩㄢˊ ㄨˊ ㄍㄨˋ,wú yuán wú gù
13254,無怨無悔,7,,2,3,5,ㄨˊ ㄩㄢˋ ㄨˊ ㄏㄨㄟˇ,wú yuàn wú huǐ
13255,無中生有,7,,4,1,5,ㄨˊ ㄓㄨㄥ ㄕㄥ ㄧㄡˇ,wú zhōng shēng yǒu
13256,兀自,7,,3,1,4,ㄨˋ ㄗˋ,wù zì
13257,無足輕重,7,,3,1,4,ㄨˊ ㄗㄨˊ ㄑㄧㄥ ㄓㄨㄥˋ,wú zú qīng zhòng
13258,襲,7,,8,4,12,ㄒㄧˊ,xí
13259,錫,7,,10,6,16,ㄒㄧˊ,xí
13260,稀,7,,4,6,10,ㄒㄧ,xī
13261,稀薄,7,,3,1,4,ㄒㄧ ㄅㄛˊ,xī bó
13262,細部,7,,2,2,4,ㄒㄧˋ ㄅㄨˋ,xì bù
13263,戲稱,7,,2,3,5,ㄒㄧˋ ㄔㄥ,xì chēng
13264,喜出望外,7,,4,1,5,ㄒㄧˇ ㄔㄨ ㄨㄤˋ ㄨㄞˋ,xǐ chū wàng wài
13265,洗滌,7,,6,12,18,ㄒㄧˇ ㄉㄧˊ,xǐ dí
13266,細讀,7,,3,0,3,ㄒㄧˋ ㄉㄨˊ,xì dú
13267,稀罕,7,,3,1,4,ㄒㄧ ㄏㄢˇ,xī hǎn
13268,洗劫,7,,3,0,3,ㄒㄧˇ ㄐㄧㄝˊ,xǐ jié
13269,席捲,7,,5,5,10,ㄒㄧˊ ㄐㄩㄢˇ,xí juǎn
13270,稀爛,7,,2,0,2,ㄒㄧ ㄌㄢˋ,xī làn
13271,洗禮,7,,5,6,11,ㄒㄧˇ ㄌㄧˇ,xǐ lǐ
13272,犀利,7,,5,2,7,ㄒㄧ ㄌㄧˋ,xī lì
13273,奚落,7,,3,1,4,ㄒㄧ ㄌㄨㄛˋ,xī luò
13274,戲碼,7,,5,4,9,ㄒㄧˋ ㄇㄚˇ,xì mǎ
13275,細密,7,,3,2,5,ㄒㄧˋ ㄇㄧˋ,xì mì
13276,吸納,7,,3,1,4,ㄒㄧ ㄋㄚˋ,xī nà
13277,洗腦,7,,3,3,6,ㄒㄧˇ ㄋㄠˇ,xǐ nǎo
13278,嬉鬧,7,,2,1,3,ㄒㄧ ㄋㄠˋ,xī nào
13279,戲弄,7,,4,1,5,ㄒㄧˋ ㄋㄨㄥˋ,xì nòng
13280,習氣,7,,3,9,12,ㄒㄧˊ ㄑㄧˋ,xí qì
13281,稀奇古怪,7,,3,0,3,ㄒㄧ ㄑㄧˊ ㄍㄨˇ ㄍㄨㄞˋ,xī qí gǔ guài
13282,喜氣洋洋,7,,2,1,3,ㄒㄧˇ ㄑㄧˋ ㄧㄤˊ ㄧㄤˊ,xǐ qì yáng yáng
13283,蹊蹺,7,,4,1,5,ㄒㄧ ㄑㄧㄠ,xī qiāo
13284,戲曲,7,,5,6,11,ㄒㄧˋ ㄑㄩˇ,xì qǔ
13285,攜手,7,,7,8,15,ㄒㄧ ㄕㄡˇ,xī shǒu
13286,細數,7,,3,2,5,ㄒㄧˋㄕㄨˇ,xì shǔ
13287,悉數2,7,,3,0,3,ㄒㄧ ㄕㄨˋ,xī shù
13288,悉數1,7,,3,0,3,ㄒㄧ ㄕㄨˇ,xī shǔ
13289,稀疏,7,,5,2,7,ㄒㄧ ㄕㄨ,xī shū
13290,洗刷,7,,4,2,6,ㄒㄧˇ ㄕㄨㄚ,xǐ shuā
13291,吸吮,7,,7,0,7,ㄒㄧ ㄕㄨㄣˇ,xī shǔn
13292,細說,7,,3,2,5,ㄒㄧˋ ㄕㄨㄛ,xì shuō
13293,稀鬆,7,,4,4,8,ㄒㄧ ㄙㄨㄥ,xī sōng
13294,嬉戲,7,,6,4,10,ㄒㄧ ㄒㄧˋ,xī xì
13295,嘻嘻哈哈,7,,2,1,3,ㄒㄧ ㄒㄧ ㄏㄚ ㄏㄚ,xī xī hā hā
13296,膝下,7,,3,1,4,ㄒㄧ ㄒㄧㄚˋ,xī xià
13297,細想,7,,3,0,3,ㄒㄧˋ ㄒㄧㄤˇ,xì xiǎng
13298,悉心,7,,4,2,6,ㄒㄧ ㄒㄧㄣ,xī xīn
13299,喜訊,7,,2,1,3,ㄒㄧˇ ㄒㄩㄣˋ,xǐ xùn
13300,習以為常,7,,4,2,6,ㄒㄧˊ ㄧˇ ㄨㄟˊ ㄔㄤˊ,xí yǐ wéi cháng
13301,繫於,7,,4,1,5,ㄒㄧˋ ㄩˊ,xì yú
13302,細語,7,,5,4,9,ㄒㄧˋ ㄩˇ,xì yǔ
13303,下筆,7,,4,1,5,ㄒㄧㄚˋ ㄅㄧˇ,xià bǐ
13304,狹長,7,,3,5,8,ㄒㄧㄚˊ ㄔㄤˊ,xiá cháng
13305,夏朝,7,,2,0,2,ㄒㄧㄚˋ ㄔㄠˊ,xià cháo
13306,下沉,7,,3,6,9,ㄒㄧㄚˋ ㄔㄣˊ,xià chén
13307,挾持,7,,4,2,6,ㄒㄧㄚˊ ㄔˊ,xiá chí
13308,下廚,7,,3,5,8,ㄒㄧㄚˋ ㄔㄨˊ,xià chú
13309,下肚,7,,4,1,5,ㄒㄧㄚˋ ㄉㄨˋ,xià dù
13310,下凡,7,,6,1,7,ㄒㄧㄚˋ ㄈㄢˊ,xià fán
13311,下風,7,,2,1,3,ㄒㄧㄚˋ ㄈㄥ,xià fēng
13312,下功夫,7,,3,1,4,ㄒㄧㄚˋ ㄍㄨㄥ ˙ㄈㄨ,xià gōng fu
13313,下海,7,,5,3,8,ㄒㄧㄚˋ ㄏㄞˇ,xià hǎi
13314,嚇唬,7,,4,1,5,ㄒㄧㄚˋ ㄏㄨˇ,xià hǔ
13315,下級,7,,3,0,3,ㄒㄧㄚˋ ㄐㄧˊ,xià jí
13316,下人,7,,3,0,3,ㄒㄧㄚˋ ㄖㄣˊ,xià rén
13317,下榻,7,,3,2,5,ㄒㄧㄚˋ ㄊㄚˋ,xià tà
13318,遐想,7,,3,0,3,ㄒㄧㄚˊ ㄒㄧㄤˇ,xiá xiǎng
13319,下嚥,7,,3,1,4,ㄒㄧㄚˋ ㄧㄢˋ,xià yàn
13320,狹義,7,,3,1,4,ㄒㄧㄚˊ ㄧˋ,xiá yì
13321,下載,7,,4,3,7,ㄒㄧㄚˋ ㄗㄞˋ,xià zài
13322,下葬,7,,3,1,4,ㄒㄧㄚˋ ㄗㄤˋ,xià zàng
13323,下詔,7,,8,0,8,ㄒㄧㄚˋ ㄓㄠˋ,xià zhào
13324,弦,7,,23,2,25,ㄒㄧㄢˊ,xián
13325,銜,7,,7,1,8,ㄒㄧㄢˊ,xián
13326,掀,7,,4,2,6,ㄒㄧㄢ,xiān
13327,嫌犯,7,,5,8,13,ㄒㄧㄢˊ ㄈㄢˋ,xián fàn
13328,鮮紅,7,,4,3,7,ㄒㄧㄢ ㄏㄨㄥˊ,xiān hóng
13329,閒話家常,7,,2,1,3,ㄒㄧㄢˊ ㄏㄨㄚˋ ㄐㄧㄚ ㄔㄤˊ,xián huà jiā cháng
13330,賢慧,7,,3,2,5,ㄒㄧㄢˊ ㄏㄨㄟˋ,xián huì
13331,先機,7,,3,1,4,ㄒㄧㄢ ㄐㄧ,xiān jī
13332,顯見,7,,2,1,3,ㄒㄧㄢˇ ㄐㄧㄢˋ,xiǎn jiàn
13333,先見之明,7,,3,0,3,ㄒㄧㄢ ㄐㄧㄢˋ ㄓ ㄇㄧㄥˊ,xiān jiàn zhī míng
13334,銜接,7,,5,5,10,ㄒㄧㄢˊ ㄐㄧㄝ,xián jiē
13335,險境,7,,4,2,6,ㄒㄧㄢˇ ㄐㄧㄥˋ,xiǎn jìng
13336,仙境,7,,4,3,7,ㄒㄧㄢ ㄐㄧㄥˋ,xiān jìng
13337,先決條件,7,,0,0,0,ㄒㄧㄢ ㄐㄩㄝˊ ㄊㄧㄠˊ ㄐㄧㄢˋ,xiān jué tiáo jiàn
13338,險峻,7,,3,3,6,ㄒㄧㄢˇ ㄐㄩㄣˋ,xiǎn jùn
13339,線路,7,,5,5,10,ㄒㄧㄢˋ ㄌㄨˋ,xiàn lù
13340,陷落,7,,4,3,7,ㄒㄧㄢˋ ㄌㄨㄛˋ,xiàn luò
13341,賢明,7,,4,1,5,ㄒㄧㄢˊ ㄇㄧㄥˊ,xián míng
13342,嫌棄,7,,4,2,6,ㄒㄧㄢˊ ㄑㄧˋ,xián qì
13343,限期,7,,3,2,5,ㄒㄧㄢˋ ㄑㄧˊ,xiàn qí
13344,先人,7,,5,4,9,ㄒㄧㄢ ㄖㄣˊ,xiān rén
13345,鮮少,7,,4,4,8,ㄒㄧㄢˇ ㄕㄠˇ,xiǎn shǎo
13346,獻身,7,,5,1,6,ㄒㄧㄢˋ ㄕㄣ,xiàn shēn
13347,嫻熟,7,,3,1,4,ㄒㄧㄢˊ ㄕㄡˊ,xián shóu
13348,嫌惡,7,,4,1,5,ㄒㄧㄢˊ ㄨˋ,xián wù
13349,纖細,7,,6,1,7,ㄒㄧㄢ ㄒㄧˋ,xiān xì
13350,顯眼,7,,6,1,7,ㄒㄧㄢˇ ㄧㄢˇ,xiǎn yǎn
13351,鮮豔/鮮艷,7,,9,16,25,ㄒㄧㄢ ㄧㄢˋ,xiān yàn
13352,閒置,7,,4,5,9,ㄒㄧㄢˊ ㄓˋ,xián zhì
13353,降2,7,,37,52,89,ㄒㄧㄤˊ,xiáng
13354,鑲,7,,11,2,13,ㄒㄧㄤ,xiāng
13355,相安無事,7,,3,2,5,ㄒㄧㄤ ㄢ ㄨˊ ㄕˋ,xiāng ān wú shì
13356,香草,7,,3,11,14,ㄒㄧㄤ ㄘㄠˇ,xiāng cǎo
13357,相稱,7,,5,0,5,ㄒㄧㄤ ㄔㄥˋ,xiāng chèng
13358,鄉愁,7,,4,3,7,ㄒㄧㄤ ㄔㄡˊ,xiāng chóu
13359,相對論,7,,7,0,7,ㄒㄧㄤ ㄉㄨㄟˋ ㄌㄨㄣˋ,xiāng duì lùn
13360,相逢,7,,4,1,5,ㄒㄧㄤ ㄈㄥˊ,xiāng féng
13361,享福,7,,3,2,5,ㄒㄧㄤˇ ㄈㄨˊ,xiǎng fú
13362,相輔相成,7,,5,4,9,ㄒㄧㄤ ㄈㄨˇ ㄒㄧㄤ ㄔㄥˊ,xiāng fǔ xiāng chéng
13363,相干,7,,3,1,4,ㄒㄧㄤ ㄍㄢ,xiāng gān
13364,相告,7,,3,0,3,ㄒㄧㄤ ㄍㄠˋ,xiāng gào
13365,香火,7,,5,4,9,ㄒㄧㄤ ㄏㄨㄛˇ,xiāng huǒ
13366,相間,7,,5,2,7,ㄒㄧㄤ ㄐㄧㄢˋ,xiāng jiàn
13367,相接,7,,3,1,4,ㄒㄧㄤ ㄐㄧㄝ,xiāng jiē
13368,相聚,7,,7,6,13,ㄒㄧㄤ ㄐㄩˋ,xiāng jù
13369,相距,7,,5,3,8,ㄒㄧㄤ ㄐㄩˋ,xiāng jù
13370,相戀,7,,3,2,5,ㄒㄧㄤ ㄌㄧㄢˋ,xiāng liàn
13371,相親相愛,7,,3,2,5,ㄒㄧㄤ ㄑㄧㄣ ㄒㄧㄤ ㄞˋ,xiāng qīn xiāng ài
13372,相讓,7,,2,0,2,ㄒㄧㄤ ㄖㄤˋ,xiāng ràng
13373,相思,7,,5,4,9,ㄒㄧㄤ ㄙ,xiāng sī
13374,相提並論,7,,6,1,7,ㄒㄧㄤ ㄊㄧˊ ㄅㄧㄥˋ ㄌㄨㄣˋ,xiāng tí bìng lùn
13375,相向,7,,4,0,4,ㄒㄧㄤ ㄒㄧㄤˋ,xiāng xiàng
13376,向心力,7,,4,6,10,ㄒㄧㄤˋ ㄒㄧㄣ ㄌㄧˋ,xiàng xīn lì
13377,鄉野,7,,3,2,5,ㄒㄧㄤ ㄧㄝˇ,xiāng yě
13378,相異,7,,4,1,5,ㄒㄧㄤ ㄧˋ,xiāng yì
13379,相依為命,7,,4,2,6,ㄒㄧㄤ ㄧ ㄨㄟˊ ㄇㄧㄥˋ,xiāng yī wéi mìng
13380,相約,7,,4,4,8,ㄒㄧㄤ ㄩㄝ,xiāng yuē
13381,相知,7,,3,3,6,ㄒㄧㄤ ㄓ,xiāng zhī
13382,相左,7,,3,1,4,ㄒㄧㄤ ㄗㄨㄛˇ,xiāng zuǒ
13383,詳加,7,,3,1,4,ㄒㄧㄤˊㄐㄧㄚ,xiángjiā
13384,陷於,7,,10,1,11,ㄒㄧㄢˋㄩˊ,xiànyú
13385,笑柄,7,,2,0,2,ㄒㄧㄠˋ ㄅㄧㄥˇ,xiào bǐng
13386,消沉,7,,7,1,8,ㄒㄧㄠ ㄔㄣˊ,xiāo chén
13387,孝道,7,,4,5,9,ㄒㄧㄠˋ ㄉㄠˋ,xiào dào
13388,銷毀,7,,3,8,11,ㄒㄧㄠ ㄏㄨㄟˇ,xiāo huǐ
13389,小節,7,,4,0,4,ㄒㄧㄠˇ ㄐㄧㄝˊ,xiǎo jié
13390,孝敬,7,,4,3,7,ㄒㄧㄠˋ ㄐㄧㄥˋ,xiào jìng
13391,效勞,7,,4,1,5,ㄒㄧㄠˋ ㄌㄠˊ,xiào láo
13392,銷量,7,,4,4,8,ㄒㄧㄠ ㄌㄧㄤˋ,xiāo liàng
13393,消弭,7,,4,4,8,ㄒㄧㄠ ㄇㄧˇ,xiāo mǐ
13394,小名,7,,3,0,3,ㄒㄧㄠˇ ㄇㄧㄥˊ,xiǎo míng
13395,消磨,7,,7,2,9,ㄒㄧㄠ ㄇㄛˊ,xiāo mó
13396,小品,7,,3,2,5,ㄒㄧㄠˇ ㄆㄧㄣˇ,xiǎo pǐn
13397,笑容可掬,7,,2,0,2,ㄒㄧㄠˋ ㄖㄨㄥˊ ㄎㄜˇ ㄐㄩˊ,xiào róng kě jú
13398,消散,7,,5,1,6,ㄒㄧㄠ ㄙㄢˋ,xiāo sàn
13399,校舍,7,,3,7,10,ㄒㄧㄠˋ ㄕㄜˋ,xiào shè
13400,銷聲匿跡,7,,2,2,4,ㄒㄧㄠ ㄕㄥ ㄋㄧˋ ㄐㄧ,xiāo shēng nì jī
13401,消瘦,7,,4,1,5,ㄒㄧㄠ ㄕㄡˋ,xiāo shòu
13402,小題大作,7,,3,0,3,ㄒㄧㄠˇ ㄊㄧˊ ㄉㄚˋ ㄗㄨㄛˋ,xiǎo tí dà zuò
13403,消退,7,,4,4,8,ㄒㄧㄠ ㄊㄨㄟˋ,xiāo tuì
13404,孝心,7,,3,4,7,ㄒㄧㄠˋ ㄒㄧㄣ,xiào xīn
13405,消長,7,,2,4,6,ㄒㄧㄠ ㄓㄤˇ,xiāo zhǎng
13406,囂張,7,,4,2,6,ㄒㄧㄠ ㄓㄤ,xiāo zhāng
13407,偕,7,,3,0,3,ㄒㄧㄝˊ,xié
13408,卸,7,,3,1,4,ㄒㄧㄝˋ,xiè
13409,懈怠,7,,4,3,7,ㄒㄧㄝˋ ㄉㄞˋ,xiè dài
13410,褻瀆,7,,4,1,5,ㄒㄧㄝˋ ㄉㄨˊ,xiè dú
13411,邂逅,7,,5,0,5,ㄒㄧㄝˋ ㄏㄡˋ,xiè hòu
13412,謝絕,7,,3,1,4,ㄒㄧㄝˋ ㄐㄩㄝˊ,xiè jué
13413,血淚,7,,3,3,6,ㄒㄧㄝˇ ㄌㄟˋ,xiě lèi
13414,協力,7,,4,12,16,ㄒㄧㄝˊ ㄌㄧˋ,xié lì
13415,血淋淋,7,,4,2,6,ㄒㄧㄝˇ ㄌㄧㄣˊ ㄌㄧㄣˊ,xiě lín lín
13416,洩露,7,,4,1,5,ㄒㄧㄝˋ ㄌㄨˋ,xiè lù
13417,血脈,7,,5,4,9,ㄒㄧㄝˇ ㄇㄞˋ,xiě mài
13418,脅迫,7,,4,0,4,ㄒㄧㄝˊ ㄆㄛˋ,xié pò
13419,洩氣,7,,6,2,8,ㄒㄧㄝˋ ㄑㄧˋ,xiè qì
13420,卸任,7,,3,3,6,ㄒㄧㄝˋ ㄖㄣˋ,xiè rèn
13421,血色,7,,4,1,5,ㄒㄧㄝˇ ㄙㄜˋ,xiě sè
13422,歇斯底里,7,,7,1,8,ㄒㄧㄝ ㄙ ㄉㄧˇ ㄌㄧˇ,xiē sī dǐ lǐ
13423,歇息,7,,5,1,6,ㄒㄧㄝ ㄒㄧˊ,xiē xí
13424,諧音,7,,4,2,6,ㄒㄧㄝˊ ㄧㄣ,xié yīn
13425,寫照,7,,6,10,16,ㄒㄧㄝˇ ㄓㄠˋ,xiě zhào
13426,心安理得,7,,3,1,4,ㄒㄧㄣ ㄢ ㄌㄧˇ ㄉㄜˊ,xīn ān lǐ dé
13427,新版,7,,4,2,6,ㄒㄧㄣ ㄅㄢˇ,xīn bǎn
13428,信步,7,,2,0,2,ㄒㄧㄣˋ ㄅㄨˋ,xìn bù
13429,心不甘情不願,7,,2,2,4,ㄒㄧㄣ ㄅㄨˋ ㄍㄢ ㄑㄧㄥˊㄅㄨˊㄩㄢˋ,xīn bù gān qíng bú yuàn
13430,新潮,7,,3,1,4,ㄒㄧㄣ ㄔㄠˊ,xīn cháo
13431,心煩意亂,7,,4,0,4,ㄒㄧㄣ ㄈㄢˊ ㄧˋ ㄌㄨㄢˋ,xīn fán yì luàn
13432,心房,7,,3,0,3,ㄒㄧㄣ ㄈㄤˊ,xīn fáng
13433,心防,7,,3,1,4,ㄒㄧㄣ ㄈㄤˊ,xīn fáng
13434,心腹,7,,5,0,5,ㄒㄧㄣ ㄈㄨˋ,xīn fù
13435,心肝,7,,4,2,6,ㄒㄧㄣ ㄍㄢ,xīn gān
13436,心花怒放,7,,2,0,2,ㄒㄧㄣ ㄏㄨㄚ ㄋㄨˋ ㄈㄤˋ,xīn huā nù fàng
13437,心慌,7,,3,1,4,ㄒㄧㄣ ㄏㄨㄤ,xīn huāng
13438,心灰意冷,7,,2,0,2,ㄒㄧㄣ ㄏㄨㄟ ㄧˋ ㄌㄥˇ,xīn huī yì lěng
13439,薪火,7,,1,0,1,ㄒㄧㄣ ㄏㄨㄛˇ,xīn huǒ
13440,心機,7,,6,1,7,ㄒㄧㄣ ㄐㄧ,xīn jī
13441,心結,7,,4,1,5,ㄒㄧㄣ ㄐㄧㄝˊ,xīn jié
13442,心驚肉跳,7,,3,0,3,ㄒㄧㄣ ㄐㄧㄥ ㄖㄡˋ ㄊㄧㄠˋ,xīn jīng ròu tiào
13443,心口,7,,2,1,3,ㄒㄧㄣ ㄎㄡˇ,xīn kǒu
13444,心曠神怡,7,,3,3,6,ㄒㄧㄣ ㄎㄨㄤˋ ㄕㄣˊ ㄧˊ,xīn kuàng shén yí
13445,辛辣,7,,3,1,4,ㄒㄧㄣ ㄌㄚˋ,xīn là
13446,心力交瘁,7,,2,0,2,ㄒㄧㄣ ㄌㄧˋ ㄐㄧㄠ ㄘㄨㄟˋ,xīn lì jiāo cuì
13447,心路歷程,7,,4,4,8,ㄒㄧㄣ ㄌㄨˋ ㄌㄧˋ ㄔㄥˊ,xīn lù lì chéng
13448,心念,7,,4,8,12,ㄒㄧㄣ ㄋㄧㄢˋ,xīn niàn
13449,心平氣和,7,,5,1,6,ㄒㄧㄣ ㄆㄧㄥˊ ㄑㄧˋ ㄏㄜˊ,xīn píng qì hé
13450,心切,7,,4,1,5,ㄒㄧㄣ ㄑㄧㄝˋ,xīn qiè
13451,辛勤,7,,7,7,14,ㄒㄧㄣ ㄑㄧㄣˊ,xīn qín
13452,心軟,7,,2,1,3,ㄒㄧㄣ ㄖㄨㄢˇ,xīn ruǎn
13453,心神不寧,7,,4,0,4,ㄒㄧㄣ ㄕㄣˊ ㄅㄨˋ ㄋㄧㄥˊ,xīn shén bù níng
13454,信誓旦旦,7,,2,2,4,ㄒㄧㄣˋ ㄕˋ ㄉㄢˋ ㄉㄢˋ,xìn shì dàn dàn
13455,信守,7,,4,1,5,ㄒㄧㄣˋ ㄕㄡˇ,xìn shǒu
13456,心術,7,,2,0,2,ㄒㄧㄣ ㄕㄨˋ,xīn shù
13457,心酸,7,,4,7,11,ㄒㄧㄣ ㄙㄨㄢ,xīn suān
13458,辛酸,7,,5,6,11,ㄒㄧㄣ ㄙㄨㄢ,xīn suān
13459,心窩,7,,2,1,3,ㄒㄧㄣ ㄨㄛ,xīn wō
13460,信息,7,,21,3,24,ㄒㄧㄣˋ ㄒㄧˊ,xìn xí
13461,欣喜若狂,7,,4,1,5,ㄒㄧㄣ ㄒㄧˇ ㄖㄨㄛˋ ㄎㄨㄤˊ,xīn xǐ ruò kuáng
13462,心弦,7,,3,1,4,ㄒㄧㄣ ㄒㄧㄢˊ,xīn xián
13463,心緒,7,,5,0,5,ㄒㄧㄣ ㄒㄩˋ,xīn xù
13464,心血來潮,7,,4,1,5,ㄒㄧㄣ ㄒㄩㄝˋ ㄌㄞˊ ㄔㄠˊ,xīn xuè lái cháo
13465,心眼,7,,4,1,5,ㄒㄧㄣ ㄧㄢˇ,xīn yǎn
13466,心儀,7,,2,1,3,ㄒㄧㄣ ㄧˊ,xīn yí
13467,信以為真,7,,4,0,4,ㄒㄧㄣˋ ㄧˇ ㄨㄟˊ ㄓㄣ,xìn yǐ wéi zhēn
13468,信譽,7,,3,1,4,ㄒㄧㄣˋ ㄩˋ,xìn yù
13469,心悅誠服,7,,2,0,2,ㄒㄧㄣ ㄩㄝˋ ㄔㄥˊ ㄈㄨˊ,xīn yuè chéng fú
13470,心照不宣,7,,2,0,2,ㄒㄧㄣ ㄓㄠˋ ㄅㄨˋ ㄒㄩㄢ,xīn zhào bù xuān
13471,心志,7,,5,1,6,ㄒㄧㄣ ㄓˋ,xīn zhì
13472,心知肚明,7,,4,1,5,ㄒㄧㄣ ㄓ ㄉㄨˋ ㄇㄧㄥˊ,xīn zhī dù míng
13473,星辰,7,,6,1,7,ㄒㄧㄥ ㄔㄣˊ,xīng chén
13474,興沖沖,7,,3,1,4,ㄒㄧㄥˋ ㄔㄨㄥ ㄔㄨㄥ,xìng chōng chōng
13475,刑罰,7,,6,0,6,ㄒㄧㄥˊ ㄈㄚˊ,xíng fá
13476,刑法,7,,4,1,5,ㄒㄧㄥˊ ㄈㄚˇ,xíng fǎ
13477,行賄,7,,3,0,3,ㄒㄧㄥˊ ㄏㄨㄟˋ,xíng huì
13478,性交,7,,6,0,6,ㄒㄧㄥˋ ㄐㄧㄠ,xìng jiāo
13479,行軍,7,,10,1,11,ㄒㄧㄥˊ ㄐㄩㄣ,xíng jūn
13480,星空,7,,3,4,7,ㄒㄧㄥ ㄎㄨㄥ,xīng kōng
13481,形貌,7,,3,1,4,ㄒㄧㄥˊ ㄇㄠˋ,xíng mào
13482,倖免,7,,4,3,7,ㄒㄧㄥˋ ㄇㄧㄢˇ,xìng miǎn
13483,杏仁,7,,10,10,20,ㄒㄧㄥˋ ㄖㄣˊ,xìng rén
13484,興盛,7,,6,8,14,ㄒㄧㄥ ㄕㄥˋ,xīng shèng
13485,型式,7,,4,3,7,ㄒㄧㄥˊ ㄕˋ,xíng shì
13486,行使,7,,6,3,9,ㄒㄧㄥˊ ㄕˇ,xíng shǐ
13487,興衰,7,,5,4,9,ㄒㄧㄥ ㄕㄨㄞ,xīng shuāi
13488,省思,7,,6,16,22,ㄒㄧㄥˇ ㄙ,xǐng sī
13489,惺忪,7,,3,1,4,ㄒㄧㄥ ㄙㄨㄥ,xīng sōng
13490,形塑,7,,7,2,9,ㄒㄧㄥˊ ㄙㄨˋ,xíng sù
13491,形體,7,,7,3,10,ㄒㄧㄥˊ ㄊㄧˇ,xíng tǐ
13492,興亡,7,,4,1,5,ㄒㄧㄥ ㄨㄤˊ,xīng wáng
13493,興旺,7,,5,3,8,ㄒㄧㄥ ㄨㄤˋ,xīng wàng
13494,興味,7,,4,1,5,ㄒㄧㄥˋ ㄨㄟˋ,xìng wèi
13495,行文,7,,3,1,4,ㄒㄧㄥˊ ㄨㄣˊ,xíng wén
13496,醒悟,7,,4,1,5,ㄒㄧㄥˇ ㄨˋ,xǐng wù
13497,形形色色,7,,5,2,7,ㄒㄧㄥˊ ㄒㄧㄥˊ ㄙㄜˋ ㄙㄜˋ,xíng xíng sè sè
13498,形影不離,7,,3,0,3,ㄒㄧㄥˊ ㄧㄥˇ ㄅㄨˋ ㄌㄧˊ,xíng yǐng bù lí
13499,幸災樂禍,7,,3,1,4,ㄒㄧㄥˋ ㄗㄞ ㄌㄜˋ ㄏㄨㄛˋ,xìng zāi lè huò
13500,興致勃勃,7,,5,1,6,ㄒㄧㄥˋ ㄓˋ ㄅㄛˊ ㄅㄛˊ,xìng zhì bó bó
13501,星座,7,,7,2,9,ㄒㄧㄥ ㄗㄨㄛˋ,xīng zuò
13502,凶惡/兇惡,7,,8,2,10,ㄒㄩㄥ ㄜˋ,xiōng è
13503,雄厚,7,,4,3,7,ㄒㄩㄥˊ ㄏㄡˋ,xióng hòu
13504,凶猛/兇猛,7,,8,3,11,ㄒㄩㄥ ㄇㄥˇ,xiōng měng
13505,胸脯,7,,5,1,6,ㄒㄩㄥ ㄆㄨˊ,xiōng pú
13506,雄心,7,,6,2,8,ㄒㄩㄥˊ ㄒㄧㄣ,xióng xīn
13507,熊熊烈火,7,,0,0,0,ㄒㄩㄥˊ ㄒㄩㄥˊㄌㄧㄝˋ ㄏㄨㄛˇ,xióng xióng liè huǒ
13508,胸有成竹,7,,3,1,4,ㄒㄩㄥ ㄧㄡˇ ㄔㄥˊ ㄓㄨˊ,xiōng yǒu chéng zhú
13509,雄壯,7,,3,1,4,ㄒㄩㄥˊ ㄓㄨㄤˋ,xióng zhuàng
13510,繡,7,,12,3,15,ㄒㄧㄡˋ,xiù
13511,宿,7,,4,5,9,ㄒㄧㄡˇ,xiǔ
13512,秀才,7,,13,3,16,ㄒㄧㄡˋ ㄘㄞˊ,xiù cái
13513,修道院,7,,9,2,11,ㄒㄧㄡ ㄉㄠˋ ㄩㄢˋ,xiū dào yuàn
13514,袖口,7,,3,1,4,ㄒㄧㄡˋ ㄎㄡˇ,xiù kǒu
13515,秀麗,7,,5,16,21,ㄒㄧㄡˋ ㄌㄧˋ,xiù lì
13516,修煉,7,,4,1,5,ㄒㄧㄡ ㄌㄧㄢˋ,xiū liàn
13517,修練,7,,6,3,9,ㄒㄧㄡ ㄌㄧㄢˋ,xiū liàn
13518,休憩,7,,3,3,6,ㄒㄧㄡ ㄑㄧˋ,xiū qì
13519,羞怯,7,,5,0,5,ㄒㄧㄡ ㄑㄩㄝˋ,xiū què
13520,羞澀,7,,3,1,4,ㄒㄧㄡ ㄙㄜˋ,xiū sè
13521,袖手旁觀,7,,3,1,4,ㄒㄧㄡˋ ㄕㄡˇ ㄆㄤˊ ㄍㄨㄢ,xiù shǒu páng guān
13522,修習,7,,4,2,6,ㄒㄧㄡ ㄒㄧˊ,xiū xí
13523,休想,7,,3,1,4,ㄒㄧㄡ ㄒㄧㄤˇ,xiū xiǎng
13524,休學,7,,3,2,5,ㄒㄧㄡ ㄒㄩㄝˊ,xiū xué
13525,修整,7,,2,2,4,ㄒㄧㄡ ㄓㄥˇ,xiū zhěng
13526,休止,7,,2,1,3,ㄒㄧㄡ ㄓˇ,xiū zhǐ
13527,修築,7,,5,2,7,ㄒㄧㄡ ㄓㄨˊ,xiū zhú
13528,序,7,,30,7,37,ㄒㄩˋ,xù
13529,蓄,7,,4,2,6,ㄒㄩˋ,xù
13530,鬚,7,,7,5,12,ㄒㄩ,xū
13531,虛幻,7,,7,2,9,ㄒㄩ ㄏㄨㄢˋ,xū huàn
13532,敘舊,7,,1,1,2,ㄒㄩˋ ㄐㄧㄡˋ,xù jiù
13533,虛空,7,,4,1,5,ㄒㄩ ㄎㄨㄥ,xū kōng
13534,序列,7,,16,2,18,ㄒㄩˋ ㄌㄧㄝˋ,xù liè
13535,虛名,7,,4,0,4,ㄒㄩ ㄇㄧㄥˊ,xū míng
13536,序幕,7,,4,4,8,ㄒㄩˋ ㄇㄨˋ,xù mù
13537,畜牧,7,,2,4,6,ㄒㄩˋ ㄇㄨˋ,xù mù
13538,許諾,7,,3,1,4,ㄒㄩˇ ㄋㄨㄛˋ,xǔ nuò
13539,序曲,7,,3,3,6,ㄒㄩˋ ㄑㄩˇ,xù qǔ
13540,旭日,7,,2,2,4,ㄒㄩˋ ㄖˋ,xù rì
13541,虛無,7,,5,1,6,ㄒㄩ ㄨˊ,xū wú
13542,徐徐,7,,4,3,7,ㄒㄩˊ ㄒㄩˊ,xú xú
13543,栩栩如生,7,,4,2,6,ㄒㄩˇ ㄒㄩˇ ㄖㄨˊ ㄕㄥ,xǔ xǔ rú shēng
13544,序言,7,,4,1,5,ㄒㄩˋ ㄧㄢˊ,xù yán
13545,宣導,7,,5,15,20,ㄒㄩㄢ ㄉㄠˇ,xuān dǎo
13546,宣讀,7,,4,1,5,ㄒㄩㄢ ㄉㄨˊ,xuān dú
13547,旋風,7,,5,1,6,ㄒㄩㄢˋ ㄈㄥ,xuàn fēng
13548,玄關,7,,5,3,8,ㄒㄩㄢˊ ㄍㄨㄢ,xuán guān
13549,喧嘩,7,,4,1,5,ㄒㄩㄢ ㄏㄨㄚˊ,xuān huá
13550,旋即,7,,5,1,6,ㄒㄩㄢˊ ㄐㄧˊ,xuán jí
13551,玄機,7,,4,6,10,ㄒㄩㄢˊ ㄐㄧ,xuán jī
13552,絢爛,7,,3,2,5,ㄒㄩㄢˋ ㄌㄢˋ,xuàn làn
13553,絢麗,7,,2,2,4,ㄒㄩㄢˋ ㄌㄧˋ,xuàn lì
13554,喧鬧,7,,5,2,7,ㄒㄩㄢ ㄋㄠˋ,xuān nào
13555,宣判,7,,4,4,8,ㄒㄩㄢ ㄆㄢˋ,xuān pàn
13556,渲染,7,,5,2,7,ㄒㄩㄢˋ ㄖㄢˇ,xuàn rǎn
13557,軒然大波,7,,2,3,5,ㄒㄩㄢ ㄖㄢˊ ㄉㄚˋ ㄅㄛ,xuān rán dà bō
13558,懸殊,7,,4,3,7,ㄒㄩㄢˊ ㄕㄨ,xuán shū
13559,喧囂,7,,4,3,7,ㄒㄩㄢ ㄒㄧㄠ,xuān xiāo
13560,宣洩,7,,7,3,10,ㄒㄩㄢ ㄒㄧㄝˋ,xuān xiè
13561,懸疑,7,,4,0,4,ㄒㄩㄢˊ ㄧˊ,xuán yí
13562,宣戰,7,,6,4,10,ㄒㄩㄢ ㄓㄢˋ,xuān zhàn
13563,靴,7,,6,1,7,ㄒㄩㄝ,xuē
13564,學分,7,,4,2,6,ㄒㄩㄝˊ ㄈㄣ,xué fēn
13565,削減,7,,5,5,10,ㄒㄩㄝˋ ㄐㄧㄢˇ,xuè jiǎn
13566,學理,7,,4,2,6,ㄒㄩㄝˊ ㄌㄧˇ,xué lǐ
13567,學齡,7,,5,5,10,ㄒㄩㄝˊ ㄌㄧㄥˊ,xué líng
13568,學年,7,,3,2,5,ㄒㄩㄝˊ ㄋㄧㄢˊ,xué nián
13569,學養,7,,2,2,4,ㄒㄩㄝˊ ㄧㄤˇ,xué yǎng
13570,旬,7,,4,2,6,ㄒㄩㄣˊ,xún
13571,薰,7,,4,8,12,ㄒㄩㄣ,xūn
13572,訓斥,7,,4,0,4,ㄒㄩㄣˋ ㄔˋ,xùn chì
13573,尋訪,7,,3,2,5,ㄒㄩㄣˊ ㄈㄤˇ,xún fǎng
13574,馴服,7,,4,2,6,ㄒㄩㄣˊ ㄈㄨˊ,xún fú
13575,訓話,7,,3,1,4,ㄒㄩㄣˋ ㄏㄨㄚˋ,xùn huà
13576,訓誡,7,,3,0,3,ㄒㄩㄣˋ ㄐㄧㄝˋ,xùn jiè
13577,迅雷不及掩耳,7,,2,1,3,ㄒㄩㄣˋ ㄌㄟˊ ㄅㄨˋ ㄐㄧˊ ㄧㄢˇ ㄦˇ,xùn léi bù jí yǎn ěr
13578,訓練有素,7,,4,2,6,ㄒㄩㄣˋ ㄌㄧㄢˋ ㄧㄡˇ ㄙㄨˋ,xùn liàn yǒu sù
13579,遜色,7,,5,2,7,ㄒㄩㄣˋ ㄙㄜˋ,xùn sè
13580,尋思,7,,5,1,6,ㄒㄩㄣˊ ㄙ,xún sī
13581,薰陶,7,,4,5,9,ㄒㄩㄣ ㄊㄠˊ,xūn táo
13582,循序漸進,7,,3,2,5,ㄒㄩㄣˊ ㄒㄩˋ ㄐㄧㄢˋ ㄐㄧㄣˋ,xún xù jiàn jìn
13583,勳章,7,,4,1,5,ㄒㄩㄣ ㄓㄤ,xūn zhāng
13584,芽,7,,4,29,33,ㄧㄚˊ,yá
13585,押,7,,6,2,8,ㄧㄚ,yā
13586,啞巴,7,,3,1,4,ㄧㄚˇ ˙ㄅㄚ,yǎ ba
13587,壓根兒,7,,4,1,5,ㄧㄚ ㄍㄜ ㄦ,yā gēr
13588,啞口無言,7,,3,1,4,ㄧㄚˇ ㄎㄡˇ ㄨˊ ㄧㄢˊ,yǎ kǒu wú yán
13589,壓垮,7,,3,2,5,ㄧㄚ ㄎㄨㄚˇ,yā kuǎ
13590,衙門,7,,28,2,30,ㄧㄚˊ ㄇㄣˊ,yá mén
13591,鴉片,7,,17,2,19,ㄧㄚ ㄆㄧㄢˋ,yā piàn
13592,鴉雀無聲,7,,3,1,4,ㄧㄚ ㄑㄩㄝˋ ㄨˊ ㄕㄥ,yā què wú shēng
13593,壓縮,7,,5,7,12,ㄧㄚ ㄙㄨㄛ,yā suō
13594,壓榨,7,,3,3,6,ㄧㄚ ㄓㄚˋ,yā zhà
13595,壓軸,7,,1,1,2,ㄧㄚ ㄓㄡˊ,yā zhóu
13596,嚥,7,,5,2,7,ㄧㄢˋ,yàn
13597,焉,7,,46,5,51,ㄧㄢ,yān
13598,岩壁,7,,3,3,6,ㄧㄢˊ ㄅㄧˋ,yán bì
13599,掩藏,7,,3,1,4,ㄧㄢˇ ㄘㄤˊ,yǎn cáng
13600,言詞,7,,7,4,11,ㄧㄢˊ ㄘˊ,yán cí
13601,言辭,7,,6,1,7,ㄧㄢˊ ㄘˊ,yán cí
13602,煙囪,7,,6,6,12,ㄧㄢ ㄘㄨㄥ,yān cōng
13603,延宕,7,,4,3,7,ㄧㄢˊ ㄉㄤˋ,yán dàng
13604,嚴寒,7,,4,6,10,ㄧㄢˊ ㄏㄢˊ,yán hán
13605,咽喉,7,,5,2,7,ㄧㄢ ㄏㄡˊ,yān hóu
13606,掩護,7,,7,2,9,ㄧㄢˇ ㄏㄨˋ,yǎn hù
13607,眼花撩亂,7,,4,3,7,ㄧㄢˇ ㄏㄨㄚ ㄌㄧㄠˊ ㄌㄨㄢˋ,yǎn huā liáo luàn
13608,嚴加,7,,4,4,8,ㄧㄢˊ ㄐㄧㄚ,yán jiā
13609,沿街,7,,3,2,5,ㄧㄢˊ ㄐㄧㄝ,yán jiē
13610,演進,7,,7,6,13,ㄧㄢˇ ㄐㄧㄣˋ,yǎn jìn
13611,嚴峻,7,,6,8,14,ㄧㄢˊ ㄐㄩㄣˋ,yán jùn
13612,嚴酷,7,,6,1,7,ㄧㄢˊ ㄎㄨˋ,yán kù
13613,延攬,7,,3,1,4,ㄧㄢˊ ㄌㄢˇ,yán lǎn
13614,豔麗,7,,2,1,3,ㄧㄢˋ ㄌㄧˋ,yàn lì
13615,眼簾,7,,5,3,8,ㄧㄢˇ ㄌㄧㄢˊ,yǎn lián
13616,掩埋,7,,3,16,19,ㄧㄢˇ ㄇㄞˊ,yǎn mái
13617,顏面,7,,6,2,8,ㄧㄢˊ ㄇㄧㄢˋ,yán miàn
13618,宴請,7,,3,1,4,ㄧㄢˋ ㄑㄧㄥˇ,yàn qǐng
13619,眼球,7,,10,2,12,ㄧㄢˇ ㄑㄧㄡˊ,yǎn qiú
13620,儼然,7,,10,8,18,ㄧㄢˇ ㄖㄢˊ,yǎn rán
13621,眼色,7,,5,1,6,ㄧㄢˇ ㄙㄜˋ,yǎn sè
13622,嚴守,7,,3,1,4,ㄧㄢˊ ㄕㄡˇ,yán shǒu
13623,沿襲,7,,3,2,5,ㄧㄢˊ ㄒㄧˊ,yán xí
13624,研習,7,,6,6,12,ㄧㄢˊ ㄒㄧˊ,yán xí
13625,筵席,7,,3,1,4,ㄧㄢˊ ㄒㄧˊ,yán xí
13626,宴席,7,,4,2,6,ㄧㄢˋ ㄒㄧˊ,yàn xí
13627,演習,7,,3,17,20,ㄧㄢˇ ㄒㄧˊ,yǎn xí
13628,煙消雲散,7,,4,1,5,ㄧㄢ ㄒㄧㄠ ㄩㄣˊ ㄙㄢˋ,yān xiāo yún sàn
13629,嚴刑,7,,4,0,4,ㄧㄢˊ ㄒㄧㄥˊ,yán xíng
13630,奄奄一息,7,,4,2,6,ㄧㄢ ㄧㄢ ㄧ ㄒㄧˊ,yān yān yī xí
13631,豔陽,7,,3,3,6,ㄧㄢˋ ㄧㄤˊ,yàn yáng
13632,研議,7,,1,1,2,ㄧㄢˊ ㄧˋ,yán yì
13633,演繹,7,,4,63,67,ㄧㄢˇ ㄧˋ,yǎn yì
13634,演藝,7,,3,3,6,ㄧㄢˇ ㄧˋ,yǎn yì
13635,嚴正,7,,3,3,6,ㄧㄢˊ ㄓㄥˋ,yán zhèng
13636,養病,7,,3,1,4,ㄧㄤˇ ㄅㄧㄥˋ,yǎng bìng
13637,揚長而去,7,,3,0,3,ㄧㄤˊ ㄔㄤˊ ㄦˊ ㄑㄩˋ,yáng cháng ér qù
13638,仰慕,7,,5,2,7,ㄧㄤˇ ㄇㄨˋ,yǎng mù
13639,揚棄,7,,3,1,4,ㄧㄤˊ ㄑㄧˋ,yáng qì
13640,央求,7,,5,0,5,ㄧㄤ ㄑㄧㄡˊ,yāng qiú
13641,仰天,7,,4,0,4,ㄧㄤˇ ㄊㄧㄢ,yǎng tiān
13642,仰頭,7,,4,0,4,ㄧㄤˇㄊㄡˊ,yǎng tóu
13643,揚言,7,,4,7,11,ㄧㄤˊ ㄧㄢˊ,yáng yán
13644,仰仗,7,,3,1,4,ㄧㄤˇ ㄓㄤˋ,yǎng zhàng
13645,佯裝,7,,4,0,4,ㄧㄤˊ ㄓㄨㄤ,yáng zhuāng
13646,養子,7,,8,0,8,ㄧㄤˇ ㄗˇ,yǎng zǐ
13647,舀,7,,6,3,9,ㄧㄠˇ,yǎo
13648,遙不可及,7,,4,2,6,ㄧㄠˊ ㄅㄨˋ ㄎㄜˇ ㄐㄧˊ,yáo bù kě jí
13649,藥廠,7,,5,3,8,ㄧㄠˋ ㄔㄤˇ,yào chǎng
13650,謠傳,7,,4,3,7,ㄧㄠˊ ㄔㄨㄢˊ,yáo chuán
13651,咬定,7,,3,1,4,ㄧㄠˇ ㄉㄧㄥˋ,yǎo dìng
13652,要犯,7,,1,1,2,ㄧㄠˋ ㄈㄢˋ,yào fàn
13653,邀功,7,,1,1,2,ㄧㄠ ㄍㄨㄥ,yāo gōng
13654,要害,7,,6,1,7,ㄧㄠˋ ㄏㄞˋ,yào hài
13655,吆喝,7,,4,2,6,ㄧㄠ ㄏㄜˋ,yāo hè
13656,要件,7,,6,2,8,ㄧㄠˋ ㄐㄧㄢˋ,yào jiàn
13657,要角,7,,3,1,4,ㄧㄠˋ ㄐㄧㄠˇ,yào jiǎo
13658,咬緊牙關,7,,3,1,4,ㄧㄠˇ ㄐㄧㄣˇ ㄧㄚˊ ㄍㄨㄢ,yǎo jǐn yá guān
13659,要訣,7,,4,1,5,ㄧㄠˋ ㄐㄩㄝˊ,yào jué
13660,要塞,7,,4,0,4,ㄧㄠˋ ㄙㄞˋ,yào sài
13661,搖身一變,7,,4,5,9,ㄧㄠˊ ㄕㄣ ㄧ ㄅㄧㄢˋ,yáo shēn yī biàn
13662,要事,7,,3,0,3,ㄧㄠˋ ㄕˋ,yào shì
13663,要脅,7,,2,1,3,ㄧㄠ ㄒㄧㄝˊ,yāo xié
13664,咬牙,7,,4,2,6,ㄧㄠˇ ㄧㄚˊ,yǎo yá
13665,咬牙切齒,7,,6,1,7,ㄧㄠˇ ㄧㄚˊ ㄑㄧㄝˋ ㄔˇ,yǎo yá qiè chǐ
13666,搖搖欲墜,7,,4,1,5,ㄧㄠˊ ㄧㄠˊ ㄩˋ ㄓㄨㄟˋ,yáo yáo yù zhuì
13667,搖曳,7,,5,5,10,ㄧㄠˊ ㄧˋ,yáo yì
13668,夭折,7,,5,3,8,ㄧㄠˇ ㄓㄜˊ,yǎo zhé
13669,夜幕,7,,4,3,7,ㄧㄝˋ ㄇㄨˋ,yè mù
13670,夜深人靜,7,,3,2,5,ㄧㄝˋ ㄕㄣ ㄖㄣˊ ㄐㄧㄥˋ,yè shēn rén jìng
13671,野心勃勃,7,,3,1,4,ㄧㄝˇ ㄒㄧㄣ ㄅㄛˊ ㄅㄛˊ,yě xīn bó bó
13672,業已,7,,3,0,3,ㄧㄝˋ ㄧˇ,yè yǐ
13673,揶揄,7,,3,1,4,ㄧㄝˊ ㄩˊ,yé yú
13674,溢,7,,3,3,6,ㄧˋ,yì
13675,翼,7,,4,3,7,ㄧˋ,yì
13676,矣,7,,83,5,88,ㄧˇ,yǐ
13677,伊,7,,31,16,47,ㄧ,yī
13678,壹,7,,4,2,6,ㄧ,yī
13679,一頭霧水,7,,4,1,5,ㄧˋ ㄊㄡˊ ㄨˋ ㄕㄨㄟˇ,yì  tóu wù shuǐ
13680,一敗塗地,7,,3,0,3,ㄧˊ ㄅㄞˋ ㄊㄨˊ ㄉㄧˋ,yí bài tú dì
13681,一本正經,7,,6,0,6,ㄧˋ ㄅㄣˇ ㄓㄥˋ ㄐㄧㄥ,yì běn zhèng jīng
13682,一臂之力,7,,3,2,5,ㄧˊ ㄅㄧˋ ㄓ ㄌㄧˋ,yí bì zhī lì
13683,儀表,7,,3,2,5,ㄧˊ ㄅㄧㄠˇ,yí biǎo
13684,亦步亦趨,7,,2,1,3,ㄧˋ ㄅㄨˋ ㄧˋ ㄑㄩ,yì bù yì qū
13685,臆測,7,,4,1,5,ㄧˋ ㄘㄜˋ,yì cè
13686,一塵不染,7,,2,1,3,ㄧˋ ㄔㄣˊ ㄅㄨˋ ㄖㄢˇ,yì chén bù rǎn
13687,一成不變,7,,6,1,7,ㄧˋ ㄔㄥˊ ㄅㄨˋ ㄅㄧㄢˋ,yì chéng bú biàn
13688,一籌莫展,7,,3,1,4,ㄧˋ ㄔㄡˊ ㄇㄛˋ ㄓㄢˇ,yì chóu mò zhǎn
13689,依次,7,,4,1,5,ㄧ ㄘˋ,yī cì
13690,依存,7,,3,2,5,ㄧ ㄘㄨㄣˊ,yī cún
13691,一等,7,,3,1,4,ㄧˋ ㄉㄥˇ,yì děng
13692,疑點,7,,4,1,5,ㄧˊ ㄉㄧㄢˇ,yí diǎn
13693,一動也不動,7,,0,0,0,ㄧˊ ㄉㄨㄥˋ ㄧㄝˇ ㄅㄨˊ ㄉㄨㄥˋ,yí dòng yě bú dòng
13694,異端,7,,5,0,5,ㄧˋ ㄉㄨㄢ,yì duān
13695,一發不可收拾,7,,3,4,7,ㄧˋ ㄈㄚ ㄅㄨˋ ㄎㄜˇ ㄕㄡ ㄕˊ,yì fā bù kě shōu shí
13696,以防萬一,7,,2,1,3,ㄧˇ ㄈㄤˊ ㄨㄢˋ ㄧ,yǐ fáng wàn yī
13697,義憤填膺,7,,3,0,3,ㄧˋ ㄈㄣˋ ㄊㄧㄢˊ ㄧㄥ,yì fèn tián yīng
13698,衣冠,7,,3,1,4,ㄧ ㄍㄨㄢ,yī guān
13699,抑或,7,,8,1,9,ㄧˋ ㄏㄨㄛˋ,yì huò
13700,遺跡,7,,6,15,21,ㄧˊ ㄐㄧ,yí jī
13701,異己,7,,4,1,5,ㄧˋ ㄐㄧˇ,yì jǐ
13702,一技之長,7,,3,8,11,ㄧˊ ㄐㄧˋ ㄓ ㄔㄤˊ,yí jì zhī cháng
13703,一見鍾情,7,,3,2,5,ㄧˊ ㄐㄧㄢˋ ㄓㄨㄥ ㄑㄧㄥˊ,yí jiàn zhōng qíng
13704,衣襟,7,,3,0,3,ㄧ ㄐㄧㄣ,yī jīn
13705,意境,7,,4,7,11,ㄧˋ ㄐㄧㄥˋ,yì jìng
13706,易經,7,,5,6,11,ㄧˋ ㄐㄧㄥ,yì jīng
13707,疑懼,7,,2,0,2,ㄧˊ ㄐㄩˋ,yí jù
13708,一蹶不振,7,,3,3,6,ㄧˋ ㄐㄩㄝˊ ㄅㄨˊ ㄓㄣˋ,yì jué bú zhèn
13709,倚靠,7,,4,1,5,ㄧˇ ㄎㄠˋ,yǐ kào
13710,倚賴,7,,4,3,7,ㄧˇ ㄌㄞˋ,yǐ lài
13711,屹立,7,,3,4,7,ㄧˋ ㄌㄧˋ,yì lì
13712,依戀,7,,3,2,5,ㄧ ㄌㄧㄢˋ,yī liàn
13713,遺留,7,,4,3,7,ㄧˊ ㄌㄧㄡˊ,yí liú
13714,一溜煙,7,,3,1,4,ㄧˊ ㄌㄧㄡˋ ㄧㄢ,yí liù yān
13715,議論紛紛,7,,4,2,6,ㄧˋ ㄌㄨㄣˋ ㄈㄣ ㄈㄣ,yì lùn fēn fēn
13716,一落千丈,7,,2,0,2,ㄧˊ ㄌㄨㄛˋ ㄑㄧㄢ ㄓㄤˋ,yí luò qiān zhàng
13717,一鳴驚人,7,,2,1,3,ㄧˋ ㄇㄧㄥˊ ㄐㄧㄥ ㄖㄣˊ,yì míng jīng rén
13718,一目了然,7,,3,1,4,ㄧˊ ㄇㄨˋ ㄌㄧㄠˇ ㄖㄢˊ,yí mù liǎo rán
13719,一拍即合,7,,2,1,3,ㄧˋ ㄆㄞ ㄐㄧˊ ㄏㄜˊ,yì pāi jí hé
13720,一屁股,7,,3,0,3,ㄧˊ ㄆㄧˋ ㄍㄨˇ,yí pì gǔ
13721,藝品,7,,2,5,7,ㄧˋ ㄆㄧㄣˇ,yì pǐn
13722,夷平,7,,1,1,2,ㄧˊ ㄆㄧㄥˊ,yí píng
13723,意氣,7,,3,1,4,ㄧˋ ㄑㄧˋ,yì qì
13724,義氣,7,,4,2,6,ㄧˋ ㄑㄧˋ,yì qì
13725,以期,7,,5,0,5,ㄧˇ ㄑㄧˊ,yǐ qí
13726,意氣風發,7,,2,1,3,ㄧˋ ㄑㄧˋ ㄈㄥ ㄈㄚ,yì qì fēng fā
13727,一氣呵成,7,,3,2,5,ㄧˊ ㄑㄧˋ ㄏㄜ ㄔㄥˊ,yí qì hē chéng
13728,一竅不通,7,,2,1,3,ㄧˊ ㄑㄧㄠˋ ㄅㄨˋ ㄊㄨㄥ,yí qiào bù tōng
13729,異曲同工,7,,4,2,6,ㄧˋ ㄑㄩˇ ㄊㄨㄥˊ ㄍㄨㄥ,yì qǔ tóng gōng
13730,毅然,7,,9,7,16,ㄧˋ ㄖㄢˊ,yì rán
13731,已然,7,,11,2,13,ㄧˇ ㄖㄢˊ,yǐ rán
13732,宜人,7,,3,4,7,ㄧˊ ㄖㄣˊ,yí rén
13733,翌日,7,,5,0,5,ㄧˋ ㄖˋ,yì rì
13734,儀容,7,,3,3,6,ㄧˊ ㄖㄨㄥˊ,yí róng
13735,易如反掌,7,,3,1,4,ㄧˋ ㄖㄨˊ ㄈㄢˇ ㄓㄤˇ,yì rú fǎn zhǎng
13736,一掃而空,7,,3,0,3,ㄧˋ ㄙㄠˇ ㄦˊ ㄎㄨㄥ,yì sǎo ér kōng
13737,疑神疑鬼,7,,2,1,3,ㄧˊ ㄕㄣˊ ㄧˊ ㄍㄨㄟˇ,yí shén yí guǐ
13738,一聲令下,7,,2,2,4,ㄧˋ ㄕㄥ ㄌㄧㄥˋ ㄒㄧㄚˋ,yì shēng lìng xià
13739,議事,7,,4,1,5,ㄧˋ ㄕˋ,yì shì
13740,軼事,7,,3,0,3,ㄧˋ ㄕˋ,yì shì
13741,一視同仁,7,,4,3,7,ㄧˊ ㄕˋ ㄊㄨㄥˊ ㄖㄣˊ,yí shì tóng rén
13742,遺孀,7,,3,1,4,ㄧˊ ㄕㄨㄤ,yí shuāng
13743,疑似,7,,3,7,10,ㄧˊ ㄙˋ,yí sì
13744,一絲不苟,7,,4,1,5,ㄧˋ ㄙ ㄅㄨˋ ㄍㄡˇ,yì sī bù gǒu
13745,伊斯蘭教,7,,4,24,28,ㄧ ㄙ ㄌㄢˊ ㄐㄧㄠˋ,yī sī lán jiào
13746,儀態,7,,3,1,4,ㄧˊ ㄊㄞˋ,yí tài
13747,異同,7,,3,0,3,ㄧˋ ㄊㄨㄥˊ,yì tóng
13748,一統,7,,5,0,5,ㄧˋ ㄊㄨㄥˇ,yì tǒng
13749,一團糟,7,,3,0,3,ㄧˋ ㄊㄨㄢˊ ㄗㄠ,yì tuán zāo
13750,一網打盡,7,,2,1,3,ㄧˋ ㄨㄤˇ ㄉㄚˇ ㄐㄧㄣˋ,yì wǎng dǎ jìn
13751,一望無際,7,,3,4,7,ㄧˊ ㄨㄤˋ ㄨˊ ㄐㄧˋ,yí wàng wú jì
13752,意謂,7,,9,2,11,ㄧˋ ㄨㄟˋ,yì wèi
13753,依偎,7,,4,2,6,ㄧ ㄨㄟ,yī wēi
13754,藝文,7,,5,4,9,ㄧˋ ㄨㄣˊ,yì wén
13755,一文不值,7,,2,0,2,ㄧˋ ㄨㄣˊ ㄅㄨˋ ㄓˊ,yì wén bù zhí
13756,一窩蜂,7,,4,1,5,ㄧˋ ㄨㄛ ㄈㄥ,yì wō fēng
13757,義無反顧,7,,3,3,6,ㄧˋ ㄨˊ ㄈㄢˇ ㄍㄨˋ,yì wú fǎn gù
13758,一無是處,7,,4,1,5,ㄧˋ ㄨˊ ㄕˋ ㄔㄨˋ,yì wú shì chù
13759,一無所獲,7,,3,0,3,ㄧˋ ㄨˊ ㄙㄨㄛˇ ㄏㄨㄛˋ,yì wú suǒ huò
13760,依稀,7,,6,3,9,ㄧ ㄒㄧ,yī xī
13761,一席之地,7,,5,1,6,ㄧˋ ㄒㄧˊ ㄓ ㄉㄧˋ,yì xí zhī dì
13762,異鄉,7,,4,8,12,ㄧˋ ㄒㄧㄤ,yì xiāng
13763,一廂情願,7,,5,1,6,ㄧˋ ㄒㄧㄤ ㄑㄧㄥˊ ㄩㄢˋ,yì xiāng qíng yuàn
13764,異想天開,7,,4,1,5,ㄧˋ ㄒㄧㄤˇ ㄊㄧㄢ ㄎㄞ,yì xiǎng tiān kāi
13765,遺言,7,,4,1,5,ㄧˊ ㄧㄢˊ,yí yán
13766,一言一行,7,,2,1,3,ㄧˋ ㄧㄢˊ ㄧˋ ㄒㄧㄥˊ,yì yán yì xíng
13767,異樣,7,,6,4,10,ㄧˋ ㄧㄤˋ,yì yàng
13768,依樣,7,,3,1,4,ㄧ ㄧㄤˋ,yī yàng
13769,抑揚頓挫,7,,2,1,3,ㄧˋ ㄧㄤˊ ㄉㄨㄣˋ ㄘㄨㄛˋ,yì yáng dùn cuò
13770,依依不捨,7,,3,3,6,ㄧ ㄧ ㄅㄨˋ ㄕㄜˇ,yī yī bù shě
13771,一意孤行,7,,3,2,5,ㄧˊ ㄧˋ ㄍㄨ ㄒㄧㄥˊ,yí yì gū xíng
13772,一飲而盡,7,,3,0,3,ㄧˋ ㄧㄣˇ ㄦˊ ㄐㄧㄣˋ,yì yǐn ér jìn
13773,一擁而上,7,,2,1,3,ㄧˋ ㄩㄥˇ ㄦˊ ㄕㄤˋ,yì yǒng ér shàng
13774,一隅,7,,4,1,5,ㄧˋ ㄩˊ,yì yú
13775,抑鬱,7,,6,1,7,ㄧˋ ㄩˋ,yì yù
13776,一眨眼,7,,3,1,4,ㄧˋ ㄓㄚˇ ㄧㄢˇ,yì zhǎ yǎn
13777,一朝,7,,3,2,5,ㄧˋ ㄓㄠ,yì zhāo
13778,一針見血,7,,4,1,5,ㄧˋ ㄓㄣ ㄐㄧㄢˋ ㄒㄧㄝˇ,yì zhēn jiàn xiě
13779,遺址,7,,6,31,37,ㄧˊ ㄓˇ,yí zhǐ
13780,意旨,7,,3,1,4,ㄧˋ ㄓˇ,yì zhǐ
13781,一知半解,7,,2,1,3,ㄧˋ ㄓ ㄅㄢˋ ㄐㄧㄝˇ,yì zhī bàn jiě
13782,倚重,7,,4,1,5,ㄧˇ ㄓㄨㄥˋ,yǐ zhòng
13783,遺囑,7,,18,1,19,ㄧˊ ㄓㄨˇ,yí zhǔ
13784,異狀,7,,3,2,5,ㄧˋ ㄓㄨㄤˋ,yì zhuàng
13785,一走了之,7,,2,0,2,ㄧˋ ㄗㄡˇ ㄌㄧㄠˇ ㄓ,yì zǒu liǎo zhī
13786,淫,7,,4,4,8,ㄧㄣˊ,yín
13787,隱蔽,7,,4,1,5,ㄧㄣˇ ㄅㄧˋ,yǐn bì
13788,吟唱,7,,5,4,9,ㄧㄣˊ ㄔㄤˋ,yín chàng
13789,陰沉,7,,5,1,6,ㄧㄣ ㄔㄣˊ,yīn chén
13790,銀河,7,,5,2,7,ㄧㄣˊ ㄏㄜˊ,yín hé
13791,隱晦,7,,3,0,3,ㄧㄣˇ ㄏㄨㄟˋ,yǐn huì
13792,印記,7,,5,14,19,ㄧㄣˋ ㄐㄧˋ,yìn jì
13793,陰間,7,,3,1,4,ㄧㄣ ㄐㄧㄢ,yīn jiān
13794,引介,7,,3,2,5,ㄧㄣˇ ㄐㄧㄝˋ,yǐn jiè
13795,銀兩,7,,3,0,3,ㄧㄣˊ ㄌㄧㄤˇ,yín liǎng
13796,陰霾,7,,4,9,13,ㄧㄣ ㄇㄞˊ,yīn mái
13797,隱密,7,,6,2,8,ㄧㄣˇ ㄇㄧˋ,yǐn mì
13798,殷切,7,,3,2,5,ㄧㄣ ㄑㄧㄝˋ,yīn qiè
13799,殷勤,7,,6,0,6,ㄧㄣ ㄑㄧㄣˊ,yīn qín
13800,隱忍,7,,4,0,4,ㄧㄣˇ ㄖㄣˇ,yǐn rěn
13801,引人入勝,7,,5,2,7,ㄧㄣˇ ㄖㄣˊ ㄖㄨˋ ㄕㄥˋ,yǐn rén rù shèng
13802,陰森,7,,3,1,4,ㄧㄣ ㄙㄣ,yīn sēn
13803,隱身,7,,4,4,8,ㄧㄣˇ ㄕㄣ,yǐn shēn
13804,吟詩,7,,4,1,5,ㄧㄣˊ ㄕ,yín shī
13805,隱士,7,,6,1,7,ㄧㄣˇ ㄕˋ,yǐn shì
13806,陰險,7,,5,0,5,ㄧㄣ ㄒㄧㄢˇ,yīn xiǎn
13807,印行,7,,3,1,4,ㄧㄣˋ ㄒㄧㄥˊ,yìn xíng
13808,陰性,7,,3,1,4,ㄧㄣ ㄒㄧㄥˋ,yīn xìng
13809,音訊,7,,3,2,5,ㄧㄣ ㄒㄩㄣˋ,yīn xùn
13810,音譯,7,,3,1,4,ㄧㄣ ㄧˋ,yīn yì
13811,引以為傲,7,,3,3,6,ㄧㄣˇ ㄧˇ ㄨㄟˊ ㄠˋ,yǐn yǐ wéi ào
13812,隱憂,7,,3,10,13,ㄧㄣˇ ㄧㄡ,yǐn yōu
13813,隱喻,7,,11,1,12,ㄧㄣˇ ㄩˋ,yǐn yù
13814,陰鬱,7,,5,0,5,ㄧㄣ ㄩˋ,yīn yù
13815,姻緣,7,,4,2,6,ㄧㄣ ㄩㄢˊ,yīn yuán
13816,印製,7,,3,1,4,ㄧㄣˋ ㄓˋ,yìn zhì
13817,硬梆梆,7,,2,4,6,ㄧㄥˋ ㄅㄤ ㄅㄤ,yìng bāng bāng
13818,櫻花,7,,6,8,14,ㄧㄥ ㄏㄨㄚ,yīng huā
13819,應急,7,,2,2,4,ㄧㄥˋ ㄐㄧˊ,yìng jí
13820,營救,7,,4,1,5,ㄧㄥˊ ㄐㄧㄡˋ,yíng jiù
13821,硬朗,7,,2,2,4,ㄧㄥˋ ㄌㄤˇ,yìng lǎng
13822,英明,7,,6,1,7,ㄧㄥ ㄇㄧㄥˊ,yīng míng
13823,迎娶,7,,4,3,7,ㄧㄥˊ ㄑㄩˇ,yíng qǔ
13824,縈繞,7,,4,1,5,ㄧㄥˊ ㄖㄠˋ,yíng rào
13825,迎刃而解,7,,3,2,5,ㄧㄥˊ ㄖㄣˋ ㄦˊ ㄐㄧㄝˇ,yíng rèn ér jiě
13826,影射,7,,3,0,3,ㄧㄥˇ ㄕㄜˋ,yǐng shè
13827,營生,7,,3,2,5,ㄧㄥˊ ㄕㄥ,yíng shēng
13828,應聲,7,,6,3,9,ㄧㄥˋ ㄕㄥ,yìng shēng
13829,硬生生,7,,3,2,5,ㄧㄥˋ ㄕㄥ ㄕㄥ,yìng shēng shēng
13830,鸚鵡,7,,16,8,24,ㄧㄥ ㄨˇ,yīng wǔ
13831,迎向,7,,4,4,8,ㄧㄥˊ ㄒㄧㄤˋ,yíng xiàng
13832,應驗,7,,3,1,4,ㄧㄥˋ ㄧㄢˋ,yìng yàn
13833,應邀,7,,5,2,7,ㄧㄥˋ ㄧㄠ,yìng yāo
13834,影藝,7,,6,0,6,ㄧㄥˇ ㄧˋ,yǐng yì
13835,應允,7,,5,0,5,ㄧㄥˋ ㄩㄣˇ,yìng yǔn
13836,應運而生,7,,3,2,5,ㄧㄥˋ ㄩㄣˋ ㄦˊ ㄕㄥ,yìng yùn ér shēng
13837,迎戰,7,,7,2,9,ㄧㄥˊ ㄓㄢˋ,yíng zhàn
13838,應戰,7,,4,0,4,ㄧㄥˋ ㄓㄢˋ,yìng zhàn
13839,硬仗,7,,3,1,4,ㄧㄥˋ ㄓㄤˋ,yìng zhàng
13840,硬著頭皮,7,,4,4,8,ㄧㄥˋ ˙ㄓㄜ ㄊㄡˊ ㄆㄧˊ,yìng zhe tóu pí
13841,擁戴,7,,6,1,7,ㄩㄥˇ ㄉㄞˋ,yǒng dài
13842,慵懶,7,,3,1,4,ㄩㄥ ㄌㄢˇ,yōng lǎn
13843,擁立,7,,4,0,4,ㄩㄥˇ ㄌㄧˋ,yǒng lì
13844,勇猛,7,,6,4,10,ㄩㄥˇ ㄇㄥˇ,yǒng měng
13845,雍容,7,,3,1,4,ㄩㄥ ㄖㄨㄥˊ,yōng róng
13846,庸俗,7,,3,0,3,ㄩㄥ ㄙㄨˊ,yōng sú
13847,勇往直前,7,,4,3,7,ㄩㄥˇ ㄨㄤˇ ㄓˊ ㄑㄧㄢˊ,yǒng wǎng zhí qián
13848,用武之地,7,,3,1,4,ㄩㄥˋ ㄨˇ ㄓ ㄉㄧˋ,yòng wǔ zhī dì
13849,湧現,7,,7,3,10,ㄩㄥˇ ㄒㄧㄢˋ,yǒng xiàn
13850,踴躍,7,,3,6,9,ㄩㄥˇ ㄩㄝˋ,yǒng yuè
13851,友愛,7,,5,2,7,ㄧㄡˇ ㄞˋ,yǒu ài
13852,有礙,7,,3,1,4,ㄧㄡˇ ㄞˋ,yǒu ài
13853,幽暗,7,,5,1,6,ㄧㄡ ㄢˋ,yōu àn
13854,右臂,7,,3,0,3,ㄧㄡˋ ㄅㄧˋ,yòu bì
13855,遊蕩,7,,6,4,10,ㄧㄡˊ ㄉㄤˋ,yóu dàng
13856,有道,7,,4,2,6,ㄧㄡˇ ㄉㄠˋ,yǒu dào
13857,油燈,7,,5,1,6,ㄧㄡˊ ㄉㄥ,yóu dēng
13858,誘發,7,,5,5,10,ㄧㄡˋ ㄈㄚ,yòu fā
13859,攸關,7,,7,6,13,ㄧㄡ ㄍㄨㄢ,yōu guān
13860,優厚,7,,3,0,3,ㄧㄡ ㄏㄡˋ,yōu hòu
13861,油畫,7,,4,2,6,ㄧㄡˊ ㄏㄨㄚˋ,yóu huà
13862,游擊,7,,4,1,5,ㄧㄡˊ ㄐㄧˊ,yóu jí
13863,有鑑於此,7,,2,0,2,ㄧㄡˇ ㄐㄧㄢˋ ㄩˊ ㄘˇ,yǒu jiàn yú cǐ
13864,有勁,7,,3,1,4,ㄧㄡˇ ㄐㄧㄥˋ,yǒu jìng
13865,幽靜,7,,3,1,4,ㄧㄡ ㄐㄧㄥˋ,yōu jìng
13866,遊歷,7,,4,3,7,ㄧㄡˊ ㄌㄧˋ,yóu lì
13867,有利可圖,7,,2,1,3,ㄧㄡˇ ㄌㄧˋ ㄎㄜˇ ㄊㄨˊ,yǒu lì kě tú
13868,遊民,7,,4,34,38,ㄧㄡˊ ㄇㄧㄣˊ,yóu mín
13869,有氣無力,7,,3,1,4,ㄧㄡˇ ㄑㄧˋ ㄨˊ ㄌㄧˋ,yǒu qì wú lì
13870,悠然,7,,3,2,5,ㄧㄡ ㄖㄢˊ,yōu rán
13871,油然而生,7,,4,1,5,ㄧㄡˊ ㄖㄢˊ ㄦˊ ㄕㄥ,yóu rán ér shēng
13872,優柔寡斷,7,,3,0,3,ㄧㄡ ㄖㄡˊ ㄍㄨㄚˇ ㄉㄨㄢˋ,yōu róu guǎ duàn
13873,遊山玩水,7,,2,2,4,ㄧㄡˊ ㄕㄢ ㄨㄢˊ ㄕㄨㄟˇ,yóu shān wán shuǐ
13874,有聲有色,7,,2,0,2,ㄧㄡˇ ㄕㄥ ㄧㄡˇ ㄙㄜˋ,yǒu shēng yǒu sè
13875,有生之年,7,,4,3,7,ㄧㄡˇ ㄕㄥ ㄓ ㄋㄧㄢˊ,yǒu shēng zhī nián
13876,有失,7,,4,1,5,ㄧㄡˇ ㄕ,yǒu shī
13877,有說有笑,7,,2,1,3,ㄧㄡˇ ㄕㄨㄛ ㄧㄡˇ ㄒㄧㄠˋ,yǒu shuō yǒu xiào
13878,有條不紊,7,,4,1,5,ㄧㄡˇ ㄊㄧㄠˊ ㄅㄨˊ ㄨㄣˋ,yǒu tiáo bú wèn
13879,遊艇,7,,5,2,7,ㄧㄡˊ ㄊㄧㄥˇ,yóu tǐng
13880,優渥,7,,4,5,9,ㄧㄡ ㄨㄛˋ,yōu wò
13881,憂心忡忡,7,,6,3,9,ㄧㄡ ㄒㄧㄣ ㄔㄨㄥ ㄔㄨㄥ,yōu xīn chōng chōng
13882,有心人,7,,3,4,7,ㄧㄡˇ ㄒㄧㄣ ㄖㄣˊ,yǒu xīn rén
13883,悠揚,7,,4,4,8,ㄧㄡ ㄧㄤˊ,yōu yáng
13884,有樣學樣,7,,2,0,2,ㄧㄡˇ ㄧㄤˋ ㄒㄩㄝˊ ㄧㄤˋ,yǒu yàng xué yàng
13885,游移,7,,3,1,4,ㄧㄡˊ ㄧˊ,yóu yí
13886,猶疑,7,,6,1,7,ㄧㄡˊ ㄧˊ,yóu yí
13887,有意無意,7,,2,0,2,ㄧㄡˇ ㄧˋ ㄨˊ ㄧˋ,yǒu yì wú yì
13888,誘因,7,,6,4,10,ㄧㄡˋ ㄧㄣ,yòu yīn
13889,悠遊,7,,2,5,7,ㄧㄡ ㄧㄡˊ,yōu yóu
13890,悠悠,7,,7,2,9,ㄧㄡ ㄧㄡ,yōu yōu
13891,悠哉,7,,2,1,3,ㄧㄡ ㄗㄞ,yōu zāi
13892,有朝一日,7,,6,3,9,ㄧㄡˇ ㄓㄠ ㄧˊ ㄖˋ,yǒu zhāo yí rì
13893,油脂,7,,5,24,29,ㄧㄡˊ ㄓ,yóu zhī
13894,由衷,7,,7,2,9,ㄧㄡˊ ㄓㄨㄥ,yóu zhōng
13895,遊走,7,,6,2,8,ㄧㄡˊ ㄗㄡˇ,yóu zǒu
13896,誘使,7,,3,0,3,ㄧㄡˋㄕˇ,yòushǐ
13897,余,7,,6,7,13,ㄩˊ,yú
13898,愚笨,7,,3,1,4,ㄩˊ ㄅㄣˋ,yú bèn
13899,漁船,7,,7,7,14,ㄩˊ ㄔㄨㄢˊ,yú chuán
13900,愈發,7,,3,0,3,ㄩˋ ㄈㄚ,yù fā
13901,語法,7,,3,4,7,ㄩˇ ㄈㄚˇ,yǔ fǎ
13902,魚貫,7,,2,1,3,ㄩˊ ㄍㄨㄢˋ,yú guàn
13903,餘光,7,,3,0,3,ㄩˊ ㄍㄨㄤ,yú guāng
13904,雨後春筍,7,,3,2,5,ㄩˇ ㄏㄡˋ ㄔㄨㄣ ㄙㄨㄣˇ,yǔ hòu chūn sǔn
13905,語彙,7,,5,2,7,ㄩˇ ㄏㄨㄟˋ,yǔ huì
13906,迂迴,7,,7,2,9,ㄩ ㄏㄨㄟˊ,yū huí
13907,語句,7,,4,0,4,ㄩˇ ㄐㄩˋ,yǔ jù
13908,預留,7,,3,2,5,ㄩˋ ㄌㄧㄡˊ,yù liú
13909,鬱悶,7,,6,2,8,ㄩˋ ㄇㄣˋ,yù mèn
13910,遇難,7,,3,2,5,ㄩˋ ㄋㄢˋ,yù nàn
13911,與日俱增,7,,3,2,5,ㄩˇ ㄖˋ ㄐㄩˋ ㄗㄥ,yǔ rì jù zēng
13912,餘生,7,,3,0,3,ㄩˊ ㄕㄥ,yú shēng
13913,預示,7,,5,1,6,ㄩˋ ㄕˋ,yù shì
13914,御史,7,,15,1,16,ㄩˋ ㄕˇ,yù shǐ
13915,與世隔絕,7,,3,2,5,ㄩˇ ㄕˋ ㄍㄜˊ ㄐㄩㄝˊ,yǔ shì gé jué
13916,與時俱進,7,,2,1,3,ㄩˇ ㄕˊ ㄐㄩˋ ㄐㄧㄣˋ,yǔ shí jù jìn
13917,於事無補,7,,2,1,3,ㄩˊ ㄕˋ ㄨˊ ㄅㄨˇ,yú shì wú bǔ
13918,寓所,7,,4,1,5,ㄩˋ ㄙㄨㄛˇ,yù suǒ
13919,語無倫次,7,,2,1,3,ㄩˇ ㄨˊ ㄌㄨㄣˊ ㄘˋ,yǔ wú lún cì
13920,預想,7,,2,1,3,ㄩˋ ㄒㄧㄤˇ,yù xiǎng
13921,寓意,7,,4,2,6,ㄩˋ ㄧˋ,yù yì
13922,羽翼,7,,4,1,5,ㄩˇ ㄧˋ,yǔ yì
13923,御用,7,,4,1,5,ㄩˋ ㄩㄥˋ,yù yòng
13924,鬱鬱,7,,5,2,7,ㄩˋ ㄩˋ,yù yù
13925,逾越,7,,3,2,5,ㄩˊ ㄩㄝˋ,yú yuè
13926,預兆,7,,4,1,5,ㄩˋ ㄓㄠˋ,yù zhào
13927,諭旨,7,,11,1,12,ㄩˋ ㄓˇ,yù zhǐ
13928,語重心長,7,,2,3,5,ㄩˇ ㄓㄨㄥˋ ㄒㄧㄣ ㄔㄤˊ,yǔ zhòng xīn cháng
13929,遠播,7,,3,1,4,ㄩㄢˇ ㄅㄛˋ,yuǎn bò
13930,淵博,7,,4,0,4,ㄩㄢ ㄅㄛˊ,yuān bó
13931,元朝,7,,6,5,11,ㄩㄢˊ ㄔㄠˊ,yuán cháo
13932,園地,7,,3,3,6,ㄩㄢˊ ㄉㄧˋ,yuán dì
13933,原動力,7,,4,2,6,ㄩㄢˊ ㄉㄨㄥˋ ㄌㄧˋ,yuán dòng lì
13934,怨懟,7,,3,1,4,ㄩㄢˋ ㄉㄨㄟˋ,yuàn duì
13935,原封不動,7,,2,1,3,ㄩㄢˊ ㄈㄥ ㄅㄨˊ ㄉㄨㄥˋ,yuán fēng bú dòng
13936,原稿,7,,5,0,5,ㄩㄢˊ ㄍㄠˇ,yuán gǎo
13937,冤家,7,,3,0,3,ㄩㄢ ㄐㄧㄚ,yuān jiā
13938,元老,7,,5,1,6,ㄩㄢˊ ㄌㄠˇ,yuán lǎo
13939,源流,7,,4,1,5,ㄩㄢˊ ㄌㄧㄡˊ,yuán liú
13940,原貌,7,,4,5,9,ㄩㄢˊ ㄇㄠˋ,yuán mào
13941,怨氣,7,,4,2,6,ㄩㄢˋ ㄑㄧˋ,yuàn qì
13942,冤屈,7,,3,0,3,ㄩㄢ ㄑㄩ,yuān qū
13943,圓融,7,,5,4,9,ㄩㄢˊ ㄖㄨㄥˊ,yuán róng
13944,圓潤,7,,3,1,4,ㄩㄢˊ ㄖㄨㄣˋ,yuán rùn
13945,原生,7,,5,24,29,ㄩㄢˊ ㄕㄥ,yuán shēng
13946,元帥,7,,12,1,13,ㄩㄢˊ ㄕㄨㄞˋ,yuán shuài
13947,怨天尤人,7,,3,3,6,ㄩㄢˋ ㄊㄧㄢ ㄧㄡˊ ㄖㄣˊ,yuàn tiān yóu rén
13948,遠眺,7,,3,1,4,ㄩㄢˇ ㄊㄧㄠˋ,yuǎn tiào
13949,原委,7,,5,1,6,ㄩㄢˊ ㄨㄟˇ,yuán wěi
13950,原形,7,,4,1,5,ㄩㄢˊ ㄒㄧㄥˊ,yuán xíng
13951,遠行,7,,3,2,5,ㄩㄢˇ ㄒㄧㄥˊ,yuǎn xíng
13952,鴛鴦,7,,7,1,8,ㄩㄢ ㄧㄤ,yuān yāng
13953,原野,7,,6,3,9,ㄩㄢˊ ㄧㄝˇ,yuán yě
13954,園藝,7,,5,22,27,ㄩㄢˊ ㄧˋ,yuán yì
13955,援引,7,,3,1,4,ㄩㄢˊ ㄧㄣˇ,yuán yǐn
13956,源源,7,,3,2,5,ㄩㄢˊ ㄩㄢˊ,yuán yuán
13957,淵源,7,,6,4,10,ㄩㄢ ㄩㄢˊ,yuān yuán
13958,遠征,7,,6,2,8,ㄩㄢˇ ㄓㄥ,yuǎn zhēng
13959,原子筆,7,,3,3,6,ㄩㄢˊ ㄗˇ ㄅㄧˇ,yuán zǐ bǐ
13960,遠走高飛,7,,2,0,2,ㄩㄢˇ ㄗㄡˇ ㄍㄠ ㄈㄟ,yuǎn zǒu gāo fēi
13961,曰,7,,185,11,196,ㄩㄝ,yuē
13962,閱歷,7,,3,1,4,ㄩㄝˋ ㄌㄧˋ,yuè lì
13963,約略,7,,4,3,7,ㄩㄝ ㄌㄩㄝˋ,yuē lüè
13964,約莫,7,,8,2,10,ㄩㄝ ˙ㄇㄛ,yuē mo
13965,月色,7,,3,0,3,ㄩㄝˋ ㄙㄜˋ,yuè sè
13966,樂章,7,,4,3,7,ㄩㄝˋ ㄓㄤ,yuè zhāng
13967,暈2,7,,5,5,10,ㄩㄣˋ,yùn
13968,蘊藏,7,,5,6,11,ㄩㄣˋ ㄘㄤˊ,yùn cáng
13969,勻稱,7,,2,1,3,ㄩㄣˊ ㄔㄥˋ ,yún chèng
13970,蘊含,7,,6,9,15,ㄩㄣˋ ㄏㄢˊ,yùn hán
13971,雲集,7,,3,2,5,ㄩㄣˊ ㄐㄧˊ,yún jí
13972,允諾,7,,4,2,6,ㄩㄣˇ ㄋㄨㄛˋ,yǔn nuò
13973,運算,7,,7,3,10,ㄩㄣˋ ㄙㄨㄢˋ,yùn suàn
13974,暈頭轉向,7,,2,0,2,ㄩㄣ ㄊㄡˊ ㄓㄨㄢˋ ㄒㄧㄤˋ,yūn tóu zhuàn xiàng
13975,雲霄,7,,3,1,4,ㄩㄣˊ ㄒㄧㄠ,yún xiāo
13976,暈眩,7,,6,1,7,ㄩㄣ ㄒㄩㄢˋ,yūn xuàn
13977,雜糧,7,,1,5,6,ㄗㄚˊ ㄌㄧㄤˊ,zá liáng
13978,雜亂無章,7,,3,0,3,ㄗㄚˊ ㄌㄨㄢˋ ㄨˊ ㄓㄤ,zá luàn wú zhāng
13979,哉,7,,33,2,35,ㄗㄞ,zāi
13980,宰割,7,,3,0,3,ㄗㄞˇ ㄍㄜ,zǎi gē
13981,在行,7,,3,0,3,ㄗㄞˋ ㄏㄤˊ,zài háng
13982,災情,7,,3,43,46,ㄗㄞ ㄑㄧㄥˊ,zāi qíng
13983,在所難免,7,,2,2,4,ㄗㄞˋ ㄙㄨㄛˇ ㄋㄢˊ ㄇㄧㄢˇ,zài suǒ nán miǎn
13984,宰相,7,,31,1,32,ㄗㄞˇ ㄒㄧㄤˋ,zǎi xiàng
13985,在職,7,,4,2,6,ㄗㄞˋ ㄓˊ,zài zhí
13986,栽種,7,,6,53,59,ㄗㄞ ㄓㄨㄥˋ,zāi zhòng
13987,讚不絕口,7,,3,2,5,ㄗㄢˋ ㄅㄨˋ ㄐㄩㄝˊ ㄎㄡˇ,zàn bù jué kǒu
13988,讚頌,7,,3,1,4,ㄗㄢˋ ㄙㄨㄥˋ,zàn sòng
13989,讚譽,7,,4,1,5,ㄗㄢˋ ㄩˋ,zàn yù
13990,葬身,7,,3,2,5,ㄗㄤˋ ㄕㄣ,zàng shēn
13991,灶,7,,9,8,17,ㄗㄠˋ,zào
13992,棗,7,,7,7,14,ㄗㄠˇ,zǎo
13993,遭,7,,67,21,88,ㄗㄠ,zāo
13994,鑿,7,,9,6,15,ㄗㄠˊ ,záo 
13995,躁動,7,,4,2,6,ㄗㄠˋ ㄉㄨㄥˋ,zào dòng
13996,遭逢,7,,5,8,13,ㄗㄠ ㄈㄥˊ,zāo féng
13997,造福,7,,6,7,13,ㄗㄠˋ ㄈㄨˊ,zào fú
13998,造化,7,,2,1,3,ㄗㄠˋ ㄏㄨㄚˋ ,zào huà 
13999,遭殃,7,,4,4,8,ㄗㄠ ㄧㄤ,zāo yāng
14000,造謠,7,,2,1,3,ㄗㄠˋ ㄧㄠˊ,zào yáo
14001,造詣,7,,4,1,5,ㄗㄠˋ ㄧˋ,zào yì
14002,造作,7,,4,1,5,ㄗㄠˋ ㄗㄨㄛˋ,zào zuò
14003,造影,7,,9,0,9,ㄗㄠˋㄧㄥˇ,zàoyǐng
14004,責難,7,,4,1,5,ㄗㄜˊ ㄋㄢˋ,zé nàn
14005,咋舌,7,,2,0,2,ㄗㄜˊ ㄕㄜˊ,zé shé
14006,責問,7,,3,0,3,ㄗㄜˊ ㄨㄣˋ,zé wèn
14007,責無旁貸,7,,2,2,4,ㄗㄜˊ ㄨˊ ㄆㄤˊ ㄉㄞˋ,zé wú páng dài
14008,嘖嘖稱奇,7,,3,2,5,ㄗㄜˊ ㄗㄜˊ ㄔㄥ ㄑㄧˊ,zé zé chēng qí
14009,憎惡,7,,5,0,5,ㄗㄥ ㄨˋ,zēng wù
14010,贈與,7,,2,1,3,ㄗㄥˋ ㄩˇ,zèng yǔ
14011,增援,7,,4,1,5,ㄗㄥ ㄩㄢˊ,zēng yuán
14012,曾祖父,7,,3,4,7,ㄗㄥ ㄗㄨˇ ㄈㄨˋ,zēng zǔ fù
14013,紮,7,,5,1,6,ㄓㄚˊ,zhá
14014,乍,7,,10,3,13,ㄓㄚˋ,zhà
14015,扎根,7,,3,5,8,ㄓㄚ ㄍㄣ,zhā gēn
14016,詐欺,7,,4,1,5,ㄓㄚˋ ㄑㄧ,zhà qī
14017,紮實,7,,6,6,12,ㄓㄚˊ ㄕˊ,zhá shí
14018,乍現,7,,2,1,3,ㄓㄚˋ ㄒㄧㄢˋ,zhà xiàn
14019,炸藥,7,,4,4,8,ㄓㄚˋ ㄧㄠˋ,zhà yào
14020,紮營,7,,5,1,6,ㄓㄚˊ ㄧㄥˊ,zhá yíng
14021,寨,7,,19,7,26,ㄓㄞˋ,zhài
14022,宅邸,7,,13,1,14,ㄓㄞˊ ㄉㄧˇ,zhái dǐ
14023,債券,7,,7,4,11,ㄓㄞˋ ㄑㄩㄢˋ,zhài quàn
14024,蘸,7,,3,1,4,ㄓㄢˋ,zhàn
14025,盞,7,,18,6,24,ㄓㄢˇ,zhǎn
14026,展翅,7,,4,1,5,ㄓㄢˇ ㄔˋ,zhǎn chì
14027,斬釘截鐵,7,,4,1,5,ㄓㄢˇ ㄉㄧㄥ ㄐㄧㄝˊ ㄊㄧㄝˇ,zhǎn dīng jié tiě
14028,斬斷,7,,4,1,5,ㄓㄢˇ ㄉㄨㄢˋ,zhǎn duàn
14029,戰果,7,,4,0,4,ㄓㄢˋ ㄍㄨㄛˇ,zhàn guǒ
14030,暫緩,7,,2,2,4,ㄓㄢˋ ㄏㄨㄢˇ,zhàn huǎn
14031,戰火,7,,6,22,28,ㄓㄢˋ ㄏㄨㄛˇ,zhàn huǒ
14032,戰艦,7,,6,1,7,ㄓㄢˋ ㄐㄧㄢˋ,zhàn jiàn
14033,戰局,7,,4,1,5,ㄓㄢˋ ㄐㄩˊ,zhàn jú
14034,戰況,7,,3,1,4,ㄓㄢˋ ㄎㄨㄤˋ,zhàn kuàng
14035,湛藍,7,,3,1,4,ㄓㄢˋ ㄌㄢˊ,zhàn lán
14036,戰慄,7,,4,0,4,ㄓㄢˋ ㄌㄧˋ,zhàn lì
14037,嶄露頭角,7,,3,2,5,ㄓㄢˇ ㄌㄨˋ ㄊㄡˊ ㄐㄧㄠˇ,zhǎn lù tóu jiǎo
14038,戰亂,7,,7,12,19,ㄓㄢˋ ㄌㄨㄢˋ,zhàn luàn
14039,暫且,7,,7,1,8,ㄓㄢˋ ㄑㄧㄝˇ,zhàn qiě
14040,佔上風,7,,2,1,3,ㄓㄢˋ ㄕㄤˋ ㄈㄥ,zhàn shàng fēng
14041,戰士,7,,14,6,20,ㄓㄢˋ ㄕˋ,zhàn shì
14042,斬首,7,,7,1,8,ㄓㄢˇ ㄕㄡˇ,zhǎn shǒu
14043,展望,7,,4,3,7,ㄓㄢˇ ㄨㄤˋ,zhǎn wàng
14044,戰線,7,,5,1,6,ㄓㄢˋ ㄒㄧㄢˋ,zhàn xiàn
14045,瞻仰,7,,2,2,4,ㄓㄢ ㄧㄤˇ,zhān yǎng
14046,佔用,7,,3,1,4,ㄓㄢˋ ㄩㄥˋ,zhàn yòng
14047,戰友,7,,3,1,4,ㄓㄢˋ ㄧㄡˇ,zhàn yǒu
14048,戰戰兢兢,7,,7,4,11,ㄓㄢˋ ㄓㄢˋ ㄐㄧㄥ ㄐㄧㄥ,zhàn zhàn jīng jīng
14049,沾沾自喜,7,,4,0,4,ㄓㄢ ㄓㄢ ㄗˋ ㄒㄧˇ,zhān zhān zì xǐ
14050,掌,7,,24,10,34,ㄓㄤˇ,zhǎng
14051,章法,7,,4,1,5,ㄓㄤ ㄈㄚˇ,zhāng fǎ
14052,長進,7,,4,1,5,ㄓㄤˇ ㄐㄧㄣˋ,zhǎng jìn
14053,張口,7,,3,1,4,ㄓㄤ ㄎㄡˇ,zhāng kǒu
14054,蟑螂,7,,4,13,17,ㄓㄤ ㄌㄤˊ,zhāng láng
14055,張羅,7,,4,4,8,ㄓㄤ ㄌㄨㄛˊ,zhāng luó
14056,帳目,7,,2,1,3,ㄓㄤˋ ㄇㄨˋ,zhàng mù
14057,掌心,7,,6,1,7,ㄓㄤˇ ㄒㄧㄣ,zhǎng xīn
14058,張牙舞爪,7,,3,0,3,ㄓㄤ ㄧㄚˊ ㄨˇ ㄓㄠˇ,zhāng yá wǔ zhǎo
14059,張揚,7,,3,1,4,ㄓㄤ ㄧㄤˊ,zhāng yáng
14060,仗義,7,,4,1,5,ㄓㄤˋ ㄧˋ,zhàng yì
14061,著3,7,,4017,1760,5777,ㄓㄠˊ,zháo
14062,照單全收,7,,2,1,3,ㄓㄠˋ ㄉㄢ ㄑㄩㄢˊ ㄕㄡ,zhào dān quán shōu
14063,召回,7,,5,1,6,ㄓㄠˋ ㄏㄨㄟˊ,zhào huí
14064,召集人,7,,4,4,8,ㄓㄠˋ ㄐㄧˊ ㄖㄣˊ,zhào jí rén
14065,招架,7,,5,3,8,ㄓㄠ ㄐㄧㄚˋ,zhāo jià
14066,召來,7,,3,0,3,ㄓㄠˋ ㄌㄞˊ,zhào lái
14067,朝氣,7,,4,2,6,ㄓㄠ ㄑㄧˋ,zhāo qì
14068,招惹,7,,3,0,3,ㄓㄠ ㄖㄜˇ,zhāo rě
14069,招收,7,,3,3,6,ㄓㄠ ㄕㄡ,zhāo shōu
14070,招數,7,,4,2,6,ㄓㄠ ㄕㄨˋ,zhāo shù
14071,兆頭,7,,2,1,3,ㄓㄠˋ ˙ㄊㄡ,zhào tou
14072,朝陽,7,,4,3,7,ㄓㄠ ㄧㄤˊ,zhāo yáng
14073,照耀,7,,6,2,8,ㄓㄠˋ ㄧㄠˋ,zhào yào
14074,招搖,7,,3,0,3,ㄓㄠ ㄧㄠˊ,zhāo yáo
14075,照應,7,,3,2,5,ㄓㄠˋ ㄧㄥˋ,zhào yìng
14076,沼澤,7,,5,6,11,ㄓㄠˇ ㄗㄜˊ,zhǎo zé
14077,招致,7,,7,0,7,ㄓㄠ ㄓˋ,zhāo zhì
14078,遮蔽,7,,5,7,12,ㄓㄜ ㄅㄧˋ,zhē bì
14079,折返,7,,3,1,4,ㄓㄜ ㄈㄢˇ,zhē fǎn
14080,折服,7,,3,2,5,ㄓㄜˊ ㄈㄨˊ,zhé fú
14081,遮蓋,7,,3,1,4,ㄓㄜ ㄍㄞˋ,zhē gài
14082,哲理,7,,4,3,7,ㄓㄜˊ ㄌㄧˇ,zhé lǐ
14083,哲人,7,,3,1,4,ㄓㄜˊ ㄖㄣˊ,zhé rén
14084,遮掩,7,,6,2,8,ㄓㄜ ㄧㄢˇ,zhē yǎn
14085,折衷,7,,4,1,5,ㄓㄜˊ ㄓㄨㄥ,zhé zhōng
14086,朕,7,,38,1,39,ㄓㄣˋ,zhèn
14087,枕,7,,10,4,14,ㄓㄣˇ,zhěn
14088,斟,7,,6,0,6,ㄓㄣ,zhēn
14089,臻,7,,3,1,4,ㄓㄣ,zhēn
14090,珍愛,7,,4,2,6,ㄓㄣ ㄞˋ,zhēn ài
14091,珍寶,7,,6,3,9,ㄓㄣ ㄅㄠˇ,zhēn bǎo
14092,偵察,7,,5,2,7,ㄓㄣ ㄔㄚˊ,zhēn chá
14093,偵查,7,,4,1,5,ㄓㄣ ㄔㄚˊ,zhēn chá
14094,震盪,7,,6,6,12,ㄓㄣˋ ㄉㄤˋ,zhèn dàng
14095,陣地,7,,6,0,6,ㄓㄣˋ ㄉㄧˋ,zhèn dì
14096,真諦,7,,6,3,9,ㄓㄣ ㄉㄧˋ,zhēn dì
14097,振動,7,,8,4,12,ㄓㄣˋ ㄉㄨㄥˋ,zhèn dòng
14098,震耳欲聾,7,,3,0,3,ㄓㄣˋ ㄦˇ ㄩˋ ㄌㄨㄥˊ,zhèn ěr yù lóng
14099,診療,7,,4,3,7,ㄓㄣˇ ㄌㄧㄠˊ,zhěn liáo
14100,縝密,7,,5,2,7,ㄓㄣˇ ㄇㄧˋ,zhěn mì
14101,震怒,7,,3,1,4,ㄓㄣˋ ㄋㄨˋ,zhèn nù
14102,珍品,7,,3,1,4,ㄓㄣ ㄆㄧㄣˇ,zhēn pǐn
14103,真切,7,,5,1,6,ㄓㄣ ㄑㄧㄝˋ,zhēn qiè
14104,鎮守,7,,7,1,8,ㄓㄣˋ ㄕㄡˇ,zhèn shǒu
14105,震天,7,,3,1,4,ㄓㄣˋ ㄊㄧㄢ,zhèn tiān
14106,陣亡,7,,7,4,11,ㄓㄣˋ ㄨㄤˊ,zhèn wáng
14107,振興,7,,4,8,12,ㄓㄣˋ ㄒㄧㄥ,zhèn xīng
14108,真義,7,,3,0,3,ㄓㄣ ㄧˋ,zhēn yì
14109,震懾,7,,4,2,6,ㄓㄣˋ ㄓㄜˊ,zhèn zhé
14110,振振有詞,7,,2,1,3,ㄓㄣˋ ㄓㄣˋ ㄧㄡˇ ㄘˊ,zhèn zhèn yǒu cí
14111,真摯,7,,4,1,5,ㄓㄣ ㄓˋ,zhēn zhì
14112,斟酌,7,,5,2,7,ㄓㄣ ㄓㄨㄛˊ,zhēn zhuó
14113,掙2,7,,4,4,8,ㄓㄥˋ,zhèng
14114,掙1,7,,4,4,8,ㄓㄥ,zhēng
14115,正比,7,,4,1,5,ㄓㄥˋ ㄅㄧˇ,zhèng bǐ
14116,證詞,7,,9,1,10,ㄓㄥˋ ㄘˊ,zhèng cí
14117,正道,7,,3,2,5,ㄓㄥˋ ㄉㄠˋ,zhèng dào
14118,政敵,7,,4,2,6,ㄓㄥˋ ㄉㄧˊ,zhèng dí
14119,爭鬥,7,,6,1,7,ㄓㄥ ㄉㄡˋ,zhēng dòu
14120,爭端,7,,4,6,10,ㄓㄥ ㄉㄨㄢ,zhēng duān
14121,爭奪戰,7,,3,2,5,ㄓㄥ ㄉㄨㄛˊㄓㄢˋ,zhēng duó zhàn
14122,蒸發,7,,6,12,18,ㄓㄥ ㄈㄚ,zhēng fā
14123,正軌,7,,3,1,4,ㄓㄥˋ ㄍㄨㄟˇ,zhèng guǐ
14124,政見,7,,3,2,5,ㄓㄥˋ ㄐㄧㄢˋ,zhèng jiàn
14125,政令,7,,3,1,4,ㄓㄥˋ ㄌㄧㄥˋ,zhèng lìng
14126,正門,7,,3,0,3,ㄓㄥˋ ㄇㄣˊ,zhèng mén
14127,猙獰,7,,3,1,4,ㄓㄥ ㄋㄧㄥˊ,zhēng níng
14128,正派,7,,6,1,7,ㄓㄥˋ ㄆㄞˋ,zhèng pài
14129,正氣,7,,4,1,5,ㄓㄥˋ ㄑㄧˋ,zhèng qì
14130,爭氣,7,,4,2,6,ㄓㄥ ㄑㄧˋ,zhēng qì
14131,蒸氣,7,,4,4,8,ㄓㄥ ㄑㄧˋ,zhēng qì
14132,正人君子,7,,4,0,4,ㄓㄥˋ ㄖㄣˊ ㄐㄩㄣ ㄗˇ,zhèng rén jūn zǐ
14133,正色,7,,4,0,4,ㄓㄥˋ ㄙㄜˋ,zhèng sè
14134,正事,7,,4,1,5,ㄓㄥˋ ㄕˋ,zhèng shì
14135,正題,7,,3,0,3,ㄓㄥˋ ㄊㄧˊ,zhèng tí
14136,政體,7,,5,0,5,ㄓㄥˋ ㄊㄧˇ,zhèng tǐ
14137,正途,7,,3,1,4,ㄓㄥˋ ㄊㄨˊ,zhèng tú
14138,爭先恐後,7,,4,1,5,ㄓㄥ ㄒㄧㄢ ㄎㄨㄥˇ ㄏㄡˋ,zhēng xiān kǒng hòu
14139,征戰,7,,6,2,8,ㄓㄥ ㄓㄢˋ,zhēng zhàn
14140,徵召,7,,7,1,8,ㄓㄥ ㄓㄠˋ,zhēng zhào
14141,蒸蒸日上,7,,3,1,4,ㄓㄥ ㄓㄥ ㄖˋ ㄕㄤˋ,zhēng zhēng rì shàng
14142,正值,7,,2,1,3,ㄓㄥˋ ㄓˊ,zhèng zhí
14143,整治,7,,4,6,10,ㄓㄥˇ ㄓˋ,zhěng zhì
14144,鄭重,7,,7,2,9,ㄓㄥˋ ㄓㄨㄥˋ,zhèng zhòng
14145,整裝,7,,2,2,4,ㄓㄥˇ ㄓㄨㄤ,zhěng zhuāng
14146,正宗,7,,3,1,4,ㄓㄥˋ ㄗㄨㄥ,zhèng zōng
14147,值,7,,27,32,59,ㄓˊ,zhí
14148,摯愛,7,,4,3,7,ㄓˋ ㄞˋ,zhì ài
14149,執拗,7,,3,0,3,ㄓˊ ㄠˋ,zhí ào
14150,治本,7,,3,2,5,ㄓˋ ㄅㄣˇ,zhì běn
14151,執筆,7,,7,1,8,ㄓˊ ㄅㄧˇ,zhí bǐ
14152,治標,7,,3,2,5,ㄓˋ ㄅㄧㄠ,zhì biāo
14153,織布,7,,7,6,13,ㄓ ㄅㄨˋ,zhī bù
14154,制裁,7,,4,29,33,ㄓˋ ㄘㄞˊ,zhì cái
14155,指稱,7,,4,1,5,ㄓˇ ㄔㄥ,zhǐ chēng
14156,致詞,7,,3,3,6,ㄓˋ ㄘˊ,zhì cí
14157,致富,7,,7,5,12,ㄓˋ ㄈㄨˋ,zhì fù
14158,質感,7,,3,6,9,ㄓˊ ㄍㄢˇ,zhí gǎn
14159,枝幹,7,,3,4,7,ㄓ ㄍㄢˋ,zhī gàn
14160,至高無上,7,,4,1,5,ㄓˋ ㄍㄠ ㄨˊ ㄕㄤˋ,zhì gāo wú shàng
14161,桎梏,7,,3,2,5,ㄓˋ ㄍㄨˋ,zhì gù
14162,制衡,7,,4,2,6,ㄓˋ ㄏㄥˊ,zhì héng
14163,知會,7,,3,1,4,ㄓ ㄏㄨㄟˋ,zhī huì
14164,智慧型,7,,7,7,14,ㄓˋ ㄏㄨㄟˋ ㄒㄧㄥˊ,zhì huì xíng
14165,執教,7,,3,1,4,ㄓˊ ㄐㄧㄠˋ,zhí jiào
14166,枝節,7,,3,0,3,ㄓ ㄐㄧㄝˊ,zhī jié
14167,直截了當,7,,6,0,6,ㄓˊ ㄐㄧㄝˊ ㄌㄧㄠˇ ㄉㄤˋ,zhí jié liǎo dàng
14168,支離破碎,7,,3,2,5,ㄓ ㄌㄧˊ ㄆㄛˋ ㄙㄨㄟˋ,zhī lí pò suì
14169,質料,7,,2,3,5,ㄓˊ ㄌㄧㄠˋ,zhí liào
14170,滯留,7,,4,8,12,ㄓˋ ㄌㄧㄡˊ,zhì liú
14171,支流,7,,3,13,16,ㄓ ㄌㄧㄡˊ,zhī liú
14172,指明,7,,3,0,3,ㄓˇ ㄇㄧㄥˊ,zhǐ míng
14173,致命傷,7,,3,1,4,ㄓˋ ㄇㄧㄥˋ ㄕㄤ,zhì mìng shāng
14174,稚嫩,7,,3,2,5,ㄓˋ ㄋㄣˋ,zhì nèn
14175,職能,7,,4,2,6,ㄓˊ ㄋㄥˊ,zhí néng
14176,致歉,7,,2,1,3,ㄓˋ ㄑㄧㄢˋ,zhì qiàn
14177,至親,7,,3,2,5,ㄓˋ ㄑㄧㄣ,zhì qīn
14178,指認,7,,6,1,7,ㄓˇ ㄖㄣˋ,zhǐ rèn
14179,指日可待,7,,2,1,3,ㄓˇ ㄖˋ ㄎㄜˇ ㄉㄞˋ,zhǐ rì kě dài
14180,紙上談兵,7,,2,2,4,ㄓˇ ㄕㄤˋ ㄊㄢˊ ㄅㄧㄥ,zhǐ shàng tán bīng
14181,隻身,7,,5,3,8,ㄓ ㄕㄣ,zhī shēn
14182,直視,7,,7,1,8,ㄓˊ ㄕˋ,zhí shì
14183,志士,7,,4,1,5,ㄓˋ ㄕˋ,zhì shì
14184,指使,7,,4,1,5,ㄓˇ ㄕˇ,zhǐ shǐ
14185,職守,7,,4,1,5,ㄓˊ ㄕㄡˇ,zhí shǒu
14186,直率,7,,4,0,4,ㄓˊ ㄕㄨㄞˋ,zhí shuài
14187,直挺挺,7,,3,1,4,ㄓˊ ㄊㄧㄥˇ ㄊㄧㄥˇ,zhí tǐng tǐng
14188,止痛,7,,5,2,7,ㄓˇ ㄊㄨㄥˋ,zhǐ tòng
14189,志同道合,7,,3,7,10,ㄓˋ ㄊㄨㄥˊ ㄉㄠˋ ㄏㄜˊ,zhì tóng dào hé
14190,止痛藥,7,,4,2,6,ㄓˇ ㄊㄨㄥˋ ㄧㄠˋ,zhǐ tòng yào
14191,植物人,7,,2,6,8,ㄓˊ ㄨˋ ㄖㄣˊ,zhí wù rén
14192,知悉,7,,3,1,4,ㄓ ㄒㄧ,zhī xī
14193,知心,7,,5,0,5,ㄓ ㄒㄧㄣ,zhī xīn
14194,執行不力,7,,0,0,0,ㄓˊ ㄒㄧㄥˊㄅㄨˊ ㄌㄧˋ,zhí xíng bú lì
14195,質詢,7,,3,1,4,ㄓˊ ㄒㄩㄣˊ,zhí xún
14196,執業,7,,4,1,5,ㄓˊ ㄧㄝˋ,zhí yè
14197,志業,7,,4,22,26,ㄓˋ ㄧㄝˋ,zhì yè
14198,汁液,7,,3,4,7,ㄓ ㄧㄝˋ,zhī yè
14199,執意,7,,6,4,10,ㄓˊ ㄧˋ,zhí yì
14200,旨意,7,,12,2,14,ㄓˇ ㄧˋ,zhǐ yì
14201,知音,7,,3,0,3,ㄓ ㄧㄣ,zhī yīn
14202,摯友,7,,4,0,4,ㄓˋ ㄧㄡˇ,zhì yǒu
14203,執掌,7,,4,1,5,ㄓˊ ㄓㄤˇ,zhí zhǎng
14204,指針,7,,3,1,4,ㄓˇ ㄓㄣ,zhǐ zhēn
14205,指正,7,,4,1,5,ㄓˇ ㄓㄥˋ,zhǐ zhèng
14206,直指,7,,4,1,5,ㄓˊ ㄓˇ,zhí zhǐ
14207,置之不理,7,,4,0,4,ㄓˋ ㄓ ㄅㄨˋ ㄌㄧˇ,zhì zhī bù lǐ
14208,指指點點,7,,2,1,3,ㄓˇ ㄓˇ ㄉㄧㄢˇ ㄉㄧㄢˇ,zhǐ zhǐ diǎn diǎn
14209,支支吾吾,7,,2,1,3,ㄓ ㄓ ㄨˊ ㄨˊ,zhī zhī wú wú
14210,隻字片語,7,,0,0,0,ㄓ ㄗˋ ㄆㄧㄢˋ ㄩˇ,zhī zì piàn yǔ
14211,盅,7,,4,1,5,ㄓㄨㄥ,zhōng
14212,鍾愛,7,,5,1,6,ㄓㄨㄥ ㄞˋ,zhōng ài
14213,重兵,7,,4,1,5,ㄓㄨㄥˋ ㄅㄧㄥ,zhòng bīng
14214,忠臣,7,,7,0,7,ㄓㄨㄥ ㄔㄣˊ,zhōng chén
14215,重擔,7,,7,7,14,ㄓㄨㄥˋ ㄉㄢˋ,zhòng dàn
14216,終歸,7,,2,1,3,ㄓㄨㄥ ㄍㄨㄟ,zhōng guī
14217,中和,7,,4,7,11,ㄓㄨㄥ ㄏㄜˊ,zhōng hé
14218,忠厚,7,,6,1,7,ㄓㄨㄥ ㄏㄡˋ,zhōng hòu
14219,重金,7,,3,2,5,ㄓㄨㄥˋ ㄐㄧㄣ,zhòng jīn
14220,中肯,7,,3,1,4,ㄓㄨㄥˋ ㄎㄣˇ,zhòng kěn
14221,重力,7,,18,6,24,ㄓㄨㄥˋ ㄌㄧˋ,zhòng lì
14222,終了,7,,3,1,4,ㄓㄨㄥ ㄌㄧㄠˇ,zhōng liǎo
14223,腫瘤,7,,16,17,33,ㄓㄨㄥˇ ㄌㄧㄡˊ,zhǒng liú
14224,眾目睽睽,7,,2,1,3,ㄓㄨㄥˋ ㄇㄨˋ ㄎㄨㄟˊ ㄎㄨㄟˊ,zhòng mù kuí kuí
14225,終年,7,,4,5,9,ㄓㄨㄥ ㄋㄧㄢˊ,zhōng nián
14226,終其一生,7,,6,3,9,ㄓㄨㄥ ㄑㄧˊ ㄧˋ ㄕㄥ,zhōng qí yì shēng
14227,中傷,7,,3,1,4,ㄓㄨㄥˋ ㄕㄤ,zhòng shāng
14228,中世紀,7,,6,3,9,ㄓㄨㄥ ㄕˋ ㄐㄧˋ,zhōng shì jì
14229,中樞,7,,12,4,16,ㄓㄨㄥ ㄕㄨ,zhōng shū
14230,眾所皆知,7,,2,2,4,ㄓㄨㄥˋ ㄙㄨㄛˇ ㄐㄧㄝ ㄓ,zhòng suǒ jiē zhī
14231,眾所周知,7,,6,1,7,ㄓㄨㄥˋ ㄙㄨㄛˇ ㄓㄡ ㄓ,zhòng suǒ zhōu zhī
14232,衷心,7,,7,6,13,ㄓㄨㄥ ㄒㄧㄣ,zhōng xīn
14233,忠心耿耿,7,,5,1,6,ㄓㄨㄥ ㄒㄧㄣ ㄍㄥˇ ㄍㄥˇ,zhōng xīn gěng gěng
14234,中興,7,,7,9,16,ㄓㄨㄥ ㄒㄧㄥ,zhōng xīng
14235,中葉,7,,6,2,8,ㄓㄨㄥ ㄧㄝˋ,zhōng yè
14236,中意,7,,4,1,5,ㄓㄨㄥˋ ㄧˋ,zhòng yì
14237,中用,7,,2,1,3,ㄓㄨㄥˋ ㄩㄥˋ,zhòng yòng
14238,中庸,7,,4,2,6,ㄓㄨㄥ ㄩㄥ,zhōng yōng
14239,忠於,7,,10,1,11,ㄓㄨㄥ ㄩˊ,zhōng yú
14240,重鎮,7,,5,10,15,ㄓㄨㄥˋ ㄓㄣˋ,zhòng zhèn
14241,忠貞,7,,7,0,7,ㄓㄨㄥ ㄓㄣ,zhōng zhēn
14242,終至,7,,3,1,4,ㄓㄨㄥ ㄓˋ,zhōng zhì
14243,周朝,7,,3,1,4,ㄓㄡ ㄔㄠˊ,zhōu cháo
14244,皺眉頭/皺眉,7,,9,1,10,ㄓㄡˋ ㄇㄟˊ/ㄓㄡˋㄇㄟˊ ㄊㄡˊ,zhòu méi /zhòu méi tóu
14245,周密,7,,4,1,5,ㄓㄡ ㄇㄧˋ,zhōu mì
14246,周全,7,,4,3,7,ㄓㄡ ㄑㄩㄢˊ,zhōu quán
14247,周詳,7,,3,1,4,ㄓㄡ ㄒㄧㄤˊ,zhōu xiáng
14248,軸心,7,,3,3,6,ㄓㄡˊ ㄒㄧㄣ,zhóu xīn
14249,周旋,7,,5,4,9,ㄓㄡ ㄒㄩㄢˊ,zhōu xuán
14250,周延,7,,2,1,3,ㄓㄡ ㄧㄢˊ,zhōu yán
14251,咒語,7,,5,1,6,ㄓㄡˋ ㄩˇ,zhòu yǔ
14252,拄,7,,5,2,7,ㄓㄨˇ,zhǔ
14253,朱,7,,38,9,47,ㄓㄨ,zhū
14254,著稱,7,,5,3,8,ㄓㄨˋ ㄔㄥ,zhù chēng
14255,貯存,7,,3,3,6,ㄓㄨˇ ㄘㄨㄣˊ,zhǔ cún
14256,竹竿,7,,5,3,8,ㄓㄨˊ ㄍㄢ,zhú gān
14257,諸侯,7,,20,1,21,ㄓㄨ ㄏㄡˊ,zhū hóu
14258,主將,7,,4,0,4,ㄓㄨˇ ㄐㄧㄤˋ,zhǔ jiàng
14259,助教,7,,4,4,8,ㄓㄨˋ ㄐㄧㄠˋ,zhù jiào
14260,駐軍,7,,5,4,9,ㄓㄨˋ ㄐㄩㄣ,zhù jūn
14261,佇立,7,,5,2,7,ㄓㄨˋ ㄌㄧˋ,zhù lì
14262,註明,7,,5,1,6,ㄓㄨˋ ㄇㄧㄥˊ,zhù míng
14263,注目,7,,7,3,10,ㄓㄨˋ ㄇㄨˋ,zhù mù
14264,主人翁,7,,5,2,7,ㄓㄨˇ ㄖㄣˊ ㄨㄥ,zhǔ rén wēng
14265,誅殺,7,,8,1,9,ㄓㄨ ㄕㄚ,zhū shā
14266,注射,7,,16,5,21,ㄓㄨˋ ㄕㄜˋ,zhù shè
14267,住手,7,,3,1,4,ㄓㄨˋ ㄕㄡˇ,zhù shǒu
14268,駐守,7,,6,4,10,ㄓㄨˋ ㄕㄡˇ,zhù shǒu
14269,著述,7,,4,1,5,ㄓㄨˋ ㄕㄨˋ,zhù shù
14270,蛛絲馬跡,7,,5,4,9,ㄓㄨ ㄙ ㄇㄚˇ ㄐㄧ,zhū sī mǎ jī
14271,主政,7,,4,2,6,ㄓㄨˇ ㄓㄥˋ,zhǔ zhèng
14272,駐足,7,,5,3,8,ㄓㄨˋ ㄗㄨˊ,zhù zú
14273,轉達,7,,3,0,3,ㄓㄨㄢˇ ㄉㄚˊ,zhuǎn dá
14274,專攻,7,,4,2,6,ㄓㄨㄢ ㄍㄨㄥ,zhuān gōng
14275,專橫,7,,4,0,4,ㄓㄨㄢ ㄏㄥˋ,zhuān hèng
14276,專精,7,,5,3,8,ㄓㄨㄢ ㄐㄧㄥ,zhuān jīng
14277,磚塊,7,,3,4,7,ㄓㄨㄢ ㄎㄨㄞˋ,zhuān kuài
14278,轉捩點,7,,6,5,11,ㄓㄨㄢˇ ㄌㄧㄝˋ ㄉㄧㄢˇ,zhuǎn liè diǎn
14279,轉念,7,,3,9,12,ㄓㄨㄢˇ ㄋㄧㄢˋ,zhuǎn niàn
14280,轉世,7,,3,1,4,ㄓㄨㄢˇ ㄕˋ,zhuǎn shì
14281,轉手,7,,2,1,3,ㄓㄨㄢˇ ㄕㄡˇ,zhuǎn shǒu
14282,撰述,7,,3,10,13,ㄓㄨㄢˋ ㄕㄨˋ,zhuàn shù
14283,轉述,7,,5,1,6,ㄓㄨㄢˇ ㄕㄨˋ,zhuǎn shù
14284,轉瞬,7,,2,1,3,ㄓㄨㄢˇ ㄕㄨㄣˋ,zhuǎn shùn
14285,磚頭,7,,2,5,7,ㄓㄨㄢ ˙ㄊㄡ,zhuān tou
14286,撰文,7,,4,1,5,ㄓㄨㄢˋ ㄨㄣˊ,zhuàn wén
14287,專文,7,,3,0,3,ㄓㄨㄢ ㄨㄣˊ,zhuān wén
14288,轉學,7,,3,4,7,ㄓㄨㄢˇ ㄒㄩㄝˊ,zhuǎn xué
14289,轉載,7,,3,1,4,ㄓㄨㄢˇ ㄗㄞˋ,zhuǎn zài
14290,專職,7,,3,4,7,ㄓㄨㄢ ㄓˊ,zhuān zhí
14291,莊稼,7,,9,4,13,ㄓㄨㄤ ㄐㄧㄚˋ,zhuāng jia
14292,撞見,7,,4,0,4,ㄓㄨㄤˋ ㄐㄧㄢˋ,zhuàng jiàn
14293,壯闊,7,,3,2,5,ㄓㄨㄤˋ ㄎㄨㄛˋ,zhuàng kuò
14294,壯烈,7,,3,1,4,ㄓㄨㄤˋ ㄌㄧㄝˋ,zhuàng liè
14295,裝模作樣,7,,4,1,5,ㄓㄨㄤ ㄇㄛˊ ㄗㄨㄛˋ ㄧㄤˋ,zhuāng mó zuò yàng
14296,壯年,7,,3,3,6,ㄓㄨㄤˋ ㄋㄧㄢˊ,zhuàng nián
14297,裝設,7,,4,4,8,ㄓㄨㄤ ㄕㄜˋ,zhuāng shè
14298,裝束,7,,3,1,4,ㄓㄨㄤ ㄕㄨˋ,zhuāng shù
14299,壯碩,7,,4,1,5,ㄓㄨㄤˋ ㄕㄨㄛˋ,zhuàng shuò
14300,裝修,7,,3,2,5,ㄓㄨㄤ ㄒㄧㄡ,zhuāng xiū
14301,莊嚴,7,,12,15,27,ㄓㄨㄤ ㄧㄢˊ,zhuāng yán
14302,壯志,7,,5,2,7,ㄓㄨㄤˋ ㄓˋ,zhuàng zhì
14303,莊重,7,,4,2,6,ㄓㄨㄤ ㄓㄨㄥˋ,zhuāng zhòng
14304,追根究柢,7,,5,1,6,ㄓㄨㄟ ㄍㄣ ㄐㄧㄡˋ ㄉㄧˇ,zhuī gēn jiù dǐ
14305,墜落,7,,6,1,7,ㄓㄨㄟˋ ㄌㄨㄛˋ,zhuì luò
14306,追憶,7,,4,3,7,ㄓㄨㄟ ㄧˋ,zhuī yì
14307,諄諄,7,,3,2,5,ㄓㄨㄣ ㄓㄨㄣ,zhūn zhūn
14308,啄,7,,4,7,11,ㄓㄨㄛˊ,zhuó
14309,濁,7,,3,2,5,ㄓㄨㄛˊ,zhuó
14310,酌,7,,3,0,3,ㄓㄨㄛˊ,zhuó
14311,著地,7,,4,0,4,ㄓㄨㄛˊ ㄉㄧˋ,zhuó dì
14312,灼見,7,,3,0,3,ㄓㄨㄛˊ ㄐㄧㄢˋ,zhuó jiàn
14313,著力,7,,3,1,4,ㄓㄨㄛˊ ㄌㄧˋ,zhuó lì
14314,酌量,7,,1,1,2,ㄓㄨㄛˊ ㄌㄧㄤˊ,zhuó liáng
14315,拙劣,7,,3,0,3,ㄓㄨㄛˊ ㄌㄧㄝˋ,zhuó liè
14316,著落,7,,2,1,3,ㄓㄨㄛˊ ㄌㄨㄛˋ,zhuó luò
14317,捉摸,7,,6,2,8,ㄓㄨㄛ ㄇㄛ,zhuō mō
14318,捉拿,7,,5,1,6,ㄓㄨㄛ ㄋㄚˊ,zhuō ná
14319,灼熱,7,,4,1,5,ㄓㄨㄛˊ ㄖㄜˋ,zhuó rè
14320,著眼,7,,4,2,6,ㄓㄨㄛˊ ㄧㄢˇ,zhuó yǎn
14321,卓著,7,,4,1,5,ㄓㄨㄛˊ ㄓㄨˋ,zhuó zhù
14322,逐字,7,,2,1,3,ㄓㄨˊㄗˋ,zhúzì
14323,茲,7,,12,7,19,ㄗ,zī
14324,自愛,7,,5,1,6,ㄗˋ ㄞˋ,zì ài
14325,自暴自棄,7,,4,1,5,ㄗˋ ㄅㄠˋ ㄗˋ ㄑㄧˋ,zì bào zì qì
14326,自白,7,,3,0,3,ㄗˋ ㄅㄛˊ,zì bó
14327,自得,7,,5,1,6,ㄗˋ ㄉㄜˊ,zì dé
14328,自得其樂,7,,3,1,4,ㄗˋ ㄉㄜˊ ㄑㄧˊ ㄌㄜˋ,zì dé qí lè
14329,自告奮勇,7,,4,3,7,ㄗˋ ㄍㄠˋ ㄈㄣˋ ㄩㄥˇ,zì gào fèn yǒng
14330,自個兒,7,,5,1,6,ㄗˋ ㄍㄜˇㄦ,zì gěr
14331,自毀,7,,3,1,4,ㄗˋ ㄏㄨㄟˇ,zì huǐ
14332,字跡,7,,6,2,8,ㄗˋ ㄐㄧ,zì jī
14333,自盡,7,,9,1,10,ㄗˋ ㄐㄧㄣˋ,zì jìn
14334,自救,7,,3,4,7,ㄗˋ ㄐㄧㄡˋ,zì jiù
14335,自來,7,,3,1,4,ㄗˋ ㄌㄞˊ,zì lái
14336,字裡行間,7,,4,1,5,ㄗˋ ㄌㄧˇ ㄏㄤˊ ㄐㄧㄢ,zì lǐ háng jiān
14337,自憐,7,,4,0,4,ㄗˋ ㄌㄧㄢˊ,zì lián
14338,自滿,7,,4,0,4,ㄗˋ ㄇㄢˇ,zì mǎn
14339,字面,7,,5,3,8,ㄗˋ ㄇㄧㄢˋ,zì miàn
14340,子民,7,,4,12,16,ㄗˇ ㄇㄧㄣˊ,zǐ mín
14341,自命不凡,7,,2,0,2,ㄗˋ ㄇㄧㄥˋ ㄅㄨˋ ㄈㄢˊ,zì mìng bù fán
14342,自欺欺人,7,,3,1,4,ㄗˋ ㄑㄧ ㄑㄧ ㄖㄣˊ,zì qī qī rén
14343,資遣,7,,1,1,2,ㄗ ㄑㄧㄢˇ,zī qiǎn
14344,滋潤,7,,6,10,16,ㄗ ㄖㄨㄣˋ,zī rùn
14345,自若,7,,3,1,4,ㄗˋ ㄖㄨㄛˋ,zì ruò
14346,滋生,7,,4,4,8,ㄗ ㄕㄥ,zī shēng
14347,子嗣,7,,4,1,5,ㄗˇ ㄙˋ,zǐ sì
14348,自衛,7,,5,1,6,ㄗˋ ㄨㄟˋ,zì wèi
14349,自相矛盾,7,,2,1,3,ㄗˋ ㄒㄧㄤ ㄇㄠˊ ㄉㄨㄣˋ,zì xiāng máo dùn
14350,字形,7,,5,3,8,ㄗˋ ㄒㄧㄥˊ,zì xíng
14351,自修,7,,3,2,5,ㄗˋ ㄒㄧㄡ,zì xiū
14352,自許,7,,2,2,4,ㄗˋ ㄒㄩˇ,zì xǔ
14353,滋養,7,,7,7,14,ㄗ ㄧㄤˇ,zī yǎng
14354,恣意,7,,4,2,6,ㄗˋ ㄧˋ,zì yì
14355,自已,7,,5,2,7,ㄗˋ ㄧˇ,zì yǐ
14356,自圓其說,7,,2,0,2,ㄗˋ ㄩㄢˊ ㄑㄧˊ ㄕㄨㄛ,zì yuán qí shuō
14357,自怨自艾,7,,3,1,4,ㄗˋ ㄩㄢˋ ㄗˋ ㄧˋ,zì yuàn zì yì
14358,滋長,7,,4,2,6,ㄗ ㄓㄤˇ,zī zhǎng
14359,資質,7,,4,2,6,ㄗ ㄓˊ,zī zhí
14360,自知之明,7,,3,1,4,ㄗˋ ㄓ ㄓ ㄇㄧㄥˊ,zì zhī zhī míng
14361,自重,7,,4,0,4,ㄗˋ ㄓㄨㄥˋ,zì zhòng
14362,孜孜不倦,7,,2,1,3,ㄗ ㄗ ㄅㄨˋ ㄐㄩㄢˋ,zī zī bù juàn
14363,自作主張,7,,3,0,3,ㄗˋ ㄗㄨㄛˋ ㄓㄨˇ ㄓㄤ,zì zuò zhǔ zhāng
14364,總歸,7,,2,1,3,ㄗㄨㄥˇ ㄍㄨㄟ,zǒng guī
14365,縱火,7,,3,2,5,ㄗㄨㄥˋ ㄏㄨㄛˇ,zòng huǒ
14366,總量,7,,3,6,9,ㄗㄨㄥˇ ㄌㄧㄤˋ,zǒng liàng
14367,縱情,7,,3,2,5,ㄗㄨㄥˋ ㄑㄧㄥˊ,zòng qíng
14368,縱身,7,,5,1,6,ㄗㄨㄥˋ ㄕㄣ,zòng shēn
14369,宗師,7,,3,1,4,ㄗㄨㄥ ㄕ,zōng shī
14370,總署,7,,5,10,15,ㄗㄨㄥˇ ㄕㄨˇ,zǒng shǔ
14371,走訪,7,,4,11,15,ㄗㄡˇ ㄈㄤˇ,zǒu fǎng
14372,驟然,7,,5,1,6,ㄗㄡˋ ㄖㄢˊ,zòu rán
14373,走失,7,,3,1,4,ㄗㄡˇ ㄕ,zǒu shī
14374,走投無路,7,,5,1,6,ㄗㄡˇ ㄊㄡˊ ㄨˊ ㄌㄨˋ,zǒu tóu wú lù
14375,走下坡,7,,4,2,6,ㄗㄡˇ ㄒㄧㄚˋ ㄆㄛ,zǒu xià pō
14376,走樣,7,,2,0,2,ㄗㄡˇ ㄧㄤˋ,zǒu yàng
14377,走運,7,,3,0,3,ㄗㄡˇ ㄩㄣˋ,zǒu yùn
14378,奏章,7,,8,0,8,ㄗㄡˋ ㄓㄤ,zòu zhāng
14379,奏摺,7,,12,0,12,ㄗㄡˋ ㄓㄜˊ,zòu zhé
14380,走人,7,,4,2,6,ㄗㄡˇㄖㄣˊ,zǒurén
14381,卒,7,,11,2,13,ㄗㄨˊ,zú
14382,祖傳,7,,4,3,7,ㄗㄨˇ ㄔㄨㄢˊ,zǔ chuán
14383,阻斷,7,,4,5,9,ㄗㄨˇ ㄉㄨㄢˋ,zǔ duàn
14384,阻隔,7,,4,7,11,ㄗㄨˇ ㄍㄜˊ,zǔ gé
14385,足見,7,,4,2,6,ㄗㄨˊ ㄐㄧㄢˋ,zú jiàn
14386,阻攔,7,,4,1,5,ㄗㄨˇ ㄌㄢˊ,zǔ lán
14387,鑽2,7,,13,17,30,ㄗㄨㄢˋ,zuàn
14388,鑽牛角尖,7,,3,1,4,ㄗㄨㄢ ㄋㄧㄡˊ ㄐㄧㄠˇ ㄐㄧㄢ,zuān niú jiǎo jiān
14389,鑽研,7,,6,7,13,ㄗㄨㄢ ㄧㄢˊ,zuān yán
14390,罪過,7,,7,0,7,ㄗㄨㄟˋ ㄍㄨㄛˋ,zuì guò
14391,罪魁禍首,7,,3,0,3,ㄗㄨㄟˋ ㄎㄨㄟˊ ㄏㄨㄛˋ ㄕㄡˇ,zuì kuí huò shǒu
14392,嘴臉,7,,4,1,5,ㄗㄨㄟˇ ㄌㄧㄢˇ,zuǐ liǎn
14393,罪孽,7,,4,0,4,ㄗㄨㄟˋ ㄋㄧㄝˋ,zuì niè
14394,醉心,7,,3,1,4,ㄗㄨㄟˋ ㄒㄧㄣ,zuì xīn
14395,醉醺醺,7,,3,1,4,ㄗㄨㄟˋ ㄒㄩㄣ ㄒㄩㄣ,zuì xūn xūn
14396,罪狀,7,,6,0,6,ㄗㄨㄟˋ ㄓㄨㄤˋ,zuì zhuàng
14397,尊卑,7,,3,0,3,ㄗㄨㄣ ㄅㄟ,zūn bēi
14398,尊稱,7,,4,3,7,ㄗㄨㄣ ㄔㄥ,zūn chēng
14399,尊崇,7,,7,4,11,ㄗㄨㄣ ㄔㄨㄥˊ,zūn chóng
14400,遵從,7,,6,2,8,ㄗㄨㄣ ㄘㄨㄥˊ,zūn cóng
14401,遵命,7,,4,0,4,ㄗㄨㄣ ㄇㄧㄥˋ,zūn mìng
14402,尊榮,7,,2,1,3,ㄗㄨㄣ ㄖㄨㄥˊ,zūn róng
14403,遵行,7,,3,2,5,ㄗㄨㄣ ㄒㄧㄥˊ,zūn xíng
14404,作罷,7,,4,1,5,ㄗㄨㄛˋ ㄅㄚˋ,zuò bà
14405,做工,7,,6,5,11,ㄗㄨㄛˋ ㄍㄨㄥ,zuò gōng
14406,作樂,7,,3,1,4,ㄗㄨㄛˋ ㄌㄜˋ,zuò lè
14407,坐立不安,7,,4,0,4,ㄗㄨㄛˋ ㄌㄧˋ ㄅㄨˋ ㄢ,zuò lì bù ān
14408,坐立難安,7,,2,0,2,ㄗㄨㄛˋ ㄌㄧˋ ㄋㄢˊㄢ,zuò lì nán ān
14409,左鄰右舍,7,,3,6,9,ㄗㄨㄛˇ ㄌㄧㄣˊ ㄧㄡˋ ㄕㄜˋ,zuǒ lín yòu shè
14410,作亂,7,,3,1,4,ㄗㄨㄛˋ ㄌㄨㄢˋ,zuò luàn
14411,作嘔,7,,3,1,4,ㄗㄨㄛˋ ㄡˇ,zuò ǒu
14412,左派,7,,6,7,13,ㄗㄨㄛˇ ㄆㄞˋ,zuǒ pài
14413,作勢,7,,4,0,4,ㄗㄨㄛˋ ㄕˋ,zuò shì
14414,坐視,7,,3,1,4,ㄗㄨㄛˋ ㄕˋ,zuò shì
14415,作詩,7,,4,0,4,ㄗㄨㄛˋ ㄕ,zuò shī
14416,左思右想,7,,2,0,2,ㄗㄨㄛˇ ㄙ ㄧㄡˋ ㄒㄧㄤˇ,zuǒ sī yòu xiǎng
14417,作祟,7,,6,2,8,ㄗㄨㄛˋ ㄙㄨㄟˋ,zuò suì
14418,座談,7,,3,1,4,ㄗㄨㄛˋ ㄊㄢˊ,zuò tán
14419,作物,7,,7,92,99,ㄗㄨㄛˋ ㄨˋ,zuò wù
14420,座右銘,7,,4,4,8,ㄗㄨㄛˋ ㄧㄡˋ ㄇㄧㄥˊ,zuò yòu míng
14421,左右手,7,,3,2,5,ㄗㄨㄛˇ ㄧㄡˋ ㄕㄡˇ,zuǒ yòu shǒu
14422,坐鎮,7,,5,2,7,ㄗㄨㄛˋ ㄓㄣˋ,zuò zhèn
14423,佐證,7,,5,4,9,ㄗㄨㄛˇ ㄓㄥˋ,zuǒ zhèng
14424,坐姿,7,,5,1,6,ㄗㄨㄛˋ ㄗ,zuò zī
14425,做作,7,,4,0,4,ㄗㄨㄛˋ ㄗㄨㄛˋ,zuò zuò
